Time,Team,BuyVolume,SellVolume,EtfPosition,FuturePosition,EtfPrice,FuturePrice,TotalFees,AccountBalance,ProfitOrLoss
1.214228,0,0,0,0,0,126600,126700,0,0,0
1.214228,1,0,0,0,0,126600,126700,0,0,0
1.214228,2,10,11,-1,1,126600,126700,113,-1113,-1013
1.214228,3,0,0,0,0,126600,126700,0,0,0
1.214228,4,0,10,-10,10,126600,126700,-126,-874,126
1.214228,5,0,10,-10,10,126600,126700,-127,127,1127
1.214228,6,0,0,0,0,126600,126700,0,0,0
1.497778,0,0,0,0,0,126800,126800,0,0,0
1.497778,1,0,0,0,0,126800,126800,0,0,0
1.497778,2,20,21,-1,1,126800,126800,240,-3240,-3240
1.497778,3,0,0,0,0,126800,126800,0,0,0
1.497778,4,0,20,-20,20,126800,126800,-253,-747,-747
1.497778,5,10,10,0,0,126800,126800,126,-126,-126
1.497778,6,0,0,0,0,126800,126800,0,0,0
1.781532,0,10,0,10,-10,127300,126800,255,-2255,285
1.781532,1,0,0,0,0,127300,126800,0,0,0
1.781532,2,22,31,-9,9,127300,126800,164,-6164,-8450
1.781532,3,0,2,-2,2,127300,126800,-25,-175,-683
1.781532,4,0,20,-20,20,127300,126800,-253,-747,-5827
1.781532,5,20,20,0,0,127300,126800,253,2747,2747
1.781532,6,0,0,0,0,127300,126800,0,0,0
2.003101,0,10,0,10,-10,127300,126800,255,-2255,285
2.003101,1,0,0,0,0,127300,126800,0,0,0
2.003101,2,22,33,-11,11,127300,126800,139,-5939,-8733
2.003101,3,2,2,0,0,127300,126800,26,-826,-826
2.003101,4,0,20,-20,20,127300,126800,-253,-747,-5827
2.003101,5,20,20,0,0,127300,126800,253,2747,2747
2.003101,6,0,0,0,0,127300,126800,0,0,0
2.284426,0,10,0,10,-10,127300,126800,255,-2255,285
2.284426,1,0,0,0,0,127300,126800,0,0,0
2.284426,2,32,33,-1,1,127300,126800,394,-8194,-8448
2.284426,3,2,2,0,0,127300,126800,26,-826,-826
2.284426,4,0,20,-20,20,127300,126800,-253,-747,-5827
2.284426,5,20,30,-10,10,127300,126800,126,2874,334
2.284426,6,0,0,0,0,127300,126800,0,0,0
2.539152,0,10,0,10,-10,127300,126800,255,-2255,285
2.539152,1,0,0,0,0,127300,126800,0,0,0
2.539152,2,32,33,-1,1,127300,126800,394,-8194,-8448
2.539152,3,2,2,0,0,127300,126800,26,-826,-826
2.539152,4,0,20,-20,20,127300,126800,-253,-747,-5827
2.539152,5,20,30,-10,10,127300,126800,126,2874,334
2.539152,6,0,0,0,0,127300,126800,0,0,0
2.751135,0,10,0,10,-10,127400,126800,255,-2255,285
2.751135,1,0,0,0,0,127400,126800,0,0,0
2.751135,2,32,33,-1,1,127400,126800,394,-8194,-8448
2.751135,3,2,2,0,0,127400,126800,26,-826,-826
2.751135,4,0,30,-30,30,127400,126800,-380,-620,-8240
2.751135,5,20,30,-10,10,127400,126800,126,2874,334
2.751135,6,0,0,0,0,127400,126800,0,0,0
3.027906,0,10,0,10,-10,127400,127300,255,-2255,-1255
3.027906,1,0,0,0,0,127400,127300,0,0,0
3.027906,2,32,33,-1,1,127400,127300,394,-8194,-8294
3.027906,3,2,2,0,0,127400,127300,26,-826,-826
3.027906,4,0,30,-30,30,127400,127300,-380,-620,-3620
3.027906,5,20,30,-10,10,127400,127300,126,2874,1874
3.027906,6,0,0,0,0,127400,127300,0,0,0
3.267492,0,10,0,10,-10,127400,127200,255,-2255,-255
3.267492,1,0,0,0,0,127400,127200,0,0,0
3.267492,2,32,33,-1,1,127400,127200,394,-8194,-8394
3.267492,3,2,2,0,0,127400,127200,26,-826,-826
3.267492,4,0,30,-30,30,127400,127200,-380,-620,-6620
3.267492,5,20,30,-10,10,127400,127200,126,2874,874
3.267492,6,0,0,0,0,127400,127200,0,0,0
3.456534,0,10,0,10,-10,127400,127200,255,-2255,-255
3.456534,1,0,0,0,0,127400,127200,0,0,0
3.456534,2,32,33,-1,1,127400,127200,394,-8194,-8394
3.456534,3,2,2,0,0,127400,127200,26,-826,-826
3.456534,4,0,30,-30,30,127400,127200,-380,-620,-6620
3.456534,5,20,30,-10,10,127400,127200,126,2874,874
3.456534,6,0,0,0,0,127400,127200,0,0,0
3.7898,0,10,0,10,-10,127500,127400,255,-2255,-1255
3.7898,1,0,0,0,0,127500,127400,0,0,0
3.7898,2,32,43,-11,11,127500,127400,267,-8067,-9167
3.7898,3,2,2,0,0,127500,127400,26,-826,-826
3.7898,4,0,30,-30,30,127500,127400,-380,-620,-3620
3.7898,5,23,30,-7,7,127500,127400,202,2198,1498
3.7898,6,0,0,0,0,127500,127400,0,0,0
3.99358,0,10,0,10,-10,127600,127400,255,-2255,-255
3.99358,1,0,0,0,0,127600,127400,0,0,0
3.99358,2,42,43,-1,1,127600,127400,522,-9322,-9522
3.99358,3,2,2,0,0,127600,127400,26,-826,-826
3.99358,4,0,30,-30,30,127600,127400,-380,-620,-6620
3.99358,5,23,40,-17,17,127600,127400,74,2326,-1074
3.99358,6,0,0,0,0,127600,127400,0,0,0
4.2451,0,10,0,10,-10,127600,127600,255,-2255,-2255
4.2451,1,0,0,0,0,127600,127600,0,0,0
4.2451,2,42,43,-1,1,127600,127600,522,-9322,-9322
4.2451,3,2,2,0,0,127600,127600,26,-826,-826
4.2451,4,0,30,-30,30,127600,127600,-380,-620,-620
4.2451,5,23,40,-17,17,127600,127600,74,2326,2326
4.2451,6,0,0,0,0,127600,127600,0,0,0
4.541152,0,10,0,10,-10,127700,127700,255,-2255,-2255
4.541152,1,0,0,0,0,127700,127700,0,0,0
4.541152,2,42,43,-1,1,127700,127700,522,-9322,-9322
4.541152,3,2,2,0,0,127700,127700,26,-826,-826
4.541152,4,0,40,-40,40,127700,127700,-508,-492,-492
4.541152,5,33,40,-7,7,127700,127700,329,1071,1071
4.541152,6,0,0,0,0,127700,127700,0,0,0
4.757568,0,10,0,10,-10,127700,127700,255,-2255,-2255
4.757568,1,0,0,0,0,127700,127700,0,0,0
4.757568,2,42,43,-1,1,127700,127700,522,-9322,-9322
4.757568,3,2,2,0,0,127700,127700,26,-826,-826
4.757568,4,0,40,-40,40,127700,127700,-508,-492,-492
4.757568,5,33,40,-7,7,127700,127700,329,1071,1071
4.757568,6,0,0,0,0,127700,127700,0,0,0
5.012227,0,10,0,10,-10,127700,127700,255,-2255,-2255
5.012227,1,0,0,0,0,127700,127700,0,0,0
5.012227,2,42,43,-1,1,127700,127700,522,-9322,-9322
5.012227,3,2,2,0,0,127700,127700,26,-826,-826
5.012227,4,0,40,-40,40,127700,127700,-508,-492,-492
5.012227,5,33,40,-7,7,127700,127700,329,1071,1071
5.012227,6,0,0,0,0,127700,127700,0,0,0
5.300548,0,10,0,10,-10,127700,128000,255,-2255,-4815
5.300548,1,0,0,0,0,127700,128000,0,0,0
5.300548,2,42,43,-1,1,127700,128000,522,-9322,-9066
5.300548,3,2,2,0,0,127700,128000,26,-826,-826
5.300548,4,0,40,-40,40,127700,128000,-508,-492,9748
5.300548,5,33,40,-7,7,127700,128000,329,1071,2863
5.300548,6,0,0,0,0,127700,128000,0,0,0
5.515415,0,30,0,30,-30,128100,128000,767,-767,2233
5.515415,1,0,0,0,0,128100,128000,0,0,0
5.515415,2,52,53,-1,1,128100,128000,650,-13450,-13550
5.515415,3,2,4,-2,2,128100,128000,0,-1000,-1200
5.515415,4,0,50,-50,50,128100,128000,-636,-1364,-6364
5.515415,5,35,50,-15,15,128100,128000,252,-2052,-3552
5.515415,6,0,0,0,0,128100,128000,0,0,0
5.718987,0,30,0,30,-30,128200,128000,767,-767,5233
5.718987,1,0,0,0,0,128200,128000,0,0,0
5.718987,2,52,55,-3,3,128200,128000,624,-13224,-13824
5.718987,3,4,4,0,0,128200,128000,51,-1451,-1451
5.718987,4,0,50,-50,50,128200,128000,-636,-1364,-11364
5.718987,5,35,50,-15,15,128200,128000,252,-2052,-5052
5.718987,6,0,0,0,0,128200,128000,0,0,0
6.02431,0,30,0,30,-30,128200,128000,767,-767,5233
6.02431,1,0,0,0,0,128200,128000,0,0,0
6.02431,2,52,55,-3,3,128200,128000,624,-13224,-13824
6.02431,3,4,4,0,0,128200,128000,51,-1451,-1451
6.02431,4,0,50,-50,50,128200,128000,-636,-1364,-11364
6.02431,5,35,50,-15,15,128200,128000,252,-2052,-5052
6.02431,6,0,0,0,0,128200,128000,0,0,0
6.269509,0,30,20,10,-10,128000,128000,1280,4720,4720
6.269509,1,0,0,0,0,128000,128000,0,0,0
6.269509,2,72,65,7,-7,128000,128000,240,-17840,-17840
6.269509,3,4,4,0,0,128000,128000,51,-1451,-1451
6.269509,4,0,50,-50,50,128000,128000,-636,-1364,-1364
6.269509,5,55,50,5,-5,128000,128000,380,-11180,-11180
6.269509,6,0,0,0,0,128000,128000,0,0,0
6.547782,0,30,20,10,-10,127200,127700,1280,4720,2170
6.547782,1,0,0,0,0,127200,127700,0,0,0
6.547782,2,82,75,7,-7,127200,127700,23,-17623,-19408
6.547782,3,6,4,2,-2,127200,127700,25,-825,-1335
6.547782,4,0,50,-50,50,127200,127700,-636,-1364,11386
6.547782,5,65,59,6,-6,127200,127700,866,-13566,-15096
6.547782,6,0,0,0,0,127200,127700,0,0,0
6.701628,0,30,20,10,-10,127700,127700,1280,4720,4720
6.701628,1,0,0,0,0,127700,127700,0,0,0
6.701628,2,82,85,-3,3,127700,127700,278,-17878,-17878
6.701628,3,6,4,2,-2,127700,127700,25,-825,-825
6.701628,4,0,50,-50,50,127700,127700,-636,-1364,-1364
6.701628,5,75,59,16,-16,127700,127700,738,-15438,-15438
6.701628,6,0,0,0,0,127700,127700,0,0,0
6.98059,0,30,20,10,-10,128200,127700,1280,4720,7270
6.98059,1,0,0,0,0,128200,127700,0,0,0
6.98059,2,82,95,-13,13,128200,127700,150,-16750,-20065
6.98059,3,6,6,0,0,128200,127700,-1,-199,-199
6.98059,4,0,50,-50,50,128200,127700,-636,-1364,-14114
6.98059,5,75,59,16,-16,128200,127700,738,-15438,-11358
6.98059,6,0,0,0,0,128200,127700,0,0,0
7.272,0,30,20,10,-10,127300,127600,1280,4720,2170
7.272,1,0,0,0,0,127300,127600,0,0,0
7.272,2,102,95,7,-7,127300,127600,277,-13877,-15662
7.272,3,8,6,2,-2,127300,127600,50,350,-160
7.272,4,0,50,-50,50,127300,127600,-636,-1364,11386
7.272,5,85,59,26,-26,127300,127600,610,-14310,-20940
7.272,6,0,0,0,0,127300,127600,0,0,0
7.503853,0,41,20,21,-21,127400,127600,1560,5540,1340
7.503853,1,0,0,0,0,127400,127600,0,0,0
7.503853,2,112,95,17,-17,127400,127600,532,-15132,-18532
7.503853,3,8,8,0,0,127400,127600,101,-101,-101
7.503853,4,0,50,-50,50,127400,127600,-636,-1364,8636
7.503853,5,87,69,18,-18,127400,127600,457,-15157,-18757
7.503853,6,0,0,0,0,127400,127600,0,0,0
7.768488,0,41,20,21,-21,127300,127600,1560,5540,185
7.768488,1,0,0,0,0,127300,127600,0,0,0
7.768488,2,122,105,17,-17,127300,127600,660,-13260,-17595
7.768488,3,8,8,0,0,127300,127600,101,-101,-101
7.768488,4,0,50,-50,50,127300,127600,-636,-1364,11386
7.768488,5,97,69,28,-28,127300,127600,330,-15030,-22170
7.768488,6,0,0,0,0,127300,127600,0,0,0
7.959815,0,71,20,51,-51,127200,127600,2323,16777,3772
7.959815,1,0,0,0,0,127200,127600,0,0,0
7.959815,2,125,105,20,-20,127200,127600,736,-12136,-17236
7.959815,3,8,8,0,0,127200,127600,101,-101,-101
7.959815,4,0,50,-50,50,127200,127600,-636,-1364,11386
7.959815,5,97,69,28,-28,127200,127600,330,-15030,-22170
7.959815,6,0,0,0,0,127200,127600,0,0,0
8.221947,0,71,20,51,-51,127500,127600,2323,16777,11677
8.221947,1,0,0,0,0,127500,127600,0,0,0
8.221947,2,132,105,27,-27,127500,127600,647,-12047,-14747
8.221947,3,8,8,0,0,127500,127600,101,-101,-101
8.221947,4,0,50,-50,50,127500,127600,-636,-1364,3636
8.221947,5,97,76,21,-21,127500,127600,508,-16608,-18708
8.221947,6,0,0,0,0,127500,127600,0,0,0
8.510076,0,71,20,51,-51,127400,127400,2323,16777,16777
8.510076,1,10,0,10,-10,127400,127400,255,-255,-255
8.510076,2,132,105,27,-27,127400,127400,647,-12047,-12047
8.510076,3,8,8,0,0,127400,127400,101,-101,-101
8.510076,4,0,50,-50,50,127400,127400,-636,-1364,-1364
8.510076,5,97,86,11,-11,127400,127400,381,-18481,-18481
8.510076,6,0,0,0,0,127400,127400,0,0,0
8.728047,0,71,20,51,-51,127400,127400,2323,16777,16777
8.728047,1,10,0,10,-10,127400,127400,255,-255,-255
8.728047,2,132,105,27,-27,127400,127400,647,-12047,-12047
8.728047,3,8,8,0,0,127400,127400,101,-101,-101
8.728047,4,0,50,-50,50,127400,127400,-636,-1364,-1364
8.728047,5,97,86,11,-11,127400,127400,381,-18481,-18481
8.728047,6,0,0,0,0,127400,127400,0,0,0
9.046787,0,71,20,51,-51,127500,127400,2323,16777,21877
9.046787,1,20,0,20,-20,127500,127400,510,490,2490
9.046787,2,132,115,17,-17,127500,127400,519,-13919,-12219
9.046787,3,8,8,0,0,127500,127400,101,-101,-101
9.046787,4,0,50,-50,50,127500,127400,-636,-1364,-6364
9.046787,5,97,86,11,-11,127500,127400,381,-18481,-17381
9.046787,6,0,0,0,0,127500,127400,0,0,0
9.252497,0,71,20,51,-51,127500,127800,2323,16777,3721
9.252497,1,20,0,20,-20,127500,127800,510,490,-4630
9.252497,2,132,115,17,-17,127500,127800,519,-13919,-18271
9.252497,3,8,8,0,0,127500,127800,101,-101,-101
9.252497,4,0,50,-50,50,127500,127800,-636,-1364,11436
9.252497,5,97,86,11,-11,127500,127800,381,-18481,-21297
9.252497,6,0,0,0,0,127500,127800,0,0,0
9.463307,0,71,20,51,-51,127500,127800,2323,16777,3721
9.463307,1,20,0,20,-20,127500,127800,510,490,-4630
9.463307,2,132,115,17,-17,127500,127800,519,-13919,-18271
9.463307,3,8,8,0,0,127500,127800,101,-101,-101
9.463307,4,0,50,-50,50,127500,127800,-636,-1364,11436
9.463307,5,97,86,11,-11,127500,127800,381,-18481,-21297
9.463307,6,0,0,0,0,127500,127800,0,0,0
9.749689,0,71,20,51,-51,127000,127800,2323,16777,3721
9.749689,1,20,0,20,-20,127000,127800,510,490,-4630
9.749689,2,152,115,37,-37,127000,127800,263,-13663,-23135
9.749689,3,10,8,2,-2,127000,127800,76,524,12
9.749689,4,0,50,-50,50,127000,127800,-636,-1364,11436
9.749689,5,107,96,11,-11,127000,127800,508,-18608,-21424
9.749689,6,0,0,0,0,127000,127800,0,0,0
10.03609,0,71,20,51,-51,127400,127500,2323,16777,11677
10.03609,1,20,0,20,-20,127400,127500,510,490,-1510
10.03609,2,152,125,27,-27,127400,127500,136,-16536,-19236
10.03609,3,10,8,2,-2,127400,127500,76,524,324
10.03609,4,0,50,-50,50,127400,127500,-636,-1364,3636
10.03609,5,117,96,21,-21,127400,127500,763,-16863,-18963
10.03609,6,0,0,0,0,127400,127500,0,0,0
10.21397,0,71,20,51,-51,127000,127500,2323,16777,3772
10.21397,1,20,0,20,-20,127000,127500,510,490,-4610
10.21397,2,162,125,37,-37,127000,127500,9,-14409,-23844
10.21397,3,12,8,4,-4,127000,127500,51,1149,129
10.21397,4,0,50,-50,50,127000,127500,-636,-1364,11386
10.21397,5,127,96,31,-31,127000,127500,636,-15736,-23641
10.21397,6,0,0,0,0,127000,127500,0,0,0
10.534729,0,71,20,51,-51,127100,127500,2323,16777,3772
10.534729,1,20,0,20,-20,127100,127500,510,490,-4610
10.534729,2,166,125,41,-41,127100,127500,-42,-13158,-23613
10.534729,3,12,8,4,-4,127100,127500,51,1149,129
10.534729,4,0,50,-50,50,127100,127500,-636,-1364,11386
10.534729,5,137,96,41,-41,127100,127500,509,-13609,-24064
10.534729,6,0,0,0,0,127100,127500,0,0,0
10.711203,0,71,20,51,-51,127200,127500,2323,16777,3772
10.711203,1,30,0,30,-30,127200,127500,764,1236,-6414
10.711203,2,166,135,31,-31,127200,127500,-169,-16031,-23936
10.711203,3,12,8,4,-4,127200,127500,51,1149,129
10.711203,4,0,50,-50,50,127200,127500,-636,-1364,11386
10.711203,5,137,96,41,-41,127200,127500,509,-13609,-24064
10.711203,6,0,0,0,0,127200,127500,0,0,0
10.981361,0,71,20,51,-51,127300,127500,2323,16777,6577
10.981361,1,30,0,30,-30,127300,127500,764,1236,-4764
10.981361,2,166,145,21,-21,127300,127500,-296,-18904,-23104
10.981361,3,12,8,4,-4,127300,127500,51,1149,349
10.981361,4,0,50,-50,50,127300,127500,-636,-1364,8636
10.981361,5,137,98,39,-39,127300,127500,484,-14184,-21984
10.981361,6,0,0,0,0,127300,127500,0,0,0
11.265624,0,71,20,51,-51,127900,127600,2323,16777,29782
11.265624,1,38,0,38,-38,127900,127600,968,1832,11522
11.265624,2,166,155,11,-11,127900,127600,-423,-21777,-18972
11.265624,3,12,8,4,-4,127900,127600,51,1149,2169
11.265624,4,0,50,-50,50,127900,127600,-636,-1364,-14114
11.265624,5,137,106,31,-31,127900,127600,382,-16482,-8577
11.265624,6,0,0,0,0,127900,127600,0,0,0
11.476753,0,71,20,51,-51,127900,127600,2323,16777,29782
11.476753,1,38,0,38,-38,127900,127600,968,1832,11522
11.476753,2,166,155,11,-11,127900,127600,-423,-21777,-18972
11.476753,3,12,8,4,-4,127900,127600,51,1149,2169
11.476753,4,0,50,-50,50,127900,127600,-636,-1364,-14114
11.476753,5,137,106,31,-31,127900,127600,382,-16482,-8577
11.476753,6,0,0,0,0,127900,127600,0,0,0
11.746637,0,71,20,51,-51,127400,127600,2323,16777,6577
11.746637,1,38,0,38,-38,127400,127600,968,1832,-5768
11.746637,2,176,155,21,-21,127400,127600,-550,-21650,-25850
11.746637,3,12,8,4,-4,127400,127600,51,1149,349
11.746637,4,0,50,-50,50,127400,127600,-636,-1364,8636
11.746637,5,137,116,21,-21,127400,127600,637,-17737,-21937
11.746637,6,0,0,0,0,127400,127600,0,0,0
12.031646,0,71,20,51,-51,127400,127600,2323,16777,6577
12.031646,1,38,0,38,-38,127400,127600,968,1832,-5768
12.031646,2,176,155,21,-21,127400,127600,-550,-21650,-25850
12.031646,3,12,8,4,-4,127400,127600,51,1149,349
12.031646,4,0,50,-50,50,127400,127600,-636,-1364,8636
12.031646,5,137,116,21,-21,127400,127600,637,-17737,-21937
12.031646,6,0,0,0,0,127400,127600,0,0,0
12.255239,0,71,20,51,-51,127400,127600,2323,16777,6577
12.255239,1,38,0,38,-38,127400,127600,968,1832,-5768
12.255239,2,176,155,21,-21,127400,127600,-550,-21650,-25850
12.255239,3,12,8,4,-4,127400,127600,51,1149,349
12.255239,4,0,50,-50,50,127400,127600,-636,-1364,8636
12.255239,5,137,116,21,-21,127400,127600,637,-17737,-21937
12.255239,6,0,0,0,0,127400,127600,0,0,0
12.511755,0,71,20,51,-51,127400,127600,2323,16777,6577
12.511755,1,38,0,38,-38,127400,127600,968,1832,-5768
12.511755,2,176,165,11,-11,127400,127600,-295,-23905,-26105
12.511755,3,12,8,4,-4,127400,127600,51,1149,349
12.511755,4,0,50,-50,50,127400,127600,-636,-1364,8636
12.511755,5,147,116,31,-31,127400,127600,510,-16610,-22810
12.511755,6,0,0,0,0,127400,127600,0,0,0
12.766728,0,71,20,51,-51,127600,127700,2323,16777,11677
12.766728,1,38,0,38,-38,127600,127700,968,1832,-1968
12.766728,2,186,174,12,-12,127600,127700,-155,-24845,-26045
12.766728,3,12,8,4,-4,127600,127700,51,1149,749
12.766728,4,0,50,-50,50,127600,127700,-636,-1364,3636
12.766728,5,147,126,21,-21,127600,127700,382,-19482,-21582
12.766728,6,0,0,0,0,127600,127700,0,0,0
13.012156,0,71,20,51,-51,127600,127700,2323,16777,11677
13.012156,1,38,0,38,-38,127600,127700,968,1832,-1968
13.012156,2,186,174,12,-12,127600,127700,-155,-24845,-26045
13.012156,3,12,8,4,-4,127600,127700,51,1149,749
13.012156,4,0,50,-50,50,127600,127700,-636,-1364,3636
13.012156,5,147,126,21,-21,127600,127700,382,-19482,-21582
13.012156,6,0,0,0,0,127600,127700,0,0,0
13.289144,0,71,20,51,-51,127600,127700,2323,16777,11677
13.289144,1,38,0,38,-38,127600,127700,968,1832,-1968
13.289144,2,186,174,12,-12,127600,127700,-155,-24845,-26045
13.289144,3,12,8,4,-4,127600,127700,51,1149,749
13.289144,4,0,50,-50,50,127600,127700,-636,-1364,3636
13.289144,5,147,126,21,-21,127600,127700,382,-19482,-21582
13.289144,6,0,0,0,0,127600,127700,0,0,0
13.532198,0,71,20,51,-51,128200,127700,2323,16777,29782
13.532198,1,38,0,38,-38,128200,127700,968,1832,11522
13.532198,2,186,184,2,-2,128200,127700,-283,-25717,-25207
13.532198,3,12,10,2,-2,128200,127700,25,1775,2285
13.532198,4,0,50,-50,50,128200,127700,-636,-1364,-14114
13.532198,5,147,126,21,-21,128200,127700,382,-19482,-14127
13.532198,6,0,0,0,0,128200,127700,0,0,0
13.729243,0,71,20,51,-51,128200,127700,2323,16777,29782
13.729243,1,38,0,38,-38,128200,127700,968,1832,11522
13.729243,2,186,184,2,-2,128200,127700,-283,-25717,-25207
13.729243,3,12,10,2,-2,128200,127700,25,1775,2285
13.729243,4,0,50,-50,50,128200,127700,-636,-1364,-14114
13.729243,5,147,126,21,-21,128200,127700,382,-19482,-14127
13.729243,6,0,0,0,0,128200,127700,0,0,0
13.984623,0,71,20,51,-51,128200,127700,2323,16777,29782
13.984623,1,38,0,38,-38,128200,127700,968,1832,11522
13.984623,2,186,194,-8,8,128200,127700,-411,-25589,-27629
13.984623,3,12,12,0,0,128200,127700,-1,2401,2401
13.984623,4,0,50,-50,50,128200,127700,-636,-1364,-14114
13.984623,5,147,136,11,-11,128200,127700,254,-20354,-17549
13.984623,6,0,0,0,0,128200,127700,0,0,0
14.286722,0,71,20,51,-51,127600,127600,2323,16777,16777
14.286722,1,38,0,38,-38,127600,127600,968,1832,1832
14.286722,2,196,194,2,-2,127600,127600,-156,-26844,-26844
14.286722,3,12,12,0,0,127600,127600,-1,2401,2401
14.286722,4,0,50,-50,50,127600,127600,-636,-1364,-1364
14.286722,5,147,146,1,-1,127600,127600,126,-20226,-20226
14.286722,6,0,0,0,0,127600,127600,0,0,0
14.541416,0,71,20,51,-51,127600,127600,2323,16777,16777
14.541416,1,38,0,38,-38,127600,127600,968,1832,1832
14.541416,2,196,194,2,-2,127600,127600,-156,-26844,-26844
14.541416,3,12,12,0,0,127600,127600,-1,2401,2401
14.541416,4,0,50,-50,50,127600,127600,-636,-1364,-1364
14.541416,5,147,146,1,-1,127600,127600,126,-20226,-20226
14.541416,6,0,0,0,0,127600,127600,0,0,0
14.785697,0,71,20,51,-51,127600,127600,2323,16777,16777
14.785697,1,38,0,38,-38,127600,127600,968,1832,1832
14.785697,2,196,194,2,-2,127600,127600,-156,-26844,-26844
14.785697,3,12,12,0,0,127600,127600,-1,2401,2401
14.785697,4,0,50,-50,50,127600,127600,-636,-1364,-1364
14.785697,5,147,146,1,-1,127600,127600,126,-20226,-20226
14.785697,6,0,0,0,0,127600,127600,0,0,0
15.012992,0,71,20,51,-51,128000,127600,2323,16777,29782
15.012992,1,38,0,38,-38,128000,127600,968,1832,11522
15.012992,2,196,204,-8,8,128000,127600,-284,-26716,-28756
15.012992,3,12,14,-2,2,128000,127600,-27,3027,2517
15.012992,4,0,50,-50,50,128000,127600,-636,-1364,-14114
15.012992,5,147,146,1,-1,128000,127600,126,-20226,-19971
15.012992,6,0,0,0,0,128000,127600,0,0,0
15.274588,0,71,20,51,-51,127800,127600,2323,16777,26977
15.274588,1,38,0,38,-38,127800,127600,968,1832,9432
15.274588,2,196,214,-18,18,127800,127600,-412,-28588,-32188
15.274588,3,12,16,-4,4,127800,127600,-53,3053,2253
15.274588,4,0,50,-50,50,127800,127600,-636,-1364,-11364
15.274588,5,147,146,1,-1,127800,127600,126,-20226,-20026
15.274588,6,0,0,0,0,127800,127600,0,0,0
15.518868,0,71,20,51,-51,127800,127600,2323,16777,26977
15.518868,1,38,0,38,-38,127800,127600,968,1832,9432
15.518868,2,196,214,-18,18,127800,127600,-412,-28588,-32188
15.518868,3,12,16,-4,4,127800,127600,-53,3053,2253
15.518868,4,0,50,-50,50,127800,127600,-636,-1364,-11364
15.518868,5,147,146,1,-1,127800,127600,126,-20226,-20026
15.518868,6,0,0,0,0,127800,127600,0,0,0
15.76097,0,71,30,41,-41,127800,127600,2579,18521,26721
15.76097,1,38,0,38,-38,127800,127600,968,1832,9432
15.76097,2,206,214,-8,8,127800,127600,-540,-32460,-34060
15.76097,3,12,16,-4,4,127800,127600,-53,3053,2253
15.76097,4,0,50,-50,50,127800,127600,-636,-1364,-11364
15.76097,5,147,146,1,-1,127800,127600,126,-20226,-20026
15.76097,6,0,0,0,0,127800,127600,0,0,0
15.952845,0,71,30,41,-41,127800,127600,2579,18521,26721
15.952845,1,38,0,38,-38,127800,127600,968,1832,9432
15.952845,2,206,214,-8,8,127800,127600,-540,-32460,-34060
15.952845,3,12,16,-4,4,127800,127600,-53,3053,2253
15.952845,4,0,50,-50,50,127800,127600,-636,-1364,-11364
15.952845,5,147,146,1,-1,127800,127600,126,-20226,-20026
15.952845,6,0,0,0,0,127800,127600,0,0,0
16.246871,0,71,30,41,-41,127800,127600,2579,18521,26721
16.246871,1,38,0,38,-38,127800,127600,968,1832,9432
16.246871,2,206,214,-8,8,127800,127600,-540,-32460,-34060
16.246871,3,12,16,-4,4,127800,127600,-53,3053,2253
16.246871,4,0,50,-50,50,127800,127600,-636,-1364,-11364
16.246871,5,147,146,1,-1,127800,127600,126,-20226,-20026
16.246871,6,0,0,0,0,127800,127600,0,0,0
16.461744,0,71,30,41,-41,127800,127600,2579,18521,26721
16.461744,1,38,0,38,-38,127800,127600,968,1832,9432
16.461744,2,206,214,-8,8,127800,127600,-540,-32460,-34060
16.461744,3,12,16,-4,4,127800,127600,-53,3053,2253
16.461744,4,0,50,-50,50,127800,127600,-636,-1364,-11364
16.461744,5,147,146,1,-1,127800,127600,126,-20226,-20026
16.461744,6,0,0,0,0,127800,127600,0,0,0
16.774672,0,71,30,41,-41,128100,127600,2579,18521,28976
16.774672,1,38,0,38,-38,128100,127600,968,1832,11522
16.774672,2,206,224,-18,18,128100,127600,-668,-31332,-35922
16.774672,3,12,18,-6,6,128100,127600,-79,3679,2149
16.774672,4,0,50,-50,50,128100,127600,-636,-1364,-14114
16.774672,5,147,146,1,-1,128100,127600,126,-20226,-19971
16.774672,6,0,0,0,0,128100,127600,0,0,0
16.991039,0,71,30,41,-41,128100,127600,2579,18521,28976
16.991039,1,38,0,38,-38,128100,127600,968,1832,11522
16.991039,2,206,224,-18,18,128100,127600,-668,-31332,-35922
16.991039,3,12,18,-6,6,128100,127600,-79,3679,2149
16.991039,4,0,50,-50,50,128100,127600,-636,-1364,-14114
16.991039,5,147,146,1,-1,128100,127600,126,-20226,-19971
16.991039,6,0,0,0,0,128100,127600,0,0,0
17.209781,0,71,30,41,-41,128100,127600,2579,18521,28976
17.209781,1,38,0,38,-38,128100,127600,968,1832,11522
17.209781,2,206,224,-18,18,128100,127600,-668,-31332,-35922
17.209781,3,12,18,-6,6,128100,127600,-79,3679,2149
17.209781,4,0,50,-50,50,128100,127600,-636,-1364,-14114
17.209781,5,147,146,1,-1,128100,127600,126,-20226,-19971
17.209781,6,0,0,0,0,128100,127600,0,0,0
17.466466,0,71,30,41,-41,127800,127700,2579,18521,22621
17.466466,1,38,0,38,-38,127800,127700,968,1832,5632
17.466466,2,216,224,-8,8,127800,127700,-412,-33588,-34388
17.466466,3,12,18,-6,6,127800,127700,-79,3679,3079
17.466466,4,0,50,-50,50,127800,127700,-636,-1364,-6364
17.466466,5,147,156,-9,9,127800,127700,-2,-20098,-20998
17.466466,6,0,0,0,0,127800,127700,0,0,0
17.744852,0,71,30,41,-41,127800,127700,2579,18521,22621
17.744852,1,38,0,38,-38,127800,127700,968,1832,5632
17.744852,2,216,224,-8,8,127800,127700,-412,-33588,-34388
17.744852,3,12,18,-6,6,127800,127700,-79,3679,3079
17.744852,4,0,50,-50,50,127800,127700,-636,-1364,-6364
17.744852,5,147,156,-9,9,127800,127700,-2,-20098,-20998
17.744852,6,0,0,0,0,127800,127700,0,0,0
17.984684,0,71,30,41,-41,127800,127800,2579,18521,18521
17.984684,1,38,0,38,-38,127800,127800,968,1832,1832
17.984684,2,216,224,-8,8,127800,127800,-412,-33588,-33588
17.984684,3,12,18,-6,6,127800,127800,-79,3679,3679
17.984684,4,0,50,-50,50,127800,127800,-636,-1364,-1364
17.984684,5,147,156,-9,9,127800,127800,-2,-20098,-20098
17.984684,6,0,0,0,0,127800,127800,0,0,0
18.272867,0,71,30,41,-41,127800,127800,2579,18521,18521
18.272867,1,38,0,38,-38,127800,127800,968,1832,1832
18.272867,2,216,224,-8,8,127800,127800,-412,-33588,-33588
18.272867,3,12,18,-6,6,127800,127800,-79,3679,3679
18.272867,4,0,50,-50,50,127800,127800,-636,-1364,-1364
18.272867,5,147,156,-9,9,127800,127800,-2,-20098,-20098
18.272867,6,0,0,0,0,127800,127800,0,0,0
18.526854,0,71,30,41,-41,127500,128000,2579,18521,8025
18.526854,1,38,0,38,-38,127500,128000,968,1832,-7896
18.526854,2,226,224,2,-2,127500,128000,-540,-33460,-33972
18.526854,3,12,18,-6,6,127500,128000,-79,3679,5215
18.526854,4,0,50,-50,50,127500,128000,-636,-1364,11436
18.526854,5,157,156,1,-1,127500,128000,-130,-18970,-19226
18.526854,6,0,0,0,0,127500,128000,0,0,0
18.70828,0,71,30,41,-41,127500,128000,2579,18521,8025
18.70828,1,38,0,38,-38,127500,128000,968,1832,-7896
18.70828,2,226,224,2,-2,127500,128000,-540,-33460,-33972
18.70828,3,12,18,-6,6,127500,128000,-79,3679,5215
18.70828,4,0,50,-50,50,127500,128000,-636,-1364,11436
18.70828,5,157,156,1,-1,127500,128000,-130,-18970,-19226
18.70828,6,0,0,0,0,127500,128000,0,0,0
18.962036,0,71,30,41,-41,127500,128000,2579,18521,8025
18.962036,1,38,0,38,-38,127500,128000,968,1832,-7896
18.962036,2,226,224,2,-2,127500,128000,-540,-33460,-33972
18.962036,3,12,18,-6,6,127500,128000,-79,3679,5215
18.962036,4,0,50,-50,50,127500,128000,-636,-1364,11436
18.962036,5,157,156,1,-1,127500,128000,-130,-18970,-19226
18.962036,6,0,0,0,0,127500,128000,0,0,0
19.257316,0,71,30,41,-41,127500,128000,2579,18521,8025
19.257316,1,38,0,38,-38,127500,128000,968,1832,-7896
19.257316,2,226,224,2,-2,127500,128000,-540,-33460,-33972
19.257316,3,12,18,-6,6,127500,128000,-79,3679,5215
19.257316,4,0,50,-50,50,127500,128000,-636,-1364,11436
19.257316,5,157,156,1,-1,127500,128000,-130,-18970,-19226
19.257316,6,0,0,0,0,127500,128000,0,0,0
19.514242,0,71,30,41,-41,127500,128000,2579,18521,8025
19.514242,1,38,0,38,-38,127500,128000,968,1832,-7896
19.514242,2,226,224,2,-2,127500,128000,-540,-33460,-33972
19.514242,3,12,18,-6,6,127500,128000,-79,3679,5215
19.514242,4,0,50,-50,50,127500,128000,-636,-1364,11436
19.514242,5,157,156,1,-1,127500,128000,-130,-18970,-19226
19.514242,6,0,0,0,0,127500,128000,0,0,0
19.761049,0,71,30,41,-41,127500,128000,2579,18521,8025
19.761049,1,38,0,38,-38,127500,128000,968,1832,-7896
19.761049,2,226,224,2,-2,127500,128000,-540,-33460,-33972
19.761049,3,12,18,-6,6,127500,128000,-79,3679,5215
19.761049,4,0,50,-50,50,127500,128000,-636,-1364,11436
19.761049,5,157,156,1,-1,127500,128000,-130,-18970,-19226
19.761049,6,0,0,0,0,127500,128000,0,0,0
20.02142,0,71,30,41,-41,127500,128000,2579,18521,8025
20.02142,1,38,0,38,-38,127500,128000,968,1832,-7896
20.02142,2,226,224,2,-2,127500,128000,-540,-33460,-33972
20.02142,3,12,18,-6,6,127500,128000,-79,3679,5215
20.02142,4,0,50,-50,50,127500,128000,-636,-1364,11436
20.02142,5,157,156,1,-1,127500,128000,-130,-18970,-19226
20.02142,6,0,0,0,0,127500,128000,0,0,0
20.223685,0,71,30,41,-41,127500,128000,2579,18521,8025
20.223685,1,38,0,38,-38,127500,128000,968,1832,-7896
20.223685,2,226,224,2,-2,127500,128000,-540,-33460,-33972
20.223685,3,12,18,-6,6,127500,128000,-79,3679,5215
20.223685,4,0,50,-50,50,127500,128000,-636,-1364,11436
20.223685,5,157,156,1,-1,127500,128000,-130,-18970,-19226
20.223685,6,0,0,0,0,127500,128000,0,0,0
20.477076,0,71,30,41,-41,128100,128000,2579,18521,22621
20.477076,1,38,0,38,-38,128100,128000,968,1832,5632
20.477076,2,226,234,-8,8,128100,128000,-668,-35332,-36132
20.477076,3,14,18,-4,4,128100,128000,-28,3428,3028
20.477076,4,0,50,-50,50,128100,128000,-636,-1364,-6364
20.477076,5,167,158,9,-9,128100,128000,100,-19400,-18500
20.477076,6,0,0,0,0,128100,128000,0,0,0
20.703848,0,71,30,41,-41,128100,128000,2579,18521,22621
20.703848,1,38,0,38,-38,128100,128000,968,1832,5632
20.703848,2,226,234,-8,8,128100,128000,-668,-35332,-36132
20.703848,3,14,18,-4,4,128100,128000,-28,3428,3028
20.703848,4,0,50,-50,50,128100,128000,-636,-1364,-6364
20.703848,5,167,158,9,-9,128100,128000,100,-19400,-18500
20.703848,6,0,0,0,0,128100,128000,0,0,0
21.04997,0,71,30,41,-41,128100,128100,2579,18521,18521
21.04997,1,38,0,38,-38,128100,128100,968,1832,1832
21.04997,2,226,234,-8,8,128100,128100,-668,-35332,-35332
21.04997,3,14,18,-4,4,128100,128100,-28,3428,3428
21.04997,4,0,50,-50,50,128100,128100,-636,-1364,-1364
21.04997,5,167,158,9,-9,128100,128100,100,-19400,-19400
21.04997,6,0,0,0,0,128100,128100,0,0,0
21.269299,0,71,30,41,-41,128400,128100,2579,18521,29017
21.269299,1,38,0,38,-38,128400,128100,968,1832,11560
21.269299,2,236,244,-8,8,128400,128100,-539,-38461,-40509
21.269299,3,16,18,-2,2,128400,128100,23,3177,2665
21.269299,4,0,50,-50,50,128400,128100,-636,-1364,-14164
21.269299,5,177,158,19,-19,128400,128100,356,-18656,-13792
21.269299,6,0,0,0,0,128400,128100,0,0,0
21.538622,0,71,30,41,-41,128400,128100,2579,18521,29017
21.538622,1,38,0,38,-38,128400,128100,968,1832,11560
21.538622,2,246,244,2,-2,128400,128100,-282,-39718,-39206
21.538622,3,16,18,-2,2,128400,128100,23,3177,2665
21.538622,4,0,50,-50,50,128400,128100,-636,-1364,-14164
21.538622,5,177,164,13,-13,128400,128100,279,-18579,-15251
21.538622,6,0,0,0,0,128400,128100,0,0,0
21.714848,0,71,30,41,-41,128400,128100,2579,18521,29017
21.714848,1,38,0,38,-38,128400,128100,968,1832,11560
21.714848,2,246,244,2,-2,128400,128100,-282,-39718,-39206
21.714848,3,16,18,-2,2,128400,128100,23,3177,2665
21.714848,4,0,50,-50,50,128400,128100,-636,-1364,-14164
21.714848,5,177,164,13,-13,128400,128100,279,-18579,-15251
21.714848,6,0,0,0,0,128400,128100,0,0,0
21.954721,0,71,30,41,-41,127600,128100,2579,18521,8025
21.954721,1,38,0,38,-38,127600,128100,968,1832,-7896
21.954721,2,256,246,10,-10,127600,128100,-436,-39564,-42124
21.954721,3,18,18,0,0,127600,128100,-3,3803,3803
21.954721,4,0,50,-50,50,127600,128100,-636,-1364,11436
21.954721,5,187,164,23,-23,127600,128100,151,-17451,-23339
21.954721,6,0,0,0,0,127600,128100,0,0,0
22.228691,0,71,30,41,-41,127600,128100,2579,18521,8025
22.228691,1,38,0,38,-38,127600,128100,968,1832,-7896
22.228691,2,256,246,10,-10,127600,128100,-436,-39564,-42124
22.228691,3,18,18,0,0,127600,128100,-3,3803,3803
22.228691,4,0,50,-50,50,127600,128100,-636,-1364,11436
22.228691,5,187,164,23,-23,127600,128100,151,-17451,-23339
22.228691,6,0,0,0,0,127600,128100,0,0,0
22.457249,0,71,30,41,-41,128100,128100,2579,18521,18521
22.457249,1,38,0,38,-38,128100,128100,968,1832,1832
22.457249,2,266,246,20,-20,128100,128100,-564,-39436,-39436
22.457249,3,18,18,0,0,128100,128100,-3,3803,3803
22.457249,4,0,50,-50,50,128100,128100,-636,-1364,-1364
22.457249,5,187,174,13,-13,128100,128100,407,-18707,-18707
22.457249,6,0,0,0,0,128100,128100,0,0,0
22.702995,0,71,30,41,-41,127900,128100,2579,18521,10321
22.702995,1,38,0,38,-38,127900,128100,968,1832,-5768
22.702995,2,266,256,10,-10,127900,128100,-308,-41692,-43692
22.702995,3,18,18,0,0,127900,128100,-3,3803,3803
22.702995,4,0,50,-50,50,127900,128100,-636,-1364,8636
22.702995,5,197,174,23,-23,127900,128100,279,-17579,-22179
22.702995,6,0,0,0,0,127900,128100,0,0,0
22.964878,0,71,30,41,-41,127900,128100,2579,18521,10321
22.964878,1,38,0,38,-38,127900,128100,968,1832,-5768
22.964878,2,266,256,10,-10,127900,128100,-308,-41692,-43692
22.964878,3,18,18,0,0,127900,128100,-3,3803,3803
22.964878,4,0,50,-50,50,127900,128100,-636,-1364,8636
22.964878,5,197,174,23,-23,127900,128100,279,-17579,-22179
22.964878,6,0,0,0,0,127900,128100,0,0,0
23.289483,0,71,30,41,-41,128200,128100,2579,18521,22621
23.289483,1,38,0,38,-38,128200,128100,968,1832,5632
23.289483,2,266,266,0,0,128200,128100,-436,-42564,-42564
23.289483,3,18,20,-2,2,128200,128100,-29,4429,4229
23.289483,4,0,50,-50,50,128200,128100,-636,-1364,-6364
23.289483,5,197,174,23,-23,128200,128100,279,-17579,-15279
23.289483,6,0,0,0,0,128200,128100,0,0,0
23.465729,0,71,39,32,-32,128200,127700,2810,20990,29150
23.465729,1,38,0,38,-38,128200,127700,968,1832,11522
23.465729,2,266,266,0,0,128200,127700,-436,-42564,-42564
23.465729,3,18,20,-2,2,128200,127700,-29,4429,3919
23.465729,4,0,50,-50,50,128200,127700,-636,-1364,-14114
23.465729,5,197,174,23,-23,128200,127700,279,-17579,-11714
23.465729,6,0,0,0,0,128200,127700,0,0,0
23.743342,0,71,39,32,-32,128200,127700,2810,20990,29150
23.743342,1,38,0,38,-38,128200,127700,968,1832,11522
23.743342,2,266,266,0,0,128200,127700,-436,-42564,-42564
23.743342,3,18,20,-2,2,128200,127700,-29,4429,3919
23.743342,4,0,50,-50,50,128200,127700,-636,-1364,-14114
23.743342,5,197,174,23,-23,128200,127700,279,-17579,-11714
23.743342,6,0,0,0,0,128200,127700,0,0,0
24.00636,0,71,39,32,-32,128200,127700,2810,20990,29150
24.00636,1,38,0,38,-38,128200,127700,968,1832,11522
24.00636,2,266,266,0,0,128200,127700,-436,-42564,-42564
24.00636,3,18,20,-2,2,128200,127700,-29,4429,3919
24.00636,4,0,50,-50,50,128200,127700,-636,-1364,-14114
24.00636,5,197,174,23,-23,128200,127700,279,-17579,-11714
24.00636,6,0,0,0,0,128200,127700,0,0,0
24.237373,0,71,39,32,-32,128200,127600,2810,20990,29150
24.237373,1,38,0,38,-38,128200,127600,968,1832,11522
24.237373,2,266,266,0,0,128200,127600,-436,-42564,-42564
24.237373,3,18,20,-2,2,128200,127600,-29,4429,3919
24.237373,4,0,50,-50,50,128200,127600,-636,-1364,-14114
24.237373,5,197,174,23,-23,128200,127600,279,-17579,-11714
24.237373,6,0,0,0,0,128200,127600,0,0,0
24.525869,0,71,39,32,-32,128200,127600,2810,20990,29150
24.525869,1,38,0,38,-38,128200,127600,968,1832,11522
24.525869,2,266,266,0,0,128200,127600,-436,-42564,-42564
24.525869,3,18,20,-2,2,128200,127600,-29,4429,3919
24.525869,4,0,50,-50,50,128200,127600,-636,-1364,-14114
24.525869,5,197,174,23,-23,128200,127600,279,-17579,-11714
24.525869,6,0,0,0,0,128200,127600,0,0,0
24.776061,0,71,39,32,-32,127500,127600,2810,20990,17790
24.776061,1,38,0,38,-38,127500,127600,968,1832,-1968
24.776061,2,276,266,10,-10,127500,127600,-564,-42436,-43436
24.776061,3,18,20,-2,2,127500,127600,-29,4429,4629
24.776061,4,0,50,-50,50,127500,127600,-636,-1364,3636
24.776061,5,197,174,23,-23,127500,127600,279,-17579,-19879
24.776061,6,0,0,0,0,127500,127600,0,0,0
24.972071,0,71,39,32,-32,127500,127600,2810,20990,17790
24.972071,1,38,0,38,-38,127500,127600,968,1832,-1968
24.972071,2,276,266,10,-10,127500,127600,-564,-42436,-43436
24.972071,3,18,20,-2,2,127500,127600,-29,4429,4629
24.972071,4,0,50,-50,50,127500,127600,-636,-1364,3636
24.972071,5,197,174,23,-23,127500,127600,279,-17579,-19879
24.972071,6,0,0,0,0,127500,127600,0,0,0
25.237929,0,71,39,32,-32,127500,127700,2810,20990,14590
25.237929,1,38,0,38,-38,127500,127700,968,1832,-5768
25.237929,2,276,266,10,-10,127500,127700,-564,-42436,-44436
25.237929,3,18,20,-2,2,127500,127700,-29,4429,4829
25.237929,4,0,50,-50,50,127500,127700,-636,-1364,8636
25.237929,5,197,174,23,-23,127500,127700,279,-17579,-22179
25.237929,6,0,0,0,0,127500,127700,0,0,0
25.476979,0,71,39,32,-32,127900,127700,2810,20990,27390
25.476979,1,38,0,38,-38,127900,127700,968,1832,9432
25.476979,2,276,266,10,-10,127900,127700,-564,-42436,-40436
25.476979,3,20,20,0,0,127900,127700,22,4378,4378
25.476979,4,0,50,-50,50,127900,127700,-636,-1364,-11364
25.476979,5,197,176,21,-21,127900,127700,253,-17953,-13753
25.476979,6,0,0,0,0,127900,127700,0,0,0
25.799664,0,71,39,32,-32,127900,127700,2810,20990,27390
25.799664,1,38,0,38,-38,127900,127700,968,1832,9432
25.799664,2,276,276,0,0,127900,127700,-692,-43308,-43308
25.799664,3,20,20,0,0,127900,127700,22,4378,4378
25.799664,4,0,50,-50,50,127900,127700,-636,-1364,-11364
25.799664,5,197,184,13,-13,127900,127700,151,-18651,-16051
25.799664,6,0,0,0,0,127900,127700,0,0,0
26.010383,0,71,39,32,-32,127900,127700,2810,20990,27390
26.010383,1,38,0,38,-38,127900,127700,968,1832,9432
26.010383,2,278,276,2,-2,127900,127700,-641,-43359,-42959
26.010383,3,20,20,0,0,127900,127700,22,4378,4378
26.010383,4,0,50,-50,50,127900,127700,-636,-1364,-11364
26.010383,5,197,186,11,-11,127900,127700,125,-18825,-16625
26.010383,6,0,0,0,0,127900,127700,0,0,0
26.214573,0,71,39,32,-32,127900,127700,2810,20990,27390
26.214573,1,38,0,38,-38,127900,127700,968,1832,9432
26.214573,2,278,276,2,-2,127900,127700,-641,-43359,-42959
26.214573,3,20,20,0,0,127900,127700,22,4378,4378
26.214573,4,0,50,-50,50,127900,127700,-636,-1364,-11364
26.214573,5,197,186,11,-11,127900,127700,125,-18825,-16625
26.214573,6,0,0,0,0,127900,127700,0,0,0
26.455362,0,71,39,32,-32,127900,127700,2810,20990,27390
26.455362,1,38,0,38,-38,127900,127700,968,1832,9432
26.455362,2,288,276,12,-12,127900,127700,-385,-43615,-41215
26.455362,3,20,20,0,0,127900,127700,22,4378,4378
26.455362,4,0,50,-50,50,127900,127700,-636,-1364,-11364
26.455362,5,197,196,1,-1,127900,127700,-3,-19697,-19497
26.455362,6,0,0,0,0,127900,127700,0,0,0
26.722041,0,71,39,32,-32,127900,127700,2810,20990,27390
26.722041,1,38,0,38,-38,127900,127700,968,1832,9432
26.722041,2,288,276,12,-12,127900,127700,-385,-43615,-41215
26.722041,3,20,20,0,0,127900,127700,22,4378,4378
26.722041,4,0,50,-50,50,127900,127700,-636,-1364,-11364
26.722041,5,197,196,1,-1,127900,127700,-3,-19697,-19497
26.722041,6,0,0,0,0,127900,127700,0,0,0
26.99551,0,71,39,32,-32,127900,127700,2810,20990,27390
26.99551,1,38,0,38,-38,127900,127700,968,1832,9432
26.99551,2,288,276,12,-12,127900,127700,-385,-43615,-41215
26.99551,3,20,20,0,0,127900,127700,22,4378,4378
26.99551,4,0,50,-50,50,127900,127700,-636,-1364,-11364
26.99551,5,197,196,1,-1,127900,127700,-3,-19697,-19497
26.99551,6,0,0,0,0,127900,127700,0,0,0
27.258233,0,71,39,32,-32,127900,127700,2810,20990,27390
27.258233,1,38,0,38,-38,127900,127700,968,1832,9432
27.258233,2,288,276,12,-12,127900,127700,-385,-43615,-41215
27.258233,3,20,20,0,0,127900,127700,22,4378,4378
27.258233,4,0,50,-50,50,127900,127700,-636,-1364,-11364
27.258233,5,197,196,1,-1,127900,127700,-3,-19697,-19497
27.258233,6,0,0,0,0,127900,127700,0,0,0
27.451078,0,71,39,32,-32,127900,127700,2810,20990,27390
27.451078,1,38,0,38,-38,127900,127700,968,1832,9432
27.451078,2,288,276,12,-12,127900,127700,-385,-43615,-41215
27.451078,3,20,20,0,0,127900,127700,22,4378,4378
27.451078,4,0,50,-50,50,127900,127700,-636,-1364,-11364
27.451078,5,197,196,1,-1,127900,127700,-3,-19697,-19497
27.451078,6,0,0,0,0,127900,127700,0,0,0
27.769883,0,71,39,32,-32,127900,127700,2810,20990,27390
27.769883,1,38,0,38,-38,127900,127700,968,1832,9432
27.769883,2,288,276,12,-12,127900,127700,-385,-43615,-41215
27.769883,3,20,20,0,0,127900,127700,22,4378,4378
27.769883,4,0,50,-50,50,127900,127700,-636,-1364,-11364
27.769883,5,197,196,1,-1,127900,127700,-3,-19697,-19497
27.769883,6,0,0,0,0,127900,127700,0,0,0
28.034893,0,71,39,32,-32,127900,127700,2810,20990,27390
28.034893,1,38,0,38,-38,127900,127700,968,1832,9432
28.034893,2,288,276,12,-12,127900,127700,-385,-43615,-41215
28.034893,3,20,20,0,0,127900,127700,22,4378,4378
28.034893,4,0,50,-50,50,127900,127700,-636,-1364,-11364
28.034893,5,197,196,1,-1,127900,127700,-3,-19697,-19497
28.034893,6,0,0,0,0,127900,127700,0,0,0
28.229261,0,71,39,32,-32,127900,127700,2810,20990,27390
28.229261,1,38,0,38,-38,127900,127700,968,1832,9432
28.229261,2,288,286,2,-2,127900,127700,-513,-44487,-44087
28.229261,3,20,20,0,0,127900,127700,22,4378,4378
28.229261,4,0,50,-50,50,127900,127700,-636,-1364,-11364
28.229261,5,197,196,1,-1,127900,127700,-3,-19697,-19497
28.229261,6,0,0,0,0,127900,127700,0,0,0
28.46798,0,71,39,32,-32,127900,127700,2810,20990,27390
28.46798,1,38,0,38,-38,127900,127700,968,1832,9432
28.46798,2,298,286,12,-12,127900,127700,-257,-44743,-42343
28.46798,3,20,20,0,0,127900,127700,22,4378,4378
28.46798,4,0,50,-50,50,127900,127700,-636,-1364,-11364
28.46798,5,197,196,1,-1,127900,127700,-3,-19697,-19497
28.46798,6,0,0,0,0,127900,127700,0,0,0
28.746721,0,101,39,62,-62,127900,127700,3577,26223,38623
28.746721,1,64,0,64,-64,127900,127700,1633,6367,19167
28.746721,2,308,286,22,-22,127900,127700,-1,-42999,-38599
28.746721,3,22,20,2,-2,127900,127700,73,4727,5127
28.746721,4,0,50,-50,50,127900,127700,-636,-1364,-11364
28.746721,5,207,196,11,-11,127900,127700,253,-17953,-15753
28.746721,6,0,0,0,0,127900,127700,0,0,0
28.982768,0,101,39,62,-62,127900,127700,3577,26223,38623
28.982768,1,64,0,64,-64,127900,127700,1633,6367,19167
28.982768,2,308,286,22,-22,127900,127700,-1,-42999,-38599
28.982768,3,22,20,2,-2,127900,127700,73,4727,5127
28.982768,4,0,50,-50,50,127900,127700,-636,-1364,-11364
28.982768,5,207,196,11,-11,127900,127700,253,-17953,-15753
28.982768,6,0,0,0,0,127900,127700,0,0,0
29.256183,0,101,39,62,-62,128500,127700,3577,26223,42033
29.256183,1,74,0,74,-74,128500,127700,1889,7111,25981
29.256183,2,308,296,12,-12,128500,127700,-129,-44871,-41811
29.256183,3,22,22,0,0,128500,127700,47,5153,5153
29.256183,4,0,50,-50,50,128500,127700,-636,-1364,-14114
29.256183,5,207,206,1,-1,128500,127700,125,-18825,-18570
29.256183,6,0,0,0,0,128500,127700,0,0,0
29.499903,0,101,39,62,-62,128500,127700,3577,26223,42033
29.499903,1,74,0,74,-74,128500,127700,1889,7111,25981
29.499903,2,308,296,12,-12,128500,127700,-129,-44871,-41811
29.499903,3,22,22,0,0,128500,127700,47,5153,5153
29.499903,4,0,50,-50,50,128500,127700,-636,-1364,-14114
29.499903,5,207,206,1,-1,128500,127700,125,-18825,-18570
29.499903,6,0,0,0,0,128500,127700,0,0,0
29.725887,0,101,39,62,-62,128500,127700,3577,26223,42033
29.725887,1,74,0,74,-74,128500,127700,1889,7111,25981
29.725887,2,308,296,12,-12,128500,127700,-129,-44871,-41811
29.725887,3,22,22,0,0,128500,127700,47,5153,5153
29.725887,4,0,50,-50,50,128500,127700,-636,-1364,-14114
29.725887,5,207,206,1,-1,128500,127700,125,-18825,-18570
29.725887,6,0,0,0,0,128500,127700,0,0,0
29.97179,0,101,39,62,-62,128500,127700,3577,26223,42033
29.97179,1,74,0,74,-74,128500,127700,1889,7111,25981
29.97179,2,308,296,12,-12,128500,127700,-129,-44871,-41811
29.97179,3,22,22,0,0,128500,127700,47,5153,5153
29.97179,4,0,50,-50,50,128500,127700,-636,-1364,-14114
29.97179,5,207,206,1,-1,128500,127700,125,-18825,-18570
29.97179,6,0,0,0,0,128500,127700,0,0,0
30.294776,0,111,39,72,-72,128100,127700,3833,27967,46327
30.294776,1,74,0,74,-74,128100,127700,1889,7111,25981
30.294776,2,315,306,9,-9,128100,127700,-347,-47653,-45358
30.294776,3,22,22,0,0,128100,127700,47,5153,5153
30.294776,4,0,50,-50,50,128100,127700,-636,-1364,-14114
30.294776,5,217,206,11,-11,128100,127700,-3,-18697,-15892
30.294776,6,0,0,0,0,128100,127700,0,0,0
30.475752,0,111,39,72,-72,128100,127700,3833,27967,46327
30.475752,1,74,0,74,-74,128100,127700,1889,7111,25981
30.475752,2,315,306,9,-9,128100,127700,-347,-47653,-45358
30.475752,3,22,22,0,0,128100,127700,47,5153,5153
30.475752,4,0,50,-50,50,128100,127700,-636,-1364,-14114
30.475752,5,217,206,11,-11,128100,127700,-3,-18697,-15892
30.475752,6,0,0,0,0,128100,127700,0,0,0
30.774066,0,111,39,72,-72,128100,127700,3833,27967,46327
30.774066,1,74,0,74,-74,128100,127700,1889,7111,25981
30.774066,2,315,306,9,-9,128100,127700,-347,-47653,-45358
30.774066,3,22,22,0,0,128100,127700,47,5153,5153
30.774066,4,0,50,-50,50,128100,127700,-636,-1364,-14114
30.774066,5,217,206,11,-11,128100,127700,-3,-18697,-15892
30.774066,6,0,0,0,0,128100,127700,0,0,0
31.040802,0,111,39,72,-72,128100,127700,3833,27967,46327
31.040802,1,74,0,74,-74,128100,127700,1889,7111,25981
31.040802,2,315,306,9,-9,128100,127700,-347,-47653,-45358
31.040802,3,22,22,0,0,128100,127700,47,5153,5153
31.040802,4,0,50,-50,50,128100,127700,-636,-1364,-14114
31.040802,5,217,206,11,-11,128100,127700,-3,-18697,-15892
31.040802,6,0,0,0,0,128100,127700,0,0,0
31.300022,0,111,39,72,-72,128500,127700,3833,27967,46327
31.300022,1,74,0,74,-74,128500,127700,1889,7111,25981
31.300022,2,315,316,-1,1,128500,127700,-475,-47525,-47780
31.300022,3,22,24,-2,2,128500,127700,21,5779,5269
31.300022,4,0,50,-50,50,128500,127700,-636,-1364,-14114
31.300022,5,217,206,11,-11,128500,127700,-3,-18697,-15892
31.300022,6,0,0,0,0,128500,127700,0,0,0
31.455224,0,111,39,72,-72,128500,127800,3833,27967,46399
31.455224,1,74,0,74,-74,128500,127800,1889,7111,26055
31.455224,2,315,316,-1,1,128500,127800,-475,-47525,-47781
31.455224,3,22,24,-2,2,128500,127800,21,5779,5267
31.455224,4,0,50,-50,50,128500,127800,-636,-1364,-14164
31.455224,5,217,206,11,-11,128500,127800,-3,-18697,-15881
31.455224,6,0,0,0,0,128500,127800,0,0,0
31.748023,0,111,39,72,-72,128500,127800,3833,27967,46399
31.748023,1,74,0,74,-74,128500,127800,1889,7111,26055
31.748023,2,315,316,-1,1,128500,127800,-475,-47525,-47781
31.748023,3,22,24,-2,2,128500,127800,21,5779,5267
31.748023,4,0,50,-50,50,128500,127800,-636,-1364,-14164
31.748023,5,217,206,11,-11,128500,127800,-3,-18697,-15881
31.748023,6,0,0,0,0,128500,127800,0,0,0
32.040686,0,111,39,72,-72,128500,127800,3833,27967,46399
32.040686,1,74,0,74,-74,128500,127800,1889,7111,26055
32.040686,2,315,316,-1,1,128500,127800,-475,-47525,-47781
32.040686,3,22,24,-2,2,128500,127800,21,5779,5267
32.040686,4,0,50,-50,50,128500,127800,-636,-1364,-14164
32.040686,5,217,206,11,-11,128500,127800,-3,-18697,-15881
32.040686,6,0,0,0,0,128500,127800,0,0,0
32.218969,0,111,39,72,-72,128500,127800,3833,27967,46399
32.218969,1,74,0,74,-74,128500,127800,1889,7111,26055
32.218969,2,315,316,-1,1,128500,127800,-475,-47525,-47781
32.218969,3,22,24,-2,2,128500,127800,21,5779,5267
32.218969,4,0,50,-50,50,128500,127800,-636,-1364,-14164
32.218969,5,217,206,11,-11,128500,127800,-3,-18697,-15881
32.218969,6,0,0,0,0,128500,127800,0,0,0
32.46079,0,111,39,72,-72,128500,127500,3833,27967,46327
32.46079,1,74,0,74,-74,128500,127500,1889,7111,25981
32.46079,2,315,316,-1,1,128500,127500,-475,-47525,-47780
32.46079,3,22,24,-2,2,128500,127500,21,5779,5269
32.46079,4,0,50,-50,50,128500,127500,-636,-1364,-14114
32.46079,5,217,206,11,-11,128500,127500,-3,-18697,-15892
32.46079,6,0,0,0,0,128500,127500,0,0,0
32.787182,0,111,39,72,-72,127500,127500,3833,27967,27967
32.787182,1,74,0,74,-74,127500,127500,1889,7111,7111
32.787182,2,319,316,3,-3,127500,127500,-526,-47874,-47874
32.787182,3,22,24,-2,2,127500,127500,21,5779,5779
32.787182,4,0,50,-50,50,127500,127500,-636,-1364,-1364
32.787182,5,217,206,11,-11,127500,127500,-3,-18697,-18697
32.787182,6,0,0,0,0,127500,127500,0,0,0
32.97612,0,111,39,72,-72,127500,127500,3833,27967,27967
32.97612,1,74,0,74,-74,127500,127500,1889,7111,7111
32.97612,2,319,316,3,-3,127500,127500,-526,-47874,-47874
32.97612,3,22,24,-2,2,127500,127500,21,5779,5779
32.97612,4,0,50,-50,50,127500,127500,-636,-1364,-1364
32.97612,5,217,206,11,-11,127500,127500,-3,-18697,-18697
32.97612,6,0,0,0,0,127500,127500,0,0,0
33.257706,0,111,39,72,-72,127300,127100,3833,27967,42367
33.257706,1,74,0,74,-74,127300,127100,1889,7111,21911
33.257706,2,329,316,13,-13,127300,127100,-653,-48347,-45747
33.257706,3,22,24,-2,2,127300,127100,21,5779,5379
33.257706,4,0,50,-50,50,127300,127100,-636,-1364,-11364
33.257706,5,222,206,16,-16,127300,127100,-67,-19633,-16433
33.257706,6,0,0,0,0,127300,127100,0,0,0
33.540655,0,111,39,72,-72,127200,127100,3833,27967,35167
33.540655,1,74,0,74,-74,127200,127100,1889,7111,14511
33.540655,2,329,326,3,-3,127200,127100,-399,-48601,-48301
33.540655,3,22,24,-2,2,127200,127100,21,5779,5579
33.540655,4,0,50,-50,50,127200,127100,-636,-1364,-6364
33.540655,5,222,206,16,-16,127200,127100,-67,-19633,-18033
33.540655,6,0,0,0,0,127200,127100,0,0,0
33.764534,0,111,39,72,-72,127200,127100,3833,27967,35167
33.764534,1,74,0,74,-74,127200,127100,1889,7111,14511
33.764534,2,329,336,-7,7,127200,127100,-145,-48855,-49555
33.764534,3,22,24,-2,2,127200,127100,21,5779,5579
33.764534,4,0,50,-50,50,127200,127100,-636,-1364,-6364
33.764534,5,222,206,16,-16,127200,127100,-67,-19633,-18033
33.764534,6,0,0,0,0,127200,127100,0,0,0
34.037255,0,111,39,72,-72,127200,127200,3833,27967,27967
34.037255,1,74,32,42,-42,127200,127200,2702,9498,9498
34.037255,2,329,346,-17,17,127200,127200,109,-48109,-48109
34.037255,3,22,24,-2,2,127200,127200,21,5779,5779
34.037255,4,0,50,-50,50,127200,127200,-636,-1364,-1364
34.037255,5,222,206,16,-16,127200,127200,-67,-19633,-19633
34.037255,6,0,0,0,0,127200,127200,0,0,0
34.266717,0,111,39,72,-72,127100,127200,3833,27967,20767
34.266717,1,74,32,42,-42,127100,127200,2702,9498,5298
34.266717,2,333,346,-13,13,127100,127200,58,-48058,-46758
34.266717,3,22,24,-2,2,127100,127200,21,5779,5979
34.266717,4,0,50,-50,50,127100,127200,-636,-1364,3636
34.266717,5,222,216,6,-6,127100,127200,187,-21887,-22487
34.266717,6,0,0,0,0,127100,127200,0,0,0
34.52456,0,111,39,72,-72,127100,127200,3833,27967,20767
34.52456,1,74,32,42,-42,127100,127200,2702,9498,5298
34.52456,2,343,346,-3,3,127100,127200,313,-50313,-50013
34.52456,3,22,24,-2,2,127100,127200,21,5779,5979
34.52456,4,0,50,-50,50,127100,127200,-636,-1364,3636
34.52456,5,232,223,9,-9,127100,127200,-29,-21971,-22871
34.52456,6,0,0,0,0,127100,127200,0,0,0
34.726433,0,111,39,72,-72,127100,127200,3833,27967,20767
34.726433,1,74,32,42,-42,127100,127200,2702,9498,5298
34.726433,2,353,346,7,-7,127100,127200,567,-51567,-52267
34.726433,3,22,24,-2,2,127100,127200,21,5779,5979
34.726433,4,0,50,-50,50,127100,127200,-636,-1364,3636
34.726433,5,242,225,17,-17,127100,127200,200,-23400,-25100
34.726433,6,0,0,0,0,127100,127200,0,0,0
35.034387,0,111,39,72,-72,127000,127200,3833,27967,13567
35.034387,1,74,32,42,-42,127000,127200,2702,9498,1098
35.034387,2,353,346,7,-7,127000,127200,567,-51567,-52967
35.034387,3,22,24,-2,2,127000,127200,21,5779,6179
35.034387,4,0,50,-50,50,127000,127200,-636,-1364,8636
35.034387,5,242,225,17,-17,127000,127200,200,-23400,-26800
35.034387,6,0,0,0,0,127000,127200,0,0,0
35.292939,0,111,39,72,-72,127000,127200,3833,27967,13567
35.292939,1,74,32,42,-42,127000,127200,2702,9498,1098
35.292939,2,353,346,7,-7,127000,127200,567,-51567,-52967
35.292939,3,22,24,-2,2,127000,127200,21,5779,6179
35.292939,4,0,50,-50,50,127000,127200,-636,-1364,8636
35.292939,5,242,225,17,-17,127000,127200,200,-23400,-26800
35.292939,6,0,0,0,0,127000,127200,0,0,0
35.533653,0,111,39,72,-72,127100,127200,3833,27967,20767
35.533653,1,74,32,42,-42,127100,127200,2702,9498,5298
35.533653,2,363,348,15,-15,127100,127200,796,-52196,-53696
35.533653,3,24,24,0,0,127100,127200,72,5728,5728
35.533653,4,0,50,-50,50,127100,127200,-636,-1364,3636
35.533653,5,242,235,7,-7,127100,127200,73,-25273,-25973
35.533653,6,0,0,0,0,127100,127200,0,0,0
35.704091,0,111,39,72,-72,127300,127200,3833,27967,35167
35.704091,1,74,32,42,-42,127300,127200,2702,9498,13698
35.704091,2,363,358,5,-5,127300,127200,669,-53069,-52569
35.704091,3,24,24,0,0,127300,127200,72,5728,5728
35.704091,4,0,50,-50,50,127300,127200,-636,-1364,-6364
35.704091,5,252,235,17,-17,127300,127200,328,-26528,-24828
35.704091,6,0,0,0,0,127300,127200,0,0,0
35.952799,0,111,39,72,-72,127300,127200,3833,27967,35167
35.952799,1,74,32,42,-42,127300,127200,2702,9498,13698
35.952799,2,363,358,5,-5,127300,127200,669,-53069,-52569
35.952799,3,24,24,0,0,127300,127200,72,5728,5728
35.952799,4,0,50,-50,50,127300,127200,-636,-1364,-6364
35.952799,5,252,235,17,-17,127300,127200,328,-26528,-24828
35.952799,6,0,0,0,0,127300,127200,0,0,0
36.249031,0,111,39,72,-72,127300,127200,3833,27967,35167
36.249031,1,74,32,42,-42,127300,127200,2702,9498,13698
36.249031,2,363,358,5,-5,127300,127200,669,-53069,-52569
36.249031,3,24,24,0,0,127300,127200,72,5728,5728
36.249031,4,0,50,-50,50,127300,127200,-636,-1364,-6364
36.249031,5,252,235,17,-17,127300,127200,328,-26528,-24828
36.249031,6,0,0,0,0,127300,127200,0,0,0
36.499127,0,111,39,72,-72,127300,127200,3833,27967,35167
36.499127,1,74,32,42,-42,127300,127200,2702,9498,13698
36.499127,2,363,358,5,-5,127300,127200,669,-53069,-52569
36.499127,3,24,24,0,0,127300,127200,72,5728,5728
36.499127,4,0,50,-50,50,127300,127200,-636,-1364,-6364
36.499127,5,252,235,17,-17,127300,127200,328,-26528,-24828
36.499127,6,0,0,0,0,127300,127200,0,0,0
36.792072,0,111,39,72,-72,127300,127500,3833,27967,13567
36.792072,1,74,32,42,-42,127300,127500,2702,9498,1098
36.792072,2,363,358,5,-5,127300,127500,669,-53069,-54069
36.792072,3,24,24,0,0,127300,127500,72,5728,5728
36.792072,4,0,50,-50,50,127300,127500,-636,-1364,8636
36.792072,5,252,235,17,-17,127300,127500,328,-26528,-29928
36.792072,6,0,0,0,0,127300,127500,0,0,0
37.009991,0,111,39,72,-72,127300,127500,3833,27967,13567
37.009991,1,74,32,42,-42,127300,127500,2702,9498,1098
37.009991,2,363,358,5,-5,127300,127500,669,-53069,-54069
37.009991,3,24,24,0,0,127300,127500,72,5728,5728
37.009991,4,0,50,-50,50,127300,127500,-636,-1364,8636
37.009991,5,252,235,17,-17,127300,127500,328,-26528,-29928
37.009991,6,0,0,0,0,127300,127500,0,0,0
37.216873,0,111,39,72,-72,127300,127500,3833,27967,13567
37.216873,1,74,32,42,-42,127300,127500,2702,9498,1098
37.216873,2,363,358,5,-5,127300,127500,669,-53069,-54069
37.216873,3,24,24,0,0,127300,127500,72,5728,5728
37.216873,4,0,50,-50,50,127300,127500,-636,-1364,8636
37.216873,5,252,235,17,-17,127300,127500,328,-26528,-29928
37.216873,6,0,0,0,0,127300,127500,0,0,0
37.550708,0,111,39,72,-72,127300,127500,3833,27967,13567
37.550708,1,74,32,42,-42,127300,127500,2702,9498,1098
37.550708,2,363,358,5,-5,127300,127500,669,-53069,-54069
37.550708,3,24,24,0,0,127300,127500,72,5728,5728
37.550708,4,0,50,-50,50,127300,127500,-636,-1364,8636
37.550708,5,252,235,17,-17,127300,127500,328,-26528,-29928
37.550708,6,0,0,0,0,127300,127500,0,0,0
37.717801,0,111,39,72,-72,127300,127500,3833,27967,13567
37.717801,1,74,32,42,-42,127300,127500,2702,9498,1098
37.717801,2,363,358,5,-5,127300,127500,669,-53069,-54069
37.717801,3,24,24,0,0,127300,127500,72,5728,5728
37.717801,4,0,50,-50,50,127300,127500,-636,-1364,8636
37.717801,5,252,235,17,-17,127300,127500,328,-26528,-29928
37.717801,6,0,0,0,0,127300,127500,0,0,0
38.034406,0,111,39,72,-72,127300,127500,3833,27967,13567
38.034406,1,74,32,42,-42,127300,127500,2702,9498,1098
38.034406,2,363,358,5,-5,127300,127500,669,-53069,-54069
38.034406,3,24,24,0,0,127300,127500,72,5728,5728
38.034406,4,0,50,-50,50,127300,127500,-636,-1364,8636
38.034406,5,252,235,17,-17,127300,127500,328,-26528,-29928
38.034406,6,0,0,0,0,127300,127500,0,0,0
38.250852,0,111,39,72,-72,127300,127500,3833,27967,13567
38.250852,1,74,32,42,-42,127300,127500,2702,9498,1098
38.250852,2,363,358,5,-5,127300,127500,669,-53069,-54069
38.250852,3,24,24,0,0,127300,127500,72,5728,5728
38.250852,4,0,50,-50,50,127300,127500,-636,-1364,8636
38.250852,5,252,235,17,-17,127300,127500,328,-26528,-29928
38.250852,6,0,0,0,0,127300,127500,0,0,0
38.454803,0,111,39,72,-72,127300,127500,3833,27967,13567
38.454803,1,74,32,42,-42,127300,127500,2702,9498,1098
38.454803,2,363,358,5,-5,127300,127500,669,-53069,-54069
38.454803,3,24,24,0,0,127300,127500,72,5728,5728
38.454803,4,0,50,-50,50,127300,127500,-636,-1364,8636
38.454803,5,252,235,17,-17,127300,127500,328,-26528,-29928
38.454803,6,0,0,0,0,127300,127500,0,0,0
38.753618,0,111,39,72,-72,127300,127500,3833,27967,13567
38.753618,1,74,32,42,-42,127300,127500,2702,9498,1098
38.753618,2,363,358,5,-5,127300,127500,669,-53069,-54069
38.753618,3,24,24,0,0,127300,127500,72,5728,5728
38.753618,4,0,50,-50,50,127300,127500,-636,-1364,8636
38.753618,5,252,235,17,-17,127300,127500,328,-26528,-29928
38.753618,6,0,0,0,0,127300,127500,0,0,0
39.010924,0,111,39,72,-72,127300,127600,3833,27967,9607
39.010924,1,74,32,42,-42,127300,127600,2702,9498,-1212
39.010924,2,363,358,5,-5,127300,127600,669,-53069,-54344
39.010924,3,24,24,0,0,127300,127600,72,5728,5728
39.010924,4,0,50,-50,50,127300,127600,-636,-1364,11386
39.010924,5,252,235,17,-17,127300,127600,328,-26528,-30863
39.010924,6,0,0,0,0,127300,127600,0,0,0
39.260148,0,111,39,72,-72,127300,127600,3833,27967,9607
39.260148,1,74,32,42,-42,127300,127600,2702,9498,-1212
39.260148,2,363,358,5,-5,127300,127600,669,-53069,-54344
39.260148,3,24,24,0,0,127300,127600,72,5728,5728
39.260148,4,0,50,-50,50,127300,127600,-636,-1364,11386
39.260148,5,252,235,17,-17,127300,127600,328,-26528,-30863
39.260148,6,0,0,0,0,127300,127600,0,0,0
39.541136,0,111,39,72,-72,127300,127600,3833,27967,9607
39.541136,1,74,32,42,-42,127300,127600,2702,9498,-1212
39.541136,2,363,358,5,-5,127300,127600,669,-53069,-54344
39.541136,3,24,24,0,0,127300,127600,72,5728,5728
39.541136,4,0,50,-50,50,127300,127600,-636,-1364,11386
39.541136,5,252,235,17,-17,127300,127600,328,-26528,-30863
39.541136,6,0,0,0,0,127300,127600,0,0,0
39.700597,0,111,39,72,-72,127300,127600,3833,27967,9607
39.700597,1,74,32,42,-42,127300,127600,2702,9498,-1212
39.700597,2,363,358,5,-5,127300,127600,669,-53069,-54344
39.700597,3,24,24,0,0,127300,127600,72,5728,5728
39.700597,4,0,50,-50,50,127300,127600,-636,-1364,11386
39.700597,5,252,235,17,-17,127300,127600,328,-26528,-30863
39.700597,6,0,0,0,0,127300,127600,0,0,0
40.021109,0,111,39,72,-72,127300,127300,3833,27967,27967
40.021109,1,74,32,42,-42,127300,127300,2702,9498,9498
40.021109,2,363,358,5,-5,127300,127300,669,-53069,-53069
40.021109,3,24,24,0,0,127300,127300,72,5728,5728
40.021109,4,0,50,-50,50,127300,127300,-636,-1364,-1364
40.021109,5,252,235,17,-17,127300,127300,328,-26528,-26528
40.021109,6,0,0,0,0,127300,127300,0,0,0
40.269625,0,111,39,72,-72,127300,127300,3833,27967,27967
40.269625,1,74,32,42,-42,127300,127300,2702,9498,9498
40.269625,2,363,358,5,-5,127300,127300,669,-53069,-53069
40.269625,3,24,24,0,0,127300,127300,72,5728,5728
40.269625,4,0,50,-50,50,127300,127300,-636,-1364,-1364
40.269625,5,252,235,17,-17,127300,127300,328,-26528,-26528
40.269625,6,0,0,0,0,127300,127300,0,0,0
40.464127,0,111,39,72,-72,127200,127300,3833,27967,20767
40.464127,1,74,32,42,-42,127200,127300,2702,9498,5298
40.464127,2,373,358,15,-15,127200,127300,923,-53323,-54823
40.464127,3,24,24,0,0,127200,127300,72,5728,5728
40.464127,4,0,50,-50,50,127200,127300,-636,-1364,3636
40.464127,5,252,245,7,-7,127200,127300,201,-28401,-29101
40.464127,6,0,0,0,0,127200,127300,0,0,0
40.764282,0,111,39,72,-72,127200,127300,3833,27967,20767
40.764282,1,74,32,42,-42,127200,127300,2702,9498,5298
40.764282,2,373,358,15,-15,127200,127300,923,-53323,-54823
40.764282,3,24,24,0,0,127200,127300,72,5728,5728
40.764282,4,0,50,-50,50,127200,127300,-636,-1364,3636
40.764282,5,252,245,7,-7,127200,127300,201,-28401,-29101
40.764282,6,0,0,0,0,127200,127300,0,0,0
41.025486,0,111,39,72,-72,127200,127300,3833,27967,20767
41.025486,1,74,32,42,-42,127200,127300,2702,9498,5298
41.025486,2,373,358,15,-15,127200,127300,923,-53323,-54823
41.025486,3,24,24,0,0,127200,127300,72,5728,5728
41.025486,4,0,50,-50,50,127200,127300,-636,-1364,3636
41.025486,5,252,245,7,-7,127200,127300,201,-28401,-29101
41.025486,6,0,0,0,0,127200,127300,0,0,0
41.244479,0,111,39,72,-72,127200,127300,3833,27967,20767
41.244479,1,74,32,42,-42,127200,127300,2702,9498,5298
41.244479,2,373,358,15,-15,127200,127300,923,-53323,-54823
41.244479,3,24,24,0,0,127200,127300,72,5728,5728
41.244479,4,0,50,-50,50,127200,127300,-636,-1364,3636
41.244479,5,252,245,7,-7,127200,127300,201,-28401,-29101
41.244479,6,0,0,0,0,127200,127300,0,0,0
41.486255,0,111,39,72,-72,127200,127300,3833,27967,20767
41.486255,1,74,32,42,-42,127200,127300,2702,9498,5298
41.486255,2,373,358,15,-15,127200,127300,923,-53323,-54823
41.486255,3,24,24,0,0,127200,127300,72,5728,5728
41.486255,4,0,50,-50,50,127200,127300,-636,-1364,3636
41.486255,5,252,245,7,-7,127200,127300,201,-28401,-29101
41.486255,6,0,0,0,0,127200,127300,0,0,0
41.773118,0,111,39,72,-72,127200,127300,3833,27967,20767
41.773118,1,74,32,42,-42,127200,127300,2702,9498,5298
41.773118,2,373,358,15,-15,127200,127300,923,-53323,-54823
41.773118,3,24,24,0,0,127200,127300,72,5728,5728
41.773118,4,0,50,-50,50,127200,127300,-636,-1364,3636
41.773118,5,252,245,7,-7,127200,127300,201,-28401,-29101
41.773118,6,0,0,0,0,127200,127300,0,0,0
42.027636,0,111,39,72,-72,127100,127600,3833,27967,9607
42.027636,1,74,32,42,-42,127100,127600,2702,9498,-1212
42.027636,2,383,358,25,-25,127100,127600,796,-52196,-58571
42.027636,3,24,24,0,0,127100,127600,72,5728,5728
42.027636,4,0,50,-50,50,127100,127600,-636,-1364,11386
42.027636,5,262,245,17,-17,127100,127600,74,-27274,-31609
42.027636,6,0,0,0,0,127100,127600,0,0,0
42.209957,0,121,39,82,-82,127400,127600,4088,28712,12312
42.209957,1,74,32,42,-42,127400,127600,2702,9498,1098
42.209957,2,383,368,15,-15,127400,127600,669,-55069,-58069
42.209957,3,24,24,0,0,127400,127600,72,5728,5728
42.209957,4,0,50,-50,50,127400,127600,-636,-1364,8636
42.209957,5,262,245,17,-17,127400,127600,74,-27274,-30674
42.209957,6,0,0,0,0,127400,127600,0,0,0
42.547522,0,121,39,82,-82,127400,127600,4088,28712,12312
42.547522,1,74,32,42,-42,127400,127600,2702,9498,1098
42.547522,2,393,368,25,-25,127400,127600,542,-56942,-61942
42.547522,3,24,24,0,0,127400,127600,72,5728,5728
42.547522,4,0,50,-50,50,127400,127600,-636,-1364,8636
42.547522,5,272,245,27,-27,127400,127600,-53,-29147,-34547
42.547522,6,0,0,0,0,127400,127600,0,0,0
42.757541,0,121,39,82,-82,127200,127600,4088,28712,7802
42.757541,1,74,32,42,-42,127200,127600,2702,9498,-1212
42.757541,2,393,370,23,-23,127200,127600,593,-57393,-63258
42.757541,3,26,24,2,-2,127200,127600,47,5753,5243
42.757541,4,0,50,-50,50,127200,127600,-636,-1364,11386
42.757541,5,272,245,27,-27,127200,127600,-53,-29147,-36032
42.757541,6,0,0,0,0,127200,127600,0,0,0
43.038825,0,121,39,82,-82,127200,127200,4088,28712,28712
43.038825,1,74,32,42,-42,127200,127200,2702,9498,9498
43.038825,2,393,370,23,-23,127200,127200,593,-57393,-57393
43.038825,3,26,24,2,-2,127200,127200,47,5753,5753
43.038825,4,0,50,-50,50,127200,127200,-636,-1364,-1364
43.038825,5,272,245,27,-27,127200,127200,-53,-29147,-29147
43.038825,6,0,0,0,0,127200,127200,0,0,0
43.215731,0,121,39,82,-82,127100,127200,4088,28712,20512
43.215731,1,74,32,42,-42,127100,127200,2702,9498,5298
43.215731,2,393,380,13,-13,127100,127200,847,-58647,-59947
43.215731,3,26,24,2,-2,127100,127200,47,5753,5553
43.215731,4,0,50,-50,50,127100,127200,-636,-1364,3636
43.215731,5,272,245,27,-27,127100,127200,-53,-29147,-31847
43.215731,6,0,0,0,0,127100,127200,0,0,0
43.459325,0,121,39,82,-82,127100,127200,4088,28712,20512
43.459325,1,74,32,42,-42,127100,127200,2702,9498,5298
43.459325,2,393,390,3,-3,127100,127200,1101,-59901,-60201
43.459325,3,26,24,2,-2,127100,127200,47,5753,5553
43.459325,4,0,50,-50,50,127100,127200,-636,-1364,3636
43.459325,5,272,245,27,-27,127100,127200,-53,-29147,-31847
43.459325,6,0,0,0,0,127100,127200,0,0,0
43.722159,0,121,39,82,-82,127100,127200,4088,28712,20512
43.722159,1,74,32,42,-42,127100,127200,2702,9498,5298
43.722159,2,393,390,3,-3,127100,127200,1101,-59901,-60201
43.722159,3,26,24,2,-2,127100,127200,47,5753,5553
43.722159,4,0,50,-50,50,127100,127200,-636,-1364,3636
43.722159,5,272,245,27,-27,127100,127200,-53,-29147,-31847
43.722159,6,0,0,0,0,127100,127200,0,0,0
43.97585,0,121,39,82,-82,127100,127200,4088,28712,20512
43.97585,1,74,32,42,-42,127100,127200,2702,9498,5298
43.97585,2,393,390,3,-3,127100,127200,1101,-59901,-60201
43.97585,3,26,24,2,-2,127100,127200,47,5753,5553
43.97585,4,0,50,-50,50,127100,127200,-636,-1364,3636
43.97585,5,272,255,17,-17,127100,127200,201,-32401,-34101
43.97585,6,0,0,0,0,127100,127200,0,0,0
44.201087,0,121,39,82,-82,127100,127200,4088,28712,20512
44.201087,1,74,32,42,-42,127100,127200,2702,9498,5298
44.201087,2,393,390,3,-3,127100,127200,1101,-59901,-60201
44.201087,3,26,24,2,-2,127100,127200,47,5753,5553
44.201087,4,0,50,-50,50,127100,127200,-636,-1364,3636
44.201087,5,272,255,17,-17,127100,127200,201,-32401,-34101
44.201087,6,0,0,0,0,127100,127200,0,0,0
44.544707,0,121,39,82,-82,127200,127400,4088,28712,12312
44.544707,1,74,32,42,-42,127200,127400,2702,9498,1098
44.544707,2,403,390,13,-13,127200,127400,974,-59774,-62374
44.544707,3,26,24,2,-2,127200,127400,47,5753,5353
44.544707,4,0,50,-50,50,127200,127400,-636,-1364,8636
44.544707,5,272,255,17,-17,127200,127400,201,-32401,-35801
44.544707,6,0,0,0,0,127200,127400,0,0,0
44.703171,0,121,39,82,-82,127200,127400,4088,28712,12312
44.703171,1,74,32,42,-42,127200,127400,2702,9498,1098
44.703171,2,403,390,13,-13,127200,127400,974,-59774,-62374
44.703171,3,26,24,2,-2,127200,127400,47,5753,5353
44.703171,4,0,50,-50,50,127200,127400,-636,-1364,8636
44.703171,5,272,255,17,-17,127200,127400,201,-32401,-35801
44.703171,6,0,0,0,0,127200,127400,0,0,0
44.987256,0,121,39,82,-82,127100,127400,4088,28712,7802
44.987256,1,74,32,42,-42,127100,127400,2702,9498,-1212
44.987256,2,413,390,23,-23,127100,127400,847,-59647,-65512
44.987256,3,26,24,2,-2,127100,127400,47,5753,5243
44.987256,4,0,50,-50,50,127100,127400,-636,-1364,11386
44.987256,5,272,265,7,-7,127100,127400,455,-34655,-36440
44.987256,6,0,0,0,0,127100,127400,0,0,0
45.241191,0,121,39,82,-82,127300,127400,4088,28712,20512
45.241191,1,86,32,54,-54,127300,127400,3008,10392,4992
45.241191,2,413,400,13,-13,127300,127400,720,-61520,-62820
45.241191,3,26,24,2,-2,127300,127400,47,5753,5553
45.241191,4,0,50,-50,50,127300,127400,-636,-1364,3636
45.241191,5,282,265,17,-17,127300,127400,710,-33910,-35610
45.241191,6,0,0,0,0,127300,127400,0,0,0
45.53214,0,121,39,82,-82,127300,127400,4088,28712,20512
45.53214,1,86,32,54,-54,127300,127400,3008,10392,4992
45.53214,2,413,400,13,-13,127300,127400,720,-61520,-62820
45.53214,3,26,24,2,-2,127300,127400,47,5753,5553
45.53214,4,0,50,-50,50,127300,127400,-636,-1364,3636
45.53214,5,282,265,17,-17,127300,127400,710,-33910,-35610
45.53214,6,0,0,0,0,127300,127400,0,0,0
45.729901,0,121,39,82,-82,127300,127400,4088,28712,20512
45.729901,1,86,32,54,-54,127300,127400,3008,10392,4992
45.729901,2,413,410,3,-3,127300,127400,593,-63393,-63693
45.729901,3,26,24,2,-2,127300,127400,47,5753,5553
45.729901,4,0,50,-50,50,127300,127400,-636,-1364,3636
45.729901,5,292,265,27,-27,127300,127400,965,-34165,-36865
45.729901,6,0,0,0,0,127300,127400,0,0,0
45.973369,0,121,39,82,-82,128100,127400,4088,28712,49622
45.973369,1,86,32,54,-54,128100,127400,3008,10392,24162
45.973369,2,423,420,3,-3,128100,127400,720,-62520,-61755
45.973369,3,26,26,0,0,128100,127400,21,6579,6579
45.973369,4,0,50,-50,50,128100,127400,-636,-1364,-14114
45.973369,5,292,275,17,-17,128100,127400,838,-36038,-31703
45.973369,6,0,0,0,0,128100,127400,0,0,0
46.26893,0,121,39,82,-82,128100,127400,4088,28712,49622
46.26893,1,86,32,54,-54,128100,127400,3008,10392,24162
46.26893,2,423,420,3,-3,128100,127400,720,-62520,-61755
46.26893,3,26,26,0,0,128100,127400,21,6579,6579
46.26893,4,0,50,-50,50,128100,127400,-636,-1364,-14114
46.26893,5,292,275,17,-17,128100,127400,838,-36038,-31703
46.26893,6,0,0,0,0,128100,127400,0,0,0
46.549745,0,121,39,82,-82,127300,127400,4088,28712,20512
46.549745,1,86,32,54,-54,127300,127400,3008,10392,4992
46.549745,2,433,420,13,-13,127300,127400,593,-63393,-64693
46.549745,3,26,26,0,0,127300,127400,21,6579,6579
46.549745,4,0,50,-50,50,127300,127400,-636,-1364,3636
46.549745,5,292,285,7,-7,127300,127400,1093,-36293,-36993
46.549745,6,0,0,0,0,127300,127400,0,0,0
46.714354,0,121,39,82,-82,127200,127400,4088,28712,12312
46.714354,1,86,32,54,-54,127200,127400,3008,10392,-408
46.714354,2,443,420,23,-23,127200,127400,466,-64266,-68866
46.714354,3,26,26,0,0,127200,127400,21,6579,6579
46.714354,4,0,50,-50,50,127200,127400,-636,-1364,8636
46.714354,5,292,295,-3,3,127200,127400,1347,-37547,-36947
46.714354,6,0,0,0,0,127200,127400,0,0,0
46.974368,0,121,39,82,-82,127100,127400,4088,28712,7802
46.974368,1,86,32,54,-54,127100,127400,3008,10392,-3378
46.974368,2,443,430,13,-13,127100,127400,720,-65520,-68835
46.974368,3,26,26,0,0,127100,127400,21,6579,6579
46.974368,4,0,50,-50,50,127100,127400,-636,-1364,11386
46.974368,5,292,295,-3,3,127100,127400,1347,-37547,-36782
46.974368,6,0,0,0,0,127100,127400,0,0,0
47.229175,0,121,39,82,-82,127300,127400,4088,28712,20512
47.229175,1,86,32,54,-54,127300,127400,3008,10392,4992
47.229175,2,443,440,3,-3,127300,127400,975,-65775,-66075
47.229175,3,26,26,0,0,127300,127400,21,6579,6579
47.229175,4,0,50,-50,50,127300,127400,-636,-1364,3636
47.229175,5,302,295,7,-7,127300,127400,1220,-39420,-40120
47.229175,6,0,0,0,0,127300,127400,0,0,0
47.516882,0,121,39,82,-82,127200,127400,4088,28712,12312
47.516882,1,86,32,54,-54,127200,127400,3008,10392,-408
47.516882,2,448,440,8,-8,127200,127400,911,-66211,-67811
47.516882,3,26,26,0,0,127200,127400,21,6579,6579
47.516882,4,0,50,-50,50,127200,127400,-636,-1364,8636
47.516882,5,312,295,17,-17,127200,127400,1093,-41293,-44693
47.516882,6,0,0,0,0,127200,127400,0,0,0
47.757854,0,121,39,82,-82,127200,127100,4088,28712,36912
47.757854,1,86,32,54,-54,127200,127100,3008,10392,15792
47.757854,2,448,440,8,-8,127200,127100,911,-66211,-65411
47.757854,3,26,26,0,0,127200,127100,21,6579,6579
47.757854,4,0,50,-50,50,127200,127100,-636,-1364,-6364
47.757854,5,312,295,17,-17,127200,127100,1093,-41293,-39593
47.757854,6,0,0,0,0,127200,127100,0,0,0
48.044528,0,121,39,82,-82,127100,127100,4088,28712,28712
48.044528,1,86,32,54,-54,127100,127100,3008,10392,10392
48.044528,2,448,450,-2,2,127100,127100,1165,-67465,-67465
48.044528,3,26,26,0,0,127100,127100,21,6579,6579
48.044528,4,0,50,-50,50,127100,127100,-636,-1364,-1364
48.044528,5,312,295,17,-17,127100,127100,1093,-41293,-41293
48.044528,6,0,0,0,0,127100,127100,0,0,0
48.237585,0,121,39,82,-82,127100,127100,4088,28712,28712
48.237585,1,86,32,54,-54,127100,127100,3008,10392,10392
48.237585,2,448,450,-2,2,127100,127100,1165,-67465,-67465
48.237585,3,26,26,0,0,127100,127100,21,6579,6579
48.237585,4,0,50,-50,50,127100,127100,-636,-1364,-1364
48.237585,5,312,295,17,-17,127100,127100,1093,-41293,-41293
48.237585,6,0,0,0,0,127100,127100,0,0,0
48.47876,0,121,39,82,-82,127100,127100,4088,28712,28712
48.47876,1,86,32,54,-54,127100,127100,3008,10392,10392
48.47876,2,448,450,-2,2,127100,127100,1165,-67465,-67465
48.47876,3,26,26,0,0,127100,127100,21,6579,6579
48.47876,4,0,50,-50,50,127100,127100,-636,-1364,-1364
48.47876,5,312,295,17,-17,127100,127100,1093,-41293,-41293
48.47876,6,0,0,0,0,127100,127100,0,0,0
48.778772,0,121,39,82,-82,127600,127100,4088,28712,49540
48.778772,1,86,32,54,-54,127600,127100,3008,10392,24108
48.778772,2,448,460,-12,12,127600,127100,1038,-66338,-69386
48.778772,3,26,28,-2,2,127600,127100,-4,7204,6696
48.778772,4,0,50,-50,50,127600,127100,-636,-1364,-14064
48.778772,5,312,295,17,-17,127600,127100,1093,-41293,-36975
48.778772,6,0,0,0,0,127600,127100,0,0,0
49.020025,0,121,39,82,-82,127600,127100,4088,28712,49540
49.020025,1,86,32,54,-54,127600,127100,3008,10392,24108
49.020025,2,448,460,-12,12,127600,127100,1038,-66338,-69386
49.020025,3,26,28,-2,2,127600,127100,-4,7204,6696
49.020025,4,0,50,-50,50,127600,127100,-636,-1364,-14064
49.020025,5,312,295,17,-17,127600,127100,1093,-41293,-36975
49.020025,6,0,0,0,0,127600,127100,0,0,0
49.275197,0,121,39,82,-82,127200,127000,4088,28712,45112
49.275197,1,86,42,44,-44,127200,127000,3262,12138,20938
49.275197,2,458,460,-2,2,127200,127000,911,-69211,-69611
49.275197,3,26,28,-2,2,127200,127000,-4,7204,6804
49.275197,4,0,50,-50,50,127200,127000,-636,-1364,-11364
49.275197,5,312,295,17,-17,127200,127000,1093,-41293,-37893
49.275197,6,0,0,0,0,127200,127000,0,0,0
49.54425,0,121,39,82,-82,127100,127000,4088,28712,36912
49.54425,1,86,160,-74,74,127100,127000,6259,20941,13541
49.54425,2,458,470,-12,12,127100,127000,1165,-68465,-69665
49.54425,3,26,28,-2,2,127100,127000,-4,7204,7004
49.54425,4,0,50,-50,50,127100,127000,-636,-1364,-6364
49.54425,5,312,295,17,-17,127100,127000,1093,-41293,-39593
49.54425,6,0,0,0,0,127100,127000,0,0,0
49.759988,0,121,39,82,-82,127100,127000,4088,28712,36912
49.759988,1,86,160,-74,74,127100,127000,6259,20941,13541
49.759988,2,458,470,-12,12,127100,127000,1165,-68465,-69665
49.759988,3,26,28,-2,2,127100,127000,-4,7204,7004
49.759988,4,0,50,-50,50,127100,127000,-636,-1364,-6364
49.759988,5,312,295,17,-17,127100,127000,1093,-41293,-39593
49.759988,6,0,0,0,0,127100,127000,0,0,0
49.973516,0,121,39,82,-82,127600,127000,4088,28712,49540
49.973516,1,86,170,-84,84,127600,127000,6513,21687,351
49.973516,2,468,480,-12,12,127600,127000,911,-68211,-71259
49.973516,3,26,30,-4,4,127600,127000,-29,7829,6813
49.973516,4,0,50,-50,50,127600,127000,-636,-1364,-14064
49.973516,5,312,295,17,-17,127600,127000,1093,-41293,-36975
49.973516,6,0,0,0,0,127600,127000,0,0,0
50.292262,0,121,39,82,-82,127600,127000,4088,28712,49540
50.292262,1,86,170,-84,84,127600,127000,6513,21687,351
50.292262,2,468,480,-12,12,127600,127000,911,-68211,-71259
50.292262,3,26,30,-4,4,127600,127000,-29,7829,6813
50.292262,4,0,50,-50,50,127600,127000,-636,-1364,-14064
50.292262,5,312,295,17,-17,127600,127000,1093,-41293,-36975
50.292262,6,0,0,0,0,127600,127000,0,0,0
50.476809,0,121,39,82,-82,127600,127000,4088,28712,49540
50.476809,1,86,170,-84,84,127600,127000,6513,21687,351
50.476809,2,468,480,-12,12,127600,127000,911,-68211,-71259
50.476809,3,26,30,-4,4,127600,127000,-29,7829,6813
50.476809,4,0,50,-50,50,127600,127000,-636,-1364,-14064
50.476809,5,312,295,17,-17,127600,127000,1093,-41293,-36975
50.476809,6,0,0,0,0,127600,127000,0,0,0
50.746851,0,121,39,82,-82,127100,127000,4088,28712,36912
50.746851,1,86,170,-84,84,127100,127000,6513,21687,13287
50.746851,2,488,480,8,-8,127100,127000,1038,-70338,-69538
50.746851,3,26,30,-4,4,127100,127000,-29,7829,7429
50.746851,4,0,50,-50,50,127100,127000,-636,-1364,-6364
50.746851,5,312,295,17,-17,127100,127000,1093,-41293,-39593
50.746851,6,0,0,0,0,127100,127000,0,0,0
51.037307,0,121,39,82,-82,127100,127000,4088,28712,36912
51.037307,1,86,170,-84,84,127100,127000,6513,21687,13287
51.037307,2,488,480,8,-8,127100,127000,1038,-70338,-69538
51.037307,3,26,30,-4,4,127100,127000,-29,7829,7429
51.037307,4,0,50,-50,50,127100,127000,-636,-1364,-6364
51.037307,5,312,295,17,-17,127100,127000,1093,-41293,-39593
51.037307,6,0,0,0,0,127100,127000,0,0,0
51.263125,0,121,39,82,-82,127100,127300,4088,28712,12312
51.263125,1,86,170,-84,84,127100,127300,6513,21687,38487
51.263125,2,488,480,8,-8,127100,127300,1038,-70338,-71938
51.263125,3,26,30,-4,4,127100,127300,-29,7829,8629
51.263125,4,0,50,-50,50,127100,127300,-636,-1364,8636
51.263125,5,312,295,17,-17,127100,127300,1093,-41293,-44693
51.263125,6,0,0,0,0,127100,127300,0,0,0
51.479801,0,121,39,82,-82,127400,127300,4088,28712,36912
51.479801,1,86,170,-84,84,127400,127300,6513,21687,13287
51.479801,2,498,482,16,-16,127400,127300,1267,-69567,-67967
51.479801,3,28,30,-2,2,127400,127300,22,7378,7178
51.479801,4,0,50,-50,50,127400,127300,-636,-1364,-6364
51.479801,5,312,295,17,-17,127400,127300,1093,-41293,-39593
51.479801,6,0,0,0,0,127400,127300,0,0,0
51.73333,0,121,39,82,-82,127600,127300,4088,28712,49622
51.73333,1,86,170,-84,84,127600,127300,6513,21687,267
51.73333,2,498,492,6,-6,127600,127300,1140,-70440,-68910
51.73333,3,28,30,-2,2,127600,127300,22,7378,6868
51.73333,4,0,50,-50,50,127600,127300,-636,-1364,-14114
51.73333,5,312,305,7,-7,127600,127300,966,-41166,-39381
51.73333,6,0,0,0,0,127600,127300,0,0,0
52.029851,0,121,39,82,-82,127600,127300,4088,28712,49622
52.029851,1,86,170,-84,84,127600,127300,6513,21687,267
52.029851,2,498,492,6,-6,127600,127300,1140,-70440,-68910
52.029851,3,28,30,-2,2,127600,127300,22,7378,6868
52.029851,4,0,50,-50,50,127600,127300,-636,-1364,-14114
52.029851,5,312,305,7,-7,127600,127300,966,-41166,-39381
52.029851,6,0,0,0,0,127600,127300,0,0,0
52.204339,0,121,39,82,-82,127600,127300,4088,28712,49622
52.204339,1,86,170,-84,84,127600,127300,6513,21687,267
52.204339,2,498,492,6,-6,127600,127300,1140,-70440,-68910
52.204339,3,28,30,-2,2,127600,127300,22,7378,6868
52.204339,4,0,50,-50,50,127600,127300,-636,-1364,-14114
52.204339,5,312,305,7,-7,127600,127300,966,-41166,-39381
52.204339,6,0,0,0,0,127600,127300,0,0,0
52.530352,0,121,39,82,-82,127600,127300,4088,28712,49622
52.530352,1,86,170,-84,84,127600,127300,6513,21687,267
52.530352,2,498,492,6,-6,127600,127300,1140,-70440,-68910
52.530352,3,28,30,-2,2,127600,127300,22,7378,6868
52.530352,4,0,50,-50,50,127600,127300,-636,-1364,-14114
52.530352,5,312,305,7,-7,127600,127300,966,-41166,-39381
52.530352,6,0,0,0,0,127600,127300,0,0,0
52.729305,0,121,39,82,-82,127600,127300,4088,28712,49622
52.729305,1,86,170,-84,84,127600,127300,6513,21687,267
52.729305,2,498,492,6,-6,127600,127300,1140,-70440,-68910
52.729305,3,28,30,-2,2,127600,127300,22,7378,6868
52.729305,4,0,50,-50,50,127600,127300,-636,-1364,-14114
52.729305,5,312,305,7,-7,127600,127300,966,-41166,-39381
52.729305,6,0,0,0,0,127600,127300,0,0,0
52.969911,0,121,39,82,-82,127100,127300,4088,28712,12312
52.969911,1,86,170,-84,84,127100,127300,6513,21687,38487
52.969911,2,501,492,9,-9,127100,127300,1102,-70402,-72202
52.969911,3,28,30,-2,2,127100,127300,22,7378,7778
52.969911,4,0,50,-50,50,127100,127300,-636,-1364,8636
52.969911,5,322,305,17,-17,127100,127300,839,-41039,-44439
52.969911,6,0,0,0,0,127100,127300,0,0,0
53.266058,0,121,39,82,-82,127100,127300,4088,28712,12312
53.266058,1,86,170,-84,84,127100,127300,6513,21687,38487
53.266058,2,501,492,9,-9,127100,127300,1102,-70402,-72202
53.266058,3,28,30,-2,2,127100,127300,22,7378,7778
53.266058,4,0,50,-50,50,127100,127300,-636,-1364,8636
53.266058,5,322,305,17,-17,127100,127300,839,-41039,-44439
53.266058,6,0,0,0,0,127100,127300,0,0,0
53.486302,0,121,39,82,-82,127100,127300,4088,28712,12312
53.486302,1,86,170,-84,84,127100,127300,6513,21687,38487
53.486302,2,501,492,9,-9,127100,127300,1102,-70402,-72202
53.486302,3,28,30,-2,2,127100,127300,22,7378,7778
53.486302,4,0,50,-50,50,127100,127300,-636,-1364,8636
53.486302,5,322,305,17,-17,127100,127300,839,-41039,-44439
53.486302,6,0,0,0,0,127100,127300,0,0,0
53.763928,0,121,39,82,-82,127100,127300,4088,28712,12312
53.763928,1,86,170,-84,84,127100,127300,6513,21687,38487
53.763928,2,501,492,9,-9,127100,127300,1102,-70402,-72202
53.763928,3,28,30,-2,2,127100,127300,22,7378,7778
53.763928,4,0,50,-50,50,127100,127300,-636,-1364,8636
53.763928,5,322,305,17,-17,127100,127300,839,-41039,-44439
53.763928,6,0,0,0,0,127100,127300,0,0,0
54.02697,0,121,39,82,-82,127100,127300,4088,28712,12312
54.02697,1,86,170,-84,84,127100,127300,6513,21687,38487
54.02697,2,501,492,9,-9,127100,127300,1102,-70402,-72202
54.02697,3,28,30,-2,2,127100,127300,22,7378,7778
54.02697,4,0,50,-50,50,127100,127300,-636,-1364,8636
54.02697,5,322,305,17,-17,127100,127300,839,-41039,-44439
54.02697,6,0,0,0,0,127100,127300,0,0,0
54.294691,0,121,39,82,-82,127300,127300,4088,28712,28712
54.294691,1,86,170,-84,84,127300,127300,6513,21687,21687
54.294691,2,509,492,17,-17,127300,127300,1306,-70606,-70606
54.294691,3,30,30,0,0,127300,127300,73,7327,7327
54.294691,4,0,50,-50,50,127300,127300,-636,-1364,-1364
54.294691,5,322,315,7,-7,127300,127300,712,-41912,-41912
54.294691,6,0,0,0,0,127300,127300,0,0,0
54.529951,0,121,39,82,-82,127300,127300,4088,28712,28712
54.529951,1,86,170,-84,84,127300,127300,6513,21687,21687
54.529951,2,509,492,17,-17,127300,127300,1306,-70606,-70606
54.529951,3,30,30,0,0,127300,127300,73,7327,7327
54.529951,4,0,50,-50,50,127300,127300,-636,-1364,-1364
54.529951,5,322,315,7,-7,127300,127300,712,-41912,-41912
54.529951,6,0,0,0,0,127300,127300,0,0,0
54.718581,0,121,39,82,-82,127200,127300,4088,28712,20512
54.718581,1,86,170,-84,84,127200,127300,6513,21687,30087
54.718581,2,509,502,7,-7,127200,127300,1560,-71860,-72560
54.718581,3,30,30,0,0,127200,127300,73,7327,7327
54.718581,4,0,50,-50,50,127200,127300,-636,-1364,3636
54.718581,5,332,315,17,-17,127200,127300,585,-42785,-44485
54.718581,6,0,0,0,0,127200,127300,0,0,0
55.028494,0,121,39,82,-82,127200,127300,4088,28712,20512
55.028494,1,86,170,-84,84,127200,127300,6513,21687,30087
55.028494,2,509,502,7,-7,127200,127300,1560,-71860,-72560
55.028494,3,30,30,0,0,127200,127300,73,7327,7327
55.028494,4,0,50,-50,50,127200,127300,-636,-1364,3636
55.028494,5,332,315,17,-17,127200,127300,585,-42785,-44485
55.028494,6,0,0,0,0,127200,127300,0,0,0
55.203349,0,121,39,82,-82,127800,127300,4088,28712,49622
55.203349,1,86,170,-84,84,127800,127300,6513,21687,267
55.203349,2,509,512,-3,3,127800,127300,1433,-70733,-71498
55.203349,3,30,32,-2,2,127800,127300,47,8153,7643
55.203349,4,0,50,-50,50,127800,127300,-636,-1364,-14114
55.203349,5,332,315,17,-17,127800,127300,585,-42785,-38450
55.203349,6,0,0,0,0,127800,127300,0,0,0
55.529204,0,121,39,82,-82,127000,127300,4088,28712,7802
55.529204,1,86,170,-84,84,127000,127300,6513,21687,43107
55.529204,2,519,512,7,-7,127000,127300,1306,-71606,-73391
55.529204,3,30,32,-2,2,127000,127300,47,8153,8663
55.529204,4,0,50,-50,50,127000,127300,-636,-1364,11386
55.529204,5,337,325,12,-12,127000,127300,775,-44475,-47535
55.529204,6,0,0,0,0,127000,127300,0,0,0
55.777972,0,121,39,82,-82,127000,127300,4088,28712,7802
55.777972,1,86,170,-84,84,127000,127300,6513,21687,43107
55.777972,2,519,512,7,-7,127000,127300,1306,-71606,-73391
55.777972,3,30,32,-2,2,127000,127300,47,8153,8663
55.777972,4,0,50,-50,50,127000,127300,-636,-1364,11386
55.777972,5,337,325,12,-12,127000,127300,775,-44475,-47535
55.777972,6,0,0,0,0,127000,127300,0,0,0
56.007556,0,121,39,82,-82,127000,127300,4088,28712,7802
56.007556,1,86,170,-84,84,127000,127300,6513,21687,43107
56.007556,2,519,512,7,-7,127000,127300,1306,-71606,-73391
56.007556,3,30,32,-2,2,127000,127300,47,8153,8663
56.007556,4,0,50,-50,50,127000,127300,-636,-1364,11386
56.007556,5,337,325,12,-12,127000,127300,775,-44475,-47535
56.007556,6,0,0,0,0,127000,127300,0,0,0
56.288889,0,121,39,82,-82,127000,127300,4088,28712,7802
56.288889,1,86,170,-84,84,127000,127300,6513,21687,43107
56.288889,2,519,512,7,-7,127000,127300,1306,-71606,-73391
56.288889,3,30,32,-2,2,127000,127300,47,8153,8663
56.288889,4,0,50,-50,50,127000,127300,-636,-1364,11386
56.288889,5,337,325,12,-12,127000,127300,775,-44475,-47535
56.288889,6,0,0,0,0,127000,127300,0,0,0
56.516812,0,121,39,82,-82,127200,127300,4088,28712,20512
56.516812,1,86,170,-84,84,127200,127300,6513,21687,30087
56.516812,2,519,522,-3,3,127200,127300,1179,-71479,-71179
56.516812,3,30,32,-2,2,127200,127300,47,8153,8353
56.516812,4,0,50,-50,50,127200,127300,-636,-1364,3636
56.516812,5,337,335,2,-2,127200,127300,648,-44348,-44548
56.516812,6,0,0,0,0,127200,127300,0,0,0
56.750378,0,121,39,82,-82,127200,127300,4088,28712,20512
56.750378,1,86,170,-84,84,127200,127300,6513,21687,30087
56.750378,2,519,522,-3,3,127200,127300,1179,-71479,-71179
56.750378,3,30,32,-2,2,127200,127300,47,8153,8353
56.750378,4,0,50,-50,50,127200,127300,-636,-1364,3636
56.750378,5,337,335,2,-2,127200,127300,648,-44348,-44548
56.750378,6,0,0,0,0,127200,127300,0,0,0
56.95485,0,121,39,82,-82,127200,127300,4088,28712,20512
56.95485,1,86,170,-84,84,127200,127300,6513,21687,30087
56.95485,2,519,522,-3,3,127200,127300,1179,-71479,-71179
56.95485,3,30,32,-2,2,127200,127300,47,8153,8353
56.95485,4,0,50,-50,50,127200,127300,-636,-1364,3636
56.95485,5,337,335,2,-2,127200,127300,648,-44348,-44548
56.95485,6,0,0,0,0,127200,127300,0,0,0
57.202715,0,121,39,82,-82,127200,127300,4088,28712,20512
57.202715,1,86,170,-84,84,127200,127300,6513,21687,30087
57.202715,2,519,522,-3,3,127200,127300,1179,-71479,-71179
57.202715,3,30,32,-2,2,127200,127300,47,8153,8353
57.202715,4,0,50,-50,50,127200,127300,-636,-1364,3636
57.202715,5,337,335,2,-2,127200,127300,648,-44348,-44548
57.202715,6,0,0,0,0,127200,127300,0,0,0
57.4614,0,121,39,82,-82,126800,127300,4088,28712,7802
57.4614,1,86,170,-84,84,126800,127300,6513,21687,43107
57.4614,2,529,522,7,-7,126800,127300,1052,-72352,-74137
57.4614,3,30,32,-2,2,126800,127300,47,8153,8663
57.4614,4,0,50,-50,50,126800,127300,-636,-1364,11386
57.4614,5,347,335,12,-12,126800,127300,521,-45221,-48281
57.4614,6,0,0,0,0,126800,127300,0,0,0
57.724306,0,121,39,82,-82,127000,127300,4088,28712,7802
57.724306,1,86,170,-84,84,127000,127300,6513,21687,43107
57.724306,2,539,522,17,-17,127000,127300,925,-72225,-76560
57.724306,3,30,32,-2,2,127000,127300,47,8153,8663
57.724306,4,0,50,-50,50,127000,127300,-636,-1364,11386
57.724306,5,357,335,22,-22,127000,127300,394,-45094,-50704
57.724306,6,0,0,0,0,127000,127300,0,0,0
58.000082,0,121,39,82,-82,126900,127300,4088,28712,7802
58.000082,1,106,170,-64,64,126900,127300,7021,23179,39499
58.000082,2,549,522,27,-27,126900,127300,1179,-71479,-78364
58.000082,3,32,32,0,0,126900,127300,98,8302,8302
58.000082,4,0,50,-50,50,126900,127300,-636,-1364,11386
58.000082,5,367,345,22,-22,126900,127300,521,-47221,-52831
58.000082,6,0,0,0,0,126900,127300,0,0,0
58.292386,0,121,39,82,-82,126900,127300,4088,28712,7802
58.292386,1,106,170,-64,64,126900,127300,7021,23179,39499
58.292386,2,549,522,27,-27,126900,127300,1179,-71479,-78364
58.292386,3,32,32,0,0,126900,127300,98,8302,8302
58.292386,4,0,50,-50,50,126900,127300,-636,-1364,11386
58.292386,5,367,345,22,-22,126900,127300,521,-47221,-52831
58.292386,6,0,0,0,0,126900,127300,0,0,0
58.543642,0,121,39,82,-82,127000,127300,4088,28712,7802
58.543642,1,106,170,-64,64,127000,127300,7021,23179,39499
58.543642,2,549,532,17,-17,127000,127300,1433,-73733,-78068
58.543642,3,32,32,0,0,127000,127300,98,8302,8302
58.543642,4,0,50,-50,50,127000,127300,-636,-1364,11386
58.543642,5,377,345,32,-32,127000,127300,394,-46094,-54254
58.543642,6,0,0,0,0,127000,127300,0,0,0
58.773659,0,121,39,82,-82,127000,127300,4088,28712,7802
58.773659,1,106,170,-64,64,127000,127300,7021,23179,39499
58.773659,2,559,532,27,-27,127000,127300,1687,-72987,-79872
58.773659,3,32,32,0,0,127000,127300,98,8302,8302
58.773659,4,0,50,-50,50,127000,127300,-636,-1364,11386
58.773659,5,377,355,22,-22,127000,127300,267,-47967,-53577
58.773659,6,0,0,0,0,127000,127300,0,0,0
59.049515,0,121,39,82,-82,127000,127300,4088,28712,7802
59.049515,1,106,170,-64,64,127000,127300,7021,23179,39499
59.049515,2,559,532,27,-27,127000,127300,1687,-72987,-79872
59.049515,3,32,32,0,0,127000,127300,98,8302,8302
59.049515,4,0,50,-50,50,127000,127300,-636,-1364,11386
59.049515,5,377,355,22,-22,127000,127300,267,-47967,-53577
59.049515,6,0,0,0,0,127000,127300,0,0,0
59.288224,0,121,39,82,-82,126900,127300,4088,28712,7802
59.288224,1,116,170,-54,54,126900,127300,7275,23925,37695
59.288224,2,559,532,27,-27,126900,127300,1687,-72987,-79872
59.288224,3,32,32,0,0,126900,127300,98,8302,8302
59.288224,4,0,50,-50,50,126900,127300,-636,-1364,11386
59.288224,5,377,365,12,-12,126900,127300,140,-49840,-52900
59.288224,6,0,0,0,0,126900,127300,0,0,0
59.522454,0,121,39,82,-82,127000,127300,4088,28712,7802
59.522454,1,116,170,-54,54,127000,127300,7275,23925,37695
59.522454,2,559,542,17,-17,127000,127300,1560,-73860,-78195
59.522454,3,32,32,0,0,127000,127300,98,8302,8302
59.522454,4,0,50,-50,50,127000,127300,-636,-1364,11386
59.522454,5,387,365,22,-22,127000,127300,394,-50094,-55704
59.522454,6,0,0,0,0,127000,127300,0,0,0
59.732015,0,121,39,82,-82,126900,127300,4088,28712,7802
59.732015,1,116,170,-54,54,126900,127300,7275,23925,37695
59.732015,2,569,542,27,-27,126900,127300,1814,-73114,-79999
59.732015,3,32,32,0,0,126900,127300,98,8302,8302
59.732015,4,0,50,-50,50,126900,127300,-636,-1364,11386
59.732015,5,387,375,12,-12,126900,127300,267,-51967,-55027
59.732015,6,0,0,0,0,126900,127300,0,0,0
59.956148,0,121,39,82,-82,127000,127300,4088,28712,7802
59.956148,1,116,170,-54,54,127000,127300,7275,23925,37695
59.956148,2,569,552,17,-17,127000,127300,1687,-74987,-79322
59.956148,3,32,32,0,0,127000,127300,98,8302,8302
59.956148,4,0,50,-50,50,127000,127300,-636,-1364,11386
59.956148,5,397,375,22,-22,127000,127300,521,-52221,-57831
59.956148,6,0,0,0,0,127000,127300,0,0,0
60.232364,0,121,39,82,-82,127000,127300,4088,28712,7802
60.232364,1,116,170,-54,54,127000,127300,7275,23925,37695
60.232364,2,569,559,10,-10,127000,127300,1598,-76298,-78848
60.232364,3,32,32,0,0,127000,127300,98,8302,8302
60.232364,4,0,50,-50,50,127000,127300,-636,-1364,11386
60.232364,5,397,375,22,-22,127000,127300,521,-52221,-57831
60.232364,6,0,0,0,0,127000,127300,0,0,0
60.518632,0,121,39,82,-82,127000,127200,4088,28712,12312
60.518632,1,116,170,-54,54,127000,127200,7275,23925,34725
60.518632,2,569,559,10,-10,127000,127200,1598,-76298,-78298
60.518632,3,32,32,0,0,127000,127200,98,8302,8302
60.518632,4,0,50,-50,50,127000,127200,-636,-1364,8636
60.518632,5,397,375,22,-22,127000,127200,521,-52221,-56621
60.518632,6,0,0,0,0,127000,127200,0,0,0
60.799124,0,121,39,82,-82,127000,127200,4088,28712,12312
60.799124,1,116,170,-54,54,127000,127200,7275,23925,34725
60.799124,2,569,559,10,-10,127000,127200,1598,-76298,-78298
60.799124,3,32,32,0,0,127000,127200,98,8302,8302
60.799124,4,0,50,-50,50,127000,127200,-636,-1364,8636
60.799124,5,397,375,22,-22,127000,127200,521,-52221,-56621
60.799124,6,0,0,0,0,127000,127200,0,0,0
60.976977,0,121,39,82,-82,127300,127200,4088,28712,36912
60.976977,1,116,170,-54,54,127300,127200,7275,23925,18525
60.976977,2,569,559,10,-10,127300,127200,1598,-76298,-75298
60.976977,3,32,32,0,0,127300,127200,98,8302,8302
60.976977,4,0,50,-50,50,127300,127200,-636,-1364,-6364
60.976977,5,397,375,22,-22,127300,127200,521,-52221,-50021
60.976977,6,0,0,0,0,127300,127200,0,0,0
61.22192,0,121,39,82,-82,127300,127200,4088,28712,36912
61.22192,1,116,170,-54,54,127300,127200,7275,23925,18525
61.22192,2,569,559,10,-10,127300,127200,1598,-76298,-75298
61.22192,3,32,32,0,0,127300,127200,98,8302,8302
61.22192,4,0,50,-50,50,127300,127200,-636,-1364,-6364
61.22192,5,397,375,22,-22,127300,127200,521,-52221,-50021
61.22192,6,0,0,0,0,127300,127200,0,0,0
61.479903,0,121,39,82,-82,127900,127200,4088,28712,49540
61.479903,1,116,170,-54,54,127900,127200,7275,23925,10209
61.479903,2,569,569,0,0,127900,127200,1471,-77171,-77171
61.479903,3,32,34,-2,2,127900,127200,72,8928,8420
61.479903,4,0,50,-50,50,127900,127200,-636,-1364,-14064
61.479903,5,397,385,12,-12,127900,127200,394,-53094,-50046
61.479903,6,0,0,0,0,127900,127200,0,0,0
61.731987,0,121,39,82,-82,127400,127200,4088,28712,45112
61.731987,1,116,170,-54,54,127400,127200,7275,23925,13125
61.731987,2,569,569,0,0,127400,127200,1471,-77171,-77171
61.731987,3,34,34,0,0,127400,127200,123,8477,8477
61.731987,4,0,50,-50,50,127400,127200,-636,-1364,-11364
61.731987,5,397,387,10,-10,127400,127200,369,-53069,-51069
61.731987,6,0,0,0,0,127400,127200,0,0,0
61.978814,0,121,39,82,-82,127900,127200,4088,28712,49540
61.978814,1,116,170,-54,54,127900,127200,7275,23925,10209
61.978814,2,569,579,-10,10,127900,127200,1344,-77044,-79584
61.978814,3,34,36,-2,2,127900,127200,97,9103,8595
61.978814,4,0,50,-50,50,127900,127200,-636,-1364,-14064
61.978814,5,397,397,0,0,127900,127200,242,-52942,-52942
61.978814,6,0,0,0,0,127900,127200,0,0,0
62.247625,0,121,39,82,-82,127900,127200,4088,28712,49540
62.247625,1,116,170,-54,54,127900,127200,7275,23925,10209
62.247625,2,569,579,-10,10,127900,127200,1344,-77044,-79584
62.247625,3,34,36,-2,2,127900,127200,97,9103,8595
62.247625,4,0,50,-50,50,127900,127200,-636,-1364,-14064
62.247625,5,397,397,0,0,127900,127200,242,-52942,-52942
62.247625,6,0,0,0,0,127900,127200,0,0,0
62.514373,0,121,39,82,-82,127900,127200,4088,28712,49540
62.514373,1,116,170,-54,54,127900,127200,7275,23925,10209
62.514373,2,569,579,-10,10,127900,127200,1344,-77044,-79584
62.514373,3,34,36,-2,2,127900,127200,97,9103,8595
62.514373,4,0,50,-50,50,127900,127200,-636,-1364,-14064
62.514373,5,397,397,0,0,127900,127200,242,-52942,-52942
62.514373,6,0,0,0,0,127900,127200,0,0,0
62.738772,0,121,39,82,-82,127500,127100,4088,28712,49540
62.738772,1,116,170,-54,54,127500,127100,7275,23925,10209
62.738772,2,569,588,-19,19,127500,127100,1229,-73329,-78155
62.738772,3,34,36,-2,2,127500,127100,97,9103,8595
62.738772,4,0,50,-50,50,127500,127100,-636,-1364,-14064
62.738772,5,397,397,0,0,127500,127100,242,-52942,-52942
62.738772,6,0,0,0,0,127500,127100,0,0,0
63.008623,0,121,39,82,-82,127500,127100,4088,28712,49540
63.008623,1,116,170,-54,54,127500,127100,7275,23925,10209
63.008623,2,569,588,-19,19,127500,127100,1229,-73329,-78155
63.008623,3,34,36,-2,2,127500,127100,97,9103,8595
63.008623,4,0,50,-50,50,127500,127100,-636,-1364,-14064
63.008623,5,397,397,0,0,127500,127100,242,-52942,-52942
63.008623,6,0,0,0,0,127500,127100,0,0,0
63.288769,0,121,39,82,-82,127500,127100,4088,28712,49540
63.288769,1,116,170,-54,54,127500,127100,7275,23925,10209
63.288769,2,569,588,-19,19,127500,127100,1229,-73329,-78155
63.288769,3,34,36,-2,2,127500,127100,97,9103,8595
63.288769,4,0,50,-50,50,127500,127100,-636,-1364,-14064
63.288769,5,397,397,0,0,127500,127100,242,-52942,-52942
63.288769,6,0,0,0,0,127500,127100,0,0,0
63.469401,0,121,39,82,-82,127700,127100,4088,28712,49540
63.469401,1,116,170,-54,54,127700,127100,7275,23925,10209
63.469401,2,569,598,-29,29,127700,127100,1102,-71202,-78568
63.469401,3,34,38,-4,4,127700,127100,71,9729,8713
63.469401,4,0,50,-50,50,127700,127100,-636,-1364,-14064
63.469401,5,397,397,0,0,127700,127100,242,-52942,-52942
63.469401,6,0,0,0,0,127700,127100,0,0,0
63.70108,0,121,39,82,-82,127700,127100,4088,28712,49540
63.70108,1,116,170,-54,54,127700,127100,7275,23925,10209
63.70108,2,569,598,-29,29,127700,127100,1102,-71202,-78568
63.70108,3,34,38,-4,4,127700,127100,71,9729,8713
63.70108,4,0,50,-50,50,127700,127100,-636,-1364,-14064
63.70108,5,397,397,0,0,127700,127100,242,-52942,-52942
63.70108,6,0,0,0,0,127700,127100,0,0,0
64.025984,0,121,49,72,-72,127300,127100,4343,30457,44857
64.025984,1,116,170,-54,54,127300,127100,7275,23925,13125
64.025984,2,579,598,-19,19,127300,127100,975,-74075,-77875
64.025984,3,34,38,-4,4,127300,127100,71,9729,8929
64.025984,4,0,50,-50,50,127300,127100,-636,-1364,-11364
64.025984,5,397,397,0,0,127300,127100,242,-52942,-52942
64.025984,6,0,0,0,0,127300,127100,0,0,0
64.219049,0,121,49,72,-72,127300,127100,4343,30457,44857
64.219049,1,116,170,-54,54,127300,127100,7275,23925,13125
64.219049,2,579,598,-19,19,127300,127100,975,-74075,-77875
64.219049,3,34,38,-4,4,127300,127100,71,9729,8929
64.219049,4,0,50,-50,50,127300,127100,-636,-1364,-11364
64.219049,5,397,397,0,0,127300,127100,242,-52942,-52942
64.219049,6,0,0,0,0,127300,127100,0,0,0
64.464464,0,121,49,72,-72,127200,127000,4343,30457,44857
64.464464,1,116,180,-64,64,127200,127000,7529,24671,11871
64.464464,2,589,598,-9,9,127200,127000,848,-75948,-77748
64.464464,3,34,38,-4,4,127200,127000,71,9729,8929
64.464464,4,0,50,-50,50,127200,127000,-636,-1364,-11364
64.464464,5,397,397,0,0,127200,127000,242,-52942,-52942
64.464464,6,0,0,0,0,127200,127000,0,0,0
64.786405,0,121,49,72,-72,127200,127000,4343,30457,44857
64.786405,1,116,180,-64,64,127200,127000,7529,24671,11871
64.786405,2,589,605,-16,16,127200,127000,759,-75159,-78359
64.786405,3,34,38,-4,4,127200,127000,71,9729,8929
64.786405,4,0,50,-50,50,127200,127000,-636,-1364,-11364
64.786405,5,397,397,0,0,127200,127000,242,-52942,-52942
64.786405,6,0,0,0,0,127200,127000,0,0,0
65.048249,0,121,49,72,-72,127200,127100,4343,30457,37657
65.048249,1,116,180,-64,64,127200,127100,7529,24671,18271
65.048249,2,589,605,-16,16,127200,127100,759,-75159,-76759
65.048249,3,34,38,-4,4,127200,127100,71,9729,9329
65.048249,4,0,50,-50,50,127200,127100,-636,-1364,-6364
65.048249,5,397,397,0,0,127200,127100,242,-52942,-52942
65.048249,6,0,0,0,0,127200,127100,0,0,0
65.286678,0,121,49,72,-72,127200,127100,4343,30457,37657
65.286678,1,116,180,-64,64,127200,127100,7529,24671,18271
65.286678,2,589,605,-16,16,127200,127100,759,-75159,-76759
65.286678,3,34,38,-4,4,127200,127100,71,9729,9329
65.286678,4,0,50,-50,50,127200,127100,-636,-1364,-6364
65.286678,5,397,397,0,0,127200,127100,242,-52942,-52942
65.286678,6,0,0,0,0,127200,127100,0,0,0
65.525003,0,121,49,72,-72,127300,127100,4343,30457,44857
65.525003,1,116,180,-64,64,127300,127100,7529,24671,11871
65.525003,2,599,605,-6,6,127300,127100,632,-78032,-79232
65.525003,3,34,38,-4,4,127300,127100,71,9729,8929
65.525003,4,0,50,-50,50,127300,127100,-636,-1364,-11364
65.525003,5,397,407,-10,10,127300,127100,497,-52197,-54197
65.525003,6,0,0,0,0,127300,127100,0,0,0
65.763802,0,121,49,72,-72,127300,127100,4343,30457,44857
65.763802,1,116,180,-64,64,127300,127100,7529,24671,11871
65.763802,2,599,605,-6,6,127300,127100,632,-78032,-79232
65.763802,3,34,38,-4,4,127300,127100,71,9729,8929
65.763802,4,0,50,-50,50,127300,127100,-636,-1364,-11364
65.763802,5,397,407,-10,10,127300,127100,497,-52197,-54197
65.763802,6,0,0,0,0,127300,127100,0,0,0
66.002699,0,121,49,72,-72,127300,127100,4343,30457,44857
66.002699,1,116,180,-64,64,127300,127100,7529,24671,11871
66.002699,2,599,605,-6,6,127300,127100,632,-78032,-79232
66.002699,3,34,38,-4,4,127300,127100,71,9729,8929
66.002699,4,0,50,-50,50,127300,127100,-636,-1364,-11364
66.002699,5,397,407,-10,10,127300,127100,497,-52197,-54197
66.002699,6,0,0,0,0,127300,127100,0,0,0
66.228241,0,121,49,72,-72,127300,127400,4343,30457,23257
66.228241,1,116,180,-64,64,127300,127400,7529,24671,31071
66.228241,2,599,605,-6,6,127300,127400,632,-78032,-77432
66.228241,3,34,38,-4,4,127300,127400,71,9729,10129
66.228241,4,0,50,-50,50,127300,127400,-636,-1364,3636
66.228241,5,397,407,-10,10,127300,127400,497,-52197,-51197
66.228241,6,0,0,0,0,127300,127400,0,0,0
66.466957,0,121,49,72,-72,127300,127400,4343,30457,23257
66.466957,1,116,180,-64,64,127300,127400,7529,24671,31071
66.466957,2,599,605,-6,6,127300,127400,632,-78032,-77432
66.466957,3,34,38,-4,4,127300,127400,71,9729,10129
66.466957,4,0,50,-50,50,127300,127400,-636,-1364,3636
66.466957,5,397,407,-10,10,127300,127400,497,-52197,-51197
66.466957,6,0,0,0,0,127300,127400,0,0,0
66.781028,0,121,49,72,-72,127300,126800,4343,30457,48745
66.781028,1,116,180,-64,64,127300,126800,7529,24671,8415
66.781028,2,599,605,-6,6,127300,126800,632,-78032,-79556
66.781028,3,34,38,-4,4,127300,126800,71,9729,8713
66.781028,4,0,50,-50,50,127300,126800,-636,-1364,-14064
66.781028,5,397,407,-10,10,127300,126800,497,-52197,-54737
66.781028,6,0,0,0,0,127300,126800,0,0,0
67.014209,0,121,69,52,-52,126800,126700,4852,37948,43148
67.014209,1,116,180,-64,64,126800,126700,7529,24671,18271
67.014209,2,609,615,-6,6,126800,126700,759,-84159,-84759
67.014209,3,36,38,-2,2,126800,126700,46,9354,9154
67.014209,4,0,50,-50,50,126800,126700,-636,-1364,-6364
67.014209,5,411,407,4,-4,126800,126700,319,-58819,-58419
67.014209,6,0,0,0,0,126800,126700,0,0,0
67.262207,0,121,69,52,-52,126600,126600,4852,37948,37948
67.262207,1,116,180,-64,64,126600,126600,7529,24671,24671
67.262207,2,619,615,4,-4,126600,126600,632,-86032,-86032
67.262207,3,36,38,-2,2,126600,126600,46,9354,9354
67.262207,4,0,50,-50,50,126600,126600,-636,-1364,-1364
67.262207,5,421,407,14,-14,126600,126600,192,-60692,-60692
67.262207,6,0,0,0,0,126600,126600,0,0,0
67.46872,0,121,69,52,-52,126600,126600,4852,37948,37948
67.46872,1,116,180,-64,64,126600,126600,7529,24671,24671
67.46872,2,619,615,4,-4,126600,126600,632,-86032,-86032
67.46872,3,36,38,-2,2,126600,126600,46,9354,9354
67.46872,4,0,50,-50,50,126600,126600,-636,-1364,-1364
67.46872,5,421,407,14,-14,126600,126600,192,-60692,-60692
67.46872,6,0,0,0,0,126600,126600,0,0,0
67.783396,0,121,69,52,-52,126600,126600,4852,37948,37948
67.783396,1,116,180,-64,64,126600,126600,7529,24671,24671
67.783396,2,619,625,-6,6,126600,126600,885,-87285,-87285
67.783396,3,36,38,-2,2,126600,126600,46,9354,9354
67.783396,4,0,50,-50,50,126600,126600,-636,-1364,-1364
67.783396,5,421,407,14,-14,126600,126600,192,-60692,-60692
67.783396,6,0,0,0,0,126600,126600,0,0,0
67.964703,0,121,69,52,-52,126600,126600,4852,37948,37948
67.964703,1,116,180,-64,64,126600,126600,7529,24671,24671
67.964703,2,619,625,-6,6,126600,126600,885,-87285,-87285
67.964703,3,36,38,-2,2,126600,126600,46,9354,9354
67.964703,4,0,50,-50,50,126600,126600,-636,-1364,-1364
67.964703,5,421,407,14,-14,126600,126600,192,-60692,-60692
67.964703,6,0,0,0,0,126600,126600,0,0,0
68.284715,0,121,69,52,-52,126600,126500,4852,37948,43148
68.284715,1,116,202,-86,86,126600,126500,8086,24114,15514
68.284715,2,619,635,-16,16,126600,126500,1138,-87538,-89138
68.284715,3,36,38,-2,2,126600,126500,46,9354,9154
68.284715,4,0,50,-50,50,126600,126500,-636,-1364,-6364
68.284715,5,421,407,14,-14,126600,126500,192,-60692,-59292
68.284715,6,0,0,0,0,126600,126500,0,0,0
68.505262,0,121,84,37,-37,126500,126400,5232,40568,44268
68.505262,1,116,202,-86,86,126500,126400,8086,24114,15514
68.505262,2,629,635,-6,6,126500,126400,1012,-91412,-92012
68.505262,3,36,38,-2,2,126500,126400,46,9354,9154
68.505262,4,0,50,-50,50,126500,126400,-636,-1364,-6364
68.505262,5,421,407,14,-14,126500,126400,192,-60692,-59292
68.505262,6,0,0,0,0,126500,126400,0,0,0
68.781306,0,121,84,37,-37,126400,126400,5232,40568,40568
68.781306,1,116,202,-86,86,126400,126400,8086,24114,24114
68.781306,2,629,635,-6,6,126400,126400,1012,-91412,-91412
68.781306,3,36,38,-2,2,126400,126400,46,9354,9354
68.781306,4,0,50,-50,50,126400,126400,-636,-1364,-1364
68.781306,5,421,417,4,-4,126400,126400,445,-61945,-61945
68.781306,6,0,0,0,0,126400,126400,0,0,0
68.982378,0,121,84,37,-37,126400,126400,5232,40568,40568
68.982378,1,116,212,-96,96,126400,126400,8339,24861,24861
68.982378,2,629,645,-16,16,126400,126400,1265,-90665,-90665
68.982378,3,36,38,-2,2,126400,126400,46,9354,9354
68.982378,4,0,50,-50,50,126400,126400,-636,-1364,-1364
68.982378,5,421,417,4,-4,126400,126400,445,-61945,-61945
68.982378,6,0,0,0,0,126400,126400,0,0,0
69.209804,0,121,84,37,-37,126400,126100,5232,40568,49892
69.209804,1,116,212,-96,96,126400,126100,8339,24861,669
69.209804,2,629,645,-16,16,126400,126100,1265,-90665,-94697
69.209804,3,36,38,-2,2,126400,126100,46,9354,8850
69.209804,4,0,50,-50,50,126400,126100,-636,-1364,-13964
69.209804,5,421,417,4,-4,126400,126100,445,-61945,-60937
69.209804,6,0,0,0,0,126400,126100,0,0,0
69.517086,0,121,84,37,-37,126400,126100,5232,40568,49892
69.517086,1,116,212,-96,96,126400,126100,8339,24861,669
69.517086,2,629,645,-16,16,126400,126100,1265,-90665,-94697
69.517086,3,36,38,-2,2,126400,126100,46,9354,8850
69.517086,4,0,50,-50,50,126400,126100,-636,-1364,-13964
69.517086,5,421,417,4,-4,126400,126100,445,-61945,-60937
69.517086,6,0,0,0,0,126400,126100,0,0,0
69.755087,0,121,84,37,-37,127000,126100,5232,40568,49892
69.755087,1,116,212,-96,96,127000,126100,8339,24861,669
69.755087,2,629,655,-26,26,127000,126100,1138,-87538,-94090
69.755087,3,36,40,-4,4,127000,126100,21,10179,9171
69.755087,4,0,50,-50,50,127000,126100,-636,-1364,-13964
69.755087,5,421,427,-6,6,127000,126100,318,-59818,-61330
69.755087,6,0,0,0,0,127000,126100,0,0,0
70.01379,0,121,84,37,-37,126700,126400,5232,40568,49929
70.01379,1,116,212,-96,96,126700,126400,8339,24861,573
70.01379,2,649,665,-16,16,126700,126400,1138,-89538,-93586
70.01379,3,36,42,-6,6,126700,126400,-4,10604,9086
70.01379,4,0,50,-50,50,126700,126400,-636,-1364,-14014
70.01379,5,421,437,-16,16,126700,126400,191,-58691,-62739
70.01379,6,0,0,0,0,126700,126400,0,0,0
70.272532,0,121,114,7,-7,126900,126400,5993,51807,53578
70.272532,1,116,212,-96,96,126900,126400,8339,24861,573
70.272532,2,649,675,-26,26,126900,126400,1392,-85792,-92370
70.272532,3,36,44,-8,8,126900,126400,47,11353,9329
70.272532,4,0,50,-50,50,126900,126400,-636,-1364,-14014
70.272532,5,421,447,-26,26,126900,126400,445,-54945,-61523
70.272532,6,0,0,0,0,126900,126400,0,0,0
70.464928,0,121,144,-23,23,126700,126400,6754,63046,57227
70.464928,1,116,212,-96,96,126700,126400,8339,24861,573
70.464928,2,655,681,-26,26,126700,126400,1468,-85268,-91846
70.464928,3,36,44,-8,8,126700,126400,47,11353,9329
70.464928,4,0,50,-50,50,126700,126400,-636,-1364,-14014
70.464928,5,421,457,-36,36,126700,126400,699,-51199,-60307
70.464928,6,0,0,0,0,126700,126400,0,0,0
70.726341,0,121,144,-23,23,126800,126400,6754,63046,57227
70.726341,1,116,212,-96,96,126800,126400,8339,24861,573
70.726341,2,665,685,-20,20,126800,126400,1290,-91290,-96350
70.726341,3,36,46,-10,10,126800,126400,22,11778,9248
70.726341,4,0,50,-50,50,126800,126400,-636,-1364,-14014
70.726341,5,431,457,-26,26,126800,126400,800,-56500,-63078
70.726341,6,0,0,0,0,126800,126400,0,0,0
71.038864,0,121,161,-40,40,126500,126200,7184,66016,55936
71.038864,1,116,212,-96,96,126500,126200,8339,24861,669
71.038864,2,665,695,-30,30,126500,126200,1543,-88543,-96103
71.038864,3,36,46,-10,10,126500,126200,22,11778,9258
71.038864,4,0,50,-50,50,126500,126200,-636,-1364,-13964
71.038864,5,441,457,-16,16,126500,126200,674,-60374,-64406
71.038864,6,0,0,0,0,126500,126200,0,0,0
71.26277,0,121,161,-40,40,126500,126200,7184,66016,55936
71.26277,1,116,212,-96,96,126500,126200,8339,24861,669
71.26277,2,665,695,-30,30,126500,126200,1543,-88543,-96103
71.26277,3,36,48,-12,12,126500,126200,-3,12203,9179
71.26277,4,0,50,-50,50,126500,126200,-636,-1364,-13964
71.26277,5,443,457,-14,14,126500,126200,725,-61025,-64553
71.26277,6,0,0,0,0,126500,126200,0,0,0
71.499866,0,121,179,-58,58,126500,126200,7639,69161,54545
71.499866,1,116,212,-96,96,126500,126200,8339,24861,669
71.499866,2,675,695,-20,20,126500,126200,1417,-91417,-96457
71.499866,3,36,48,-12,12,126500,126200,-3,12203,9179
71.499866,4,0,50,-50,50,126500,126200,-636,-1364,-13964
71.499866,5,451,457,-6,6,126500,126200,624,-63324,-64836
71.499866,6,0,0,0,0,126500,126200,0,0,0
71.7412,0,121,189,-68,68,126500,126200,7892,70908,53772
71.7412,1,116,212,-96,96,126500,126200,8339,24861,669
71.7412,2,675,695,-20,20,126500,126200,1417,-91417,-96457
71.7412,3,36,48,-12,12,126500,126200,-3,12203,9179
71.7412,4,0,50,-50,50,126500,126200,-636,-1364,-13964
71.7412,5,461,457,4,-4,126500,126200,498,-66198,-65190
71.7412,6,0,0,0,0,126500,126200,0,0,0
72.014536,0,121,189,-68,68,126500,126200,7892,70908,53772
72.014536,1,116,212,-96,96,126500,126200,8339,24861,669
72.014536,2,675,695,-20,20,126500,126200,1417,-91417,-96457
72.014536,3,36,48,-12,12,126500,126200,-3,12203,9179
72.014536,4,0,50,-50,50,126500,126200,-636,-1364,-13964
72.014536,5,461,457,4,-4,126500,126200,498,-66198,-65190
72.014536,6,0,0,0,0,126500,126200,0,0,0
72.21627,0,121,189,-68,68,126500,126200,7892,70908,53772
72.21627,1,116,212,-96,96,126500,126200,8339,24861,669
72.21627,2,675,695,-20,20,126500,126200,1417,-91417,-96457
72.21627,3,36,48,-12,12,126500,126200,-3,12203,9179
72.21627,4,0,50,-50,50,126500,126200,-636,-1364,-13964
72.21627,5,461,457,4,-4,126500,126200,498,-66198,-65190
72.21627,6,0,0,0,0,126500,126200,0,0,0
72.513189,0,121,189,-68,68,126500,126200,7892,70908,53772
72.513189,1,116,212,-96,96,126500,126200,8339,24861,669
72.513189,2,685,695,-10,10,126500,126200,1670,-93670,-96190
72.513189,3,36,48,-12,12,126500,126200,-3,12203,9179
72.513189,4,0,50,-50,50,126500,126200,-636,-1364,-13964
72.513189,5,461,467,-6,6,126500,126200,372,-66072,-67584
72.513189,6,0,0,0,0,126500,126200,0,0,0
72.715928,0,121,189,-68,68,126500,126200,7892,70908,53772
72.715928,1,116,212,-96,96,126500,126200,8339,24861,669
72.715928,2,685,695,-10,10,126500,126200,1670,-93670,-96190
72.715928,3,36,48,-12,12,126500,126200,-3,12203,9179
72.715928,4,0,50,-50,50,126500,126200,-636,-1364,-13964
72.715928,5,461,467,-6,6,126500,126200,372,-66072,-67584
72.715928,6,0,0,0,0,126500,126200,0,0,0
73.007734,0,121,189,-68,68,126500,126200,7892,70908,53772
73.007734,1,116,212,-96,96,126500,126200,8339,24861,669
73.007734,2,685,695,-10,10,126500,126200,1670,-93670,-96190
73.007734,3,36,48,-12,12,126500,126200,-3,12203,9179
73.007734,4,0,50,-50,50,126500,126200,-636,-1364,-13964
73.007734,5,461,467,-6,6,126500,126200,372,-66072,-67584
73.007734,6,0,0,0,0,126500,126200,0,0,0
73.232213,0,121,189,-68,68,126500,126400,7892,70908,64108
73.232213,1,116,212,-96,96,126500,126400,8339,24861,15261
73.232213,2,685,695,-10,10,126500,126400,1670,-93670,-94670
73.232213,3,36,48,-12,12,126500,126400,-3,12203,11003
73.232213,4,0,50,-50,50,126500,126400,-636,-1364,-6364
73.232213,5,461,467,-6,6,126500,126400,372,-66072,-66672
73.232213,6,0,0,0,0,126500,126400,0,0,0
73.47261,0,121,189,-68,68,126500,126400,7892,70908,64108
73.47261,1,116,212,-96,96,126500,126400,8339,24861,15261
73.47261,2,685,695,-10,10,126500,126400,1670,-93670,-94670
73.47261,3,36,48,-12,12,126500,126400,-3,12203,11003
73.47261,4,0,50,-50,50,126500,126400,-636,-1364,-6364
73.47261,5,461,467,-6,6,126500,126400,372,-66072,-66672
73.47261,6,0,0,0,0,126500,126400,0,0,0
73.702102,0,121,189,-68,68,126500,126400,7892,70908,64108
73.702102,1,116,212,-96,96,126500,126400,8339,24861,15261
73.702102,2,685,695,-10,10,126500,126400,1670,-93670,-94670
73.702102,3,36,48,-12,12,126500,126400,-3,12203,11003
73.702102,4,0,50,-50,50,126500,126400,-636,-1364,-6364
73.702102,5,461,467,-6,6,126500,126400,372,-66072,-66672
73.702102,6,0,0,0,0,126500,126400,0,0,0
73.9992,0,121,189,-68,68,126500,126600,7892,70908,77708
73.9992,1,116,212,-96,96,126500,126600,8339,24861,34461
73.9992,2,685,695,-10,10,126500,126600,1670,-93670,-92670
73.9992,3,36,48,-12,12,126500,126600,-3,12203,13403
73.9992,4,0,50,-50,50,126500,126600,-636,-1364,3636
73.9992,5,461,467,-6,6,126500,126600,372,-66072,-65472
73.9992,6,0,0,0,0,126500,126600,0,0,0
74.269824,0,121,189,-68,68,126600,126600,7892,70908,70908
74.269824,1,116,212,-96,96,126600,126600,8339,24861,24861
74.269824,2,695,695,0,0,126600,126600,1543,-96543,-96543
74.269824,3,36,48,-12,12,126600,126600,-3,12203,12203
74.269824,4,0,50,-50,50,126600,126600,-636,-1364,-1364
74.269824,5,461,477,-16,16,126600,126600,625,-65325,-65325
74.269824,6,0,0,0,0,126600,126600,0,0,0
74.492165,0,121,189,-68,68,126600,126600,7892,70908,70908
74.492165,1,116,212,-96,96,126600,126600,8339,24861,24861
74.492165,2,695,695,0,0,126600,126600,1543,-96543,-96543
74.492165,3,36,48,-12,12,126600,126600,-3,12203,12203
74.492165,4,0,50,-50,50,126600,126600,-636,-1364,-1364
74.492165,5,461,477,-16,16,126600,126600,625,-65325,-65325
74.492165,6,0,0,0,0,126600,126600,0,0,0
74.76796,0,121,189,-68,68,126600,126600,7892,70908,70908
74.76796,1,116,212,-96,96,126600,126600,8339,24861,24861
74.76796,2,695,705,-10,10,126600,126600,1796,-95796,-95796
74.76796,3,36,48,-12,12,126600,126600,-3,12203,12203
74.76796,4,0,50,-50,50,126600,126600,-636,-1364,-1364
74.76796,5,471,477,-6,6,126600,126600,498,-67198,-67198
74.76796,6,0,0,0,0,126600,126600,0,0,0
75.005206,0,121,189,-68,68,126600,126600,7892,70908,70908
75.005206,1,116,212,-96,96,126600,126600,8339,24861,24861
75.005206,2,695,715,-20,20,126600,126600,2049,-95049,-95049
75.005206,3,36,48,-12,12,126600,126600,-3,12203,12203
75.005206,4,0,50,-50,50,126600,126600,-636,-1364,-1364
75.005206,5,481,477,4,-4,126600,126600,371,-69071,-69071
75.005206,6,0,0,0,0,126600,126600,0,0,0
75.226521,0,121,189,-68,68,126600,126600,7892,70908,70908
75.226521,1,116,212,-96,96,126600,126600,8339,24861,24861
75.226521,2,695,715,-20,20,126600,126600,2049,-95049,-95049
75.226521,3,36,48,-12,12,126600,126600,-3,12203,12203
75.226521,4,0,50,-50,50,126600,126600,-636,-1364,-1364
75.226521,5,481,477,4,-4,126600,126600,371,-69071,-69071
75.226521,6,0,0,0,0,126600,126600,0,0,0
75.547066,0,121,189,-68,68,126500,126600,7892,70908,77708
75.547066,1,116,212,-96,96,126500,126600,8339,24861,34461
75.547066,2,715,715,0,0,126500,126600,2176,-99176,-99176
75.547066,3,36,48,-12,12,126500,126600,-3,12203,13403
75.547066,4,2,50,-48,48,126500,126600,-661,-1139,3661
75.547066,5,491,487,4,-4,126500,126600,119,-69819,-70219
75.547066,6,0,0,0,0,126500,126600,0,0,0
75.706562,0,121,189,-68,68,126500,126600,7892,70908,77708
75.706562,1,116,212,-96,96,126500,126600,8339,24861,34461
75.706562,2,715,715,0,0,126500,126600,2176,-99176,-99176
75.706562,3,36,48,-12,12,126500,126600,-3,12203,13403
75.706562,4,2,50,-48,48,126500,126600,-661,-1139,3661
75.706562,5,491,487,4,-4,126500,126600,119,-69819,-70219
75.706562,6,0,0,0,0,126500,126600,0,0,0
75.98469,0,121,189,-68,68,126500,126600,7892,70908,77708
75.98469,1,116,212,-96,96,126500,126600,8339,24861,34461
75.98469,2,715,725,-10,10,126500,126600,2429,-99429,-98429
75.98469,3,36,48,-12,12,126500,126600,-3,12203,13403
75.98469,4,2,50,-48,48,126500,126600,-661,-1139,3661
75.98469,5,501,487,14,-14,126500,126600,-7,-70693,-72093
75.98469,6,0,0,0,0,126500,126600,0,0,0
76.281479,0,121,189,-68,68,126500,126600,7892,70908,77708
76.281479,1,116,212,-96,96,126500,126600,8339,24861,34461
76.281479,2,715,725,-10,10,126500,126600,2429,-99429,-98429
76.281479,3,36,48,-12,12,126500,126600,-3,12203,13403
76.281479,4,2,50,-48,48,126500,126600,-661,-1139,3661
76.281479,5,501,487,14,-14,126500,126600,-7,-70693,-72093
76.281479,6,0,0,0,0,126500,126600,0,0,0
76.529043,0,121,189,-68,68,126600,126600,7892,70908,70908
76.529043,1,116,212,-96,96,126600,126600,8339,24861,24861
76.529043,2,725,725,0,0,126600,126600,2302,-101302,-101302
76.529043,3,36,48,-12,12,126600,126600,-3,12203,12203
76.529043,4,2,50,-48,48,126600,126600,-661,-1139,-1139
76.529043,5,501,497,4,-4,126600,126600,246,-70946,-70946
76.529043,6,0,0,0,0,126600,126600,0,0,0
76.74945,0,121,189,-68,68,126500,126600,7892,70908,77708
76.74945,1,116,212,-96,96,126500,126600,8339,24861,34461
76.74945,2,735,725,10,-10,126500,126600,2176,-103176,-104176
76.74945,3,36,48,-12,12,126500,126600,-3,12203,13403
76.74945,4,2,50,-48,48,126500,126600,-661,-1139,3661
76.74945,5,501,507,-6,6,126500,126600,499,-71199,-70599
76.74945,6,0,0,0,0,126500,126600,0,0,0
77.034868,0,121,189,-68,68,126500,126600,7892,70908,77708
77.034868,1,116,212,-96,96,126500,126600,8339,24861,34461
77.034868,2,735,735,0,0,126500,126600,2050,-102050,-102050
77.034868,3,36,48,-12,12,126500,126600,-3,12203,13403
77.034868,4,2,50,-48,48,126500,126600,-661,-1139,3661
77.034868,5,511,507,4,-4,126500,126600,752,-74452,-74852
77.034868,6,0,0,0,0,126500,126600,0,0,0
77.212821,0,121,189,-68,68,126500,126600,7892,70908,77708
77.212821,1,116,212,-96,96,126500,126600,8339,24861,34461
77.212821,2,735,735,0,0,126500,126600,2050,-102050,-102050
77.212821,3,36,48,-12,12,126500,126600,-3,12203,13403
77.212821,4,2,50,-48,48,126500,126600,-661,-1139,3661
77.212821,5,511,507,4,-4,126500,126600,752,-74452,-74852
77.212821,6,0,0,0,0,126500,126600,0,0,0
77.453787,0,121,189,-68,68,126500,126200,7892,70908,53772
77.453787,1,116,212,-96,96,126500,126200,8339,24861,669
77.453787,2,735,735,0,0,126500,126200,2050,-102050,-102050
77.453787,3,36,48,-12,12,126500,126200,-3,12203,9179
77.453787,4,2,50,-48,48,126500,126200,-661,-1139,-13235
77.453787,5,511,507,4,-4,126500,126200,752,-74452,-73444
77.453787,6,0,0,0,0,126500,126200,0,0,0
77.768113,0,121,189,-68,68,126700,126200,7892,70908,53772
77.768113,1,116,212,-96,96,126700,126200,8339,24861,669
77.768113,2,735,745,-10,10,126700,126200,2302,-102302,-104822
77.768113,3,36,50,-14,14,126700,126200,-28,12828,9300
77.768113,4,10,50,-40,40,126700,126200,-762,-1838,-11918
77.768113,5,511,507,4,-4,126700,126200,752,-74452,-73444
77.768113,6,0,0,0,0,126700,126200,0,0,0
78.021928,0,121,189,-68,68,126500,126200,7892,70908,53772
78.021928,1,116,212,-96,96,126500,126200,8339,24861,669
78.021928,2,735,755,-20,20,126500,126200,2555,-99555,-104595
78.021928,3,36,50,-14,14,126500,126200,-28,12828,9300
78.021928,4,20,50,-30,30,126500,126200,-888,-5712,-13272
78.021928,5,511,507,4,-4,126500,126200,752,-74452,-73444
78.021928,6,0,0,0,0,126500,126200,0,0,0
78.282169,0,121,189,-68,68,126400,126000,7892,70908,53772
78.282169,1,116,212,-96,96,126400,126000,8339,24861,669
78.282169,2,735,765,-30,30,126400,126000,2808,-98808,-106368
78.282169,3,36,50,-14,14,126400,126000,-28,12828,9300
78.282169,4,30,50,-20,20,126400,126000,-1014,-8586,-13626
78.282169,5,511,507,4,-4,126400,126000,752,-74452,-73444
78.282169,6,0,0,0,0,126400,126000,0,0,0
78.514433,0,121,219,-98,98,126200,125800,8650,77150,52454
78.514433,1,116,212,-96,96,126200,125800,8339,24861,669
78.514433,2,745,765,-20,20,126200,125800,2682,-102682,-107722
78.514433,3,36,50,-14,14,126200,125800,-28,12828,9300
78.514433,4,30,50,-20,20,126200,125800,-1014,-8586,-13626
78.514433,5,511,507,4,-4,126200,125800,752,-74452,-73444
78.514433,6,0,0,0,0,126200,125800,0,0,0
78.771216,0,121,221,-100,100,126200,125800,8700,77700,52500
78.771216,1,116,212,-96,96,126200,125800,8339,24861,669
78.771216,2,745,775,-30,30,126200,125800,2934,-99934,-107494
78.771216,3,36,50,-14,14,126200,125800,-28,12828,9300
78.771216,4,30,50,-20,20,126200,125800,-1014,-8586,-13626
78.771216,5,511,507,4,-4,126200,125800,752,-74452,-73444
78.771216,6,0,0,0,0,126200,125800,0,0,0
79.015852,0,121,221,-100,100,126200,125900,8700,77700,52500
79.015852,1,116,212,-96,96,126200,125900,8339,24861,669
79.015852,2,745,775,-30,30,126200,125900,2934,-99934,-107494
79.015852,3,36,50,-14,14,126200,125900,-28,12828,9300
79.015852,4,30,50,-20,20,126200,125900,-1014,-8586,-13626
79.015852,5,511,507,4,-4,126200,125900,752,-74452,-73444
79.015852,6,0,0,0,0,126200,125900,0,0,0
79.23142,0,121,221,-100,100,126000,125900,8700,77700,67700
79.23142,1,116,212,-96,96,126000,125900,8339,24861,15261
79.23142,2,755,775,-20,20,126000,125900,2808,-102808,-104808
79.23142,3,36,50,-14,14,126000,125900,-28,12828,11428
79.23142,4,40,50,-10,10,126000,125900,-1140,-10460,-11460
79.23142,5,511,517,-6,6,126000,125900,1004,-73704,-74304
79.23142,6,0,0,0,0,126000,125900,0,0,0
79.458637,0,121,221,-100,100,126000,125900,8700,77700,67700
79.458637,1,116,212,-96,96,126000,125900,8339,24861,15261
79.458637,2,755,775,-20,20,126000,125900,2808,-102808,-104808
79.458637,3,36,50,-14,14,126000,125900,-28,12828,11428
79.458637,4,40,50,-10,10,126000,125900,-1140,-10460,-11460
79.458637,5,511,517,-6,6,126000,125900,1004,-73704,-74304
79.458637,6,0,0,0,0,126000,125900,0,0,0
79.769468,0,121,221,-100,100,125900,126000,8700,77700,87700
79.769468,1,116,212,-96,96,125900,126000,8339,24861,34461
79.769468,2,765,775,-10,10,125900,126000,2682,-104682,-103682
79.769468,3,36,50,-14,14,125900,126000,-28,12828,14228
79.769468,4,40,50,-10,10,125900,126000,-1140,-10460,-9460
79.769468,5,521,517,4,-4,125900,126000,878,-75578,-75978
79.769468,6,0,0,0,0,125900,126000,0,0,0
79.996906,0,121,221,-100,100,125900,126000,8700,77700,87700
79.996906,1,116,212,-96,96,125900,126000,8339,24861,34461
79.996906,2,765,775,-10,10,125900,126000,2682,-104682,-103682
79.996906,3,36,50,-14,14,125900,126000,-28,12828,14228
79.996906,4,40,50,-10,10,125900,126000,-1140,-10460,-9460
79.996906,5,521,517,4,-4,125900,126000,878,-75578,-75978
79.996906,6,0,0,0,0,125900,126000,0,0,0
80.243396,0,121,221,-100,100,126000,126000,8700,77700,77700
80.243396,1,116,212,-96,96,126000,126000,8339,24861,24861
80.243396,2,765,785,-20,20,126000,126000,2934,-103934,-103934
80.243396,3,36,50,-14,14,126000,126000,-28,12828,12828
80.243396,4,40,50,-10,10,126000,126000,-1140,-10460,-10460
80.243396,5,531,517,14,-14,126000,126000,752,-77452,-77452
80.243396,6,0,0,0,0,126000,126000,0,0,0
80.46186,0,121,221,-100,100,125900,125700,8700,77700,57700
80.46186,1,116,212,-96,96,125900,125700,8339,24861,5661
80.46186,2,765,785,-20,20,125900,125700,2934,-103934,-107934
80.46186,3,36,50,-14,14,125900,125700,-28,12828,10028
80.46186,4,40,50,-10,10,125900,125700,-1140,-10460,-12460
80.46186,5,531,517,14,-14,125900,125700,752,-77452,-74652
80.46186,6,0,0,0,0,125900,125700,0,0,0
80.796352,0,121,221,-100,100,125900,125700,8700,77700,57700
80.796352,1,116,212,-96,96,125900,125700,8339,24861,5661
80.796352,2,765,785,-20,20,125900,125700,2934,-103934,-107934
80.796352,3,36,50,-14,14,125900,125700,-28,12828,10028
80.796352,4,40,50,-10,10,125900,125700,-1140,-10460,-12460
80.796352,5,531,517,14,-14,125900,125700,752,-77452,-74652
80.796352,6,0,0,0,0,125900,125700,0,0,0
81.045794,0,121,221,-100,100,125900,125800,8700,77700,67700
81.045794,1,116,212,-96,96,125900,125800,8339,24861,15261
81.045794,2,765,795,-30,30,125900,125800,3186,-102186,-105186
81.045794,3,36,50,-14,14,125900,125800,-28,12828,11428
81.045794,4,40,50,-10,10,125900,125800,-1140,-10460,-11460
81.045794,5,531,517,14,-14,125900,125800,752,-77452,-76052
81.045794,6,0,0,0,0,125900,125800,0,0,0
81.280601,0,121,221,-100,100,125900,125500,8700,77700,52600
81.280601,1,116,212,-96,96,125900,125500,8339,24861,765
81.280601,2,765,795,-30,30,125900,125500,3186,-102186,-109716
81.280601,3,36,50,-14,14,125900,125500,-28,12828,9314
81.280601,4,40,50,-10,10,125900,125500,-1140,-10460,-12970
81.280601,5,531,527,4,-4,125900,125500,1004,-77704,-76700
81.280601,6,0,0,0,0,125900,125500,0,0,0
81.538078,0,121,221,-100,100,125700,125500,8700,77700,57700
81.538078,1,116,212,-96,96,125700,125500,8339,24861,5661
81.538078,2,777,795,-18,18,125700,125500,3035,-104035,-107635
81.538078,3,36,52,-16,16,125700,125500,22,13378,10178
81.538078,4,50,50,0,0,125700,125500,-1266,-12334,-12334
81.538078,5,531,527,4,-4,125700,125500,1004,-77704,-76904
81.538078,6,0,0,0,0,125700,125500,0,0,0
81.755551,0,121,221,-100,100,125700,125500,8700,77700,57700
81.755551,1,116,212,-96,96,125700,125500,8339,24861,5661
81.755551,2,777,795,-18,18,125700,125500,3035,-104035,-107635
81.755551,3,36,52,-16,16,125700,125500,22,13378,10178
81.755551,4,50,50,0,0,125700,125500,-1266,-12334,-12334
81.755551,5,531,527,4,-4,125700,125500,1004,-77704,-76904
81.755551,6,0,0,0,0,125700,125500,0,0,0
81.982742,0,121,221,-100,100,125700,125500,8700,77700,57700
81.982742,1,116,212,-96,96,125700,125500,8339,24861,5661
81.982742,2,777,795,-18,18,125700,125500,3035,-104035,-107635
81.982742,3,36,52,-16,16,125700,125500,22,13378,10178
81.982742,4,50,50,0,0,125700,125500,-1266,-12334,-12334
81.982742,5,531,527,4,-4,125700,125500,1004,-77704,-76904
81.982742,6,0,0,0,0,125700,125500,0,0,0
82.291642,0,121,221,-100,100,125700,125500,8700,77700,57700
82.291642,1,116,212,-96,96,125700,125500,8339,24861,5661
82.291642,2,777,795,-18,18,125700,125500,3035,-104035,-107635
82.291642,3,36,52,-16,16,125700,125500,22,13378,10178
82.291642,4,50,50,0,0,125700,125500,-1266,-12334,-12334
82.291642,5,531,527,4,-4,125700,125500,1004,-77704,-76904
82.291642,6,0,0,0,0,125700,125500,0,0,0
82.454144,0,121,221,-100,100,126000,125500,8700,77700,52600
82.454144,1,116,212,-96,96,126000,125500,8339,24861,765
82.454144,2,787,795,-8,8,126000,125500,3287,-105287,-107295
82.454144,3,36,52,-16,16,126000,125500,22,13378,9362
82.454144,4,50,50,0,0,126000,125500,-1266,-12334,-12334
82.454144,5,531,537,-6,6,126000,125500,878,-77578,-79084
82.454144,6,0,0,0,0,126000,125500,0,0,0
82.716344,0,121,221,-100,100,126000,126000,8700,77700,77700
82.716344,1,116,212,-96,96,126000,126000,8339,24861,24861
82.716344,2,787,795,-8,8,126000,126000,3287,-105287,-105287
82.716344,3,36,52,-16,16,126000,126000,22,13378,13378
82.716344,4,50,50,0,0,126000,126000,-1266,-12334,-12334
82.716344,5,531,537,-6,6,126000,126000,878,-77578,-77578
82.716344,6,0,0,0,0,126000,126000,0,0,0
82.981946,0,121,221,-100,100,126000,126000,8700,77700,77700
82.981946,1,116,212,-96,96,126000,126000,8339,24861,24861
82.981946,2,787,795,-8,8,126000,126000,3287,-105287,-105287
82.981946,3,36,52,-16,16,126000,126000,22,13378,13378
82.981946,4,50,50,0,0,126000,126000,-1266,-12334,-12334
82.981946,5,531,537,-6,6,126000,126000,878,-77578,-77578
82.981946,6,0,0,0,0,126000,126000,0,0,0
83.240389,0,121,221,-100,100,126200,126000,8700,77700,57700
83.240389,1,116,212,-96,96,126200,126000,8339,24861,5661
83.240389,2,787,805,-18,18,126200,126000,3161,-104161,-107761
83.240389,3,36,52,-16,16,126200,126000,22,13378,10178
83.240389,4,50,50,0,0,126200,126000,-1266,-12334,-12334
83.240389,5,531,541,-10,10,126200,126000,828,-76728,-78728
83.240389,6,0,0,0,0,126200,126000,0,0,0
83.55006,0,121,221,-100,100,125900,126000,8700,77700,87700
83.55006,1,116,212,-96,96,125900,126000,8339,24861,34461
83.55006,2,797,805,-8,8,125900,126000,3035,-105035,-104235
83.55006,3,36,52,-16,16,125900,126000,22,13378,14978
83.55006,4,50,50,0,0,125900,126000,-1266,-12334,-12334
83.55006,5,535,541,-6,6,125900,126000,778,-76678,-76078
83.55006,6,0,0,0,0,125900,126000,0,0,0
83.731828,0,121,221,-100,100,125900,126000,8700,77700,87700
83.731828,1,116,212,-96,96,125900,126000,8339,24861,34461
83.731828,2,797,805,-8,8,125900,126000,3035,-105035,-104235
83.731828,3,36,52,-16,16,125900,126000,22,13378,14978
83.731828,4,50,50,0,0,125900,126000,-1266,-12334,-12334
83.731828,5,535,541,-6,6,125900,126000,778,-76678,-76078
83.731828,6,0,0,0,0,125900,126000,0,0,0
83.98515,0,121,221,-100,100,125900,126200,8700,77700,102900
83.98515,1,116,212,-96,96,125900,126200,8339,24861,49053
83.98515,2,797,805,-8,8,125900,126200,3035,-105035,-103019
83.98515,3,36,52,-16,16,125900,126200,22,13378,17410
83.98515,4,50,50,0,0,125900,126200,-1266,-12334,-12334
83.98515,5,535,541,-6,6,125900,126200,778,-76678,-75166
83.98515,6,0,0,0,0,125900,126200,0,0,0
84.293895,0,121,221,-100,100,125900,126200,8700,77700,102900
84.293895,1,116,212,-96,96,125900,126200,8339,24861,49053
84.293895,2,797,805,-8,8,125900,126200,3035,-105035,-103019
84.293895,3,36,52,-16,16,125900,126200,22,13378,17410
84.293895,4,50,50,0,0,125900,126200,-1266,-12334,-12334
84.293895,5,535,541,-6,6,125900,126200,778,-76678,-75166
84.293895,6,0,0,0,0,125900,126200,0,0,0
84.485117,0,121,221,-100,100,126500,126200,8700,77700,52500
84.485117,1,116,212,-96,96,126500,126200,8339,24861,669
84.485117,2,797,805,-8,8,126500,126200,3035,-105035,-107051
84.485117,3,36,52,-16,16,126500,126200,22,13378,9346
84.485117,4,50,50,0,0,126500,126200,-1266,-12334,-12334
84.485117,5,535,541,-6,6,126500,126200,778,-76678,-78190
84.485117,6,0,0,0,0,126500,126200,0,0,0
84.743129,0,121,221,-100,100,126500,126100,8700,77700,52500
84.743129,1,116,212,-96,96,126500,126100,8339,24861,669
84.743129,2,797,805,-8,8,126500,126100,3035,-105035,-107051
84.743129,3,36,52,-16,16,126500,126100,22,13378,9346
84.743129,4,50,50,0,0,126500,126100,-1266,-12334,-12334
84.743129,5,535,541,-6,6,126500,126100,778,-76678,-78190
84.743129,6,0,0,0,0,126500,126100,0,0,0
85.021679,0,121,221,-100,100,126500,126200,8700,77700,52500
85.021679,1,116,212,-96,96,126500,126200,8339,24861,669
85.021679,2,797,805,-8,8,126500,126200,3035,-105035,-107051
85.021679,3,36,52,-16,16,126500,126200,22,13378,9346
85.021679,4,50,50,0,0,126500,126200,-1266,-12334,-12334
85.021679,5,535,541,-6,6,126500,126200,778,-76678,-78190
85.021679,6,0,0,0,0,126500,126200,0,0,0
85.209261,0,121,221,-100,100,126200,126200,8700,77700,77700
85.209261,1,116,212,-96,96,126200,126200,8339,24861,24861
85.209261,2,805,805,0,0,126200,126200,2934,-105734,-105734
85.209261,3,36,52,-16,16,126200,126200,22,13378,13378
85.209261,4,50,50,0,0,126200,126200,-1266,-12334,-12334
85.209261,5,545,541,4,-4,126200,126200,652,-77552,-77552
85.209261,6,0,0,0,0,126200,126200,0,0,0
85.454492,0,121,221,-100,100,126200,126200,8700,77700,77700
85.454492,1,116,212,-96,96,126200,126200,8339,24861,24861
85.454492,2,805,805,0,0,126200,126200,2934,-105734,-105734
85.454492,3,36,52,-16,16,126200,126200,22,13378,13378
85.454492,4,50,50,0,0,126200,126200,-1266,-12334,-12334
85.454492,5,545,541,4,-4,126200,126200,652,-77552,-77552
85.454492,6,0,0,0,0,126200,126200,0,0,0
85.775017,0,121,221,-100,100,126000,126200,8700,77700,97700
85.775017,1,116,212,-96,96,126000,126200,8339,24861,44061
85.775017,2,815,805,10,-10,126000,126200,2808,-104608,-106608
85.775017,3,36,52,-16,16,126000,126200,22,13378,16578
85.775017,4,50,50,0,0,126000,126200,-1266,-12334,-12334
85.775017,5,550,541,9,-9,126000,126200,589,-76489,-78289
85.775017,6,0,0,0,0,126000,126200,0,0,0
86.028318,0,121,221,-100,100,126400,126300,8700,77700,67700
86.028318,1,116,212,-96,96,126400,126300,8339,24861,15261
86.028318,2,815,819,-4,4,126400,126300,2632,-105432,-105832
86.028318,3,40,52,-12,12,126400,126300,124,12876,11676
86.028318,4,50,50,0,0,126400,126300,-1266,-12334,-12334
86.028318,5,560,541,19,-19,126400,126300,842,-76742,-74842
86.028318,6,0,0,0,0,126400,126300,0,0,0
86.240533,0,121,221,-100,100,126600,126300,8700,77700,52400
86.240533,1,116,212,-96,96,126600,126300,8339,24861,573
86.240533,2,820,819,1,-1,126600,126300,2758,-106058,-105805
86.240533,3,44,52,-8,8,126600,126300,226,11974,9950
86.240533,4,50,50,0,0,126600,126300,-1266,-12334,-12334
86.240533,5,560,545,15,-15,126600,126300,792,-76692,-72897
86.240533,6,0,0,0,0,126600,126300,0,0,0
86.516416,0,121,221,-100,100,126600,126300,8700,77700,52400
86.516416,1,116,212,-96,96,126600,126300,8339,24861,573
86.516416,2,820,819,1,-1,126600,126300,2758,-106058,-105805
86.516416,3,44,52,-8,8,126600,126300,226,11974,9950
86.516416,4,50,50,0,0,126600,126300,-1266,-12334,-12334
86.516416,5,560,545,15,-15,126600,126300,792,-76692,-72897
86.516416,6,0,0,0,0,126600,126300,0,0,0
86.741465,0,121,221,-100,100,126600,126300,8700,77700,52400
86.741465,1,116,212,-96,96,126600,126300,8339,24861,573
86.741465,2,820,819,1,-1,126600,126300,2758,-106058,-105805
86.741465,3,44,52,-8,8,126600,126300,226,11974,9950
86.741465,4,50,50,0,0,126600,126300,-1266,-12334,-12334
86.741465,5,560,545,15,-15,126600,126300,792,-76692,-72897
86.741465,6,0,0,0,0,126600,126300,0,0,0
86.976139,0,121,221,-100,100,126600,126300,8700,77700,52400
86.976139,1,116,212,-96,96,126600,126300,8339,24861,573
86.976139,2,820,819,1,-1,126600,126300,2758,-106058,-105805
86.976139,3,44,52,-8,8,126600,126300,226,11974,9950
86.976139,4,50,50,0,0,126600,126300,-1266,-12334,-12334
86.976139,5,560,545,15,-15,126600,126300,792,-76692,-72897
86.976139,6,0,0,0,0,126600,126300,0,0,0
87.268179,0,121,221,-100,100,126600,126300,8700,77700,52400
87.268179,1,116,212,-96,96,126600,126300,8339,24861,573
87.268179,2,820,819,1,-1,126600,126300,2758,-106058,-105805
87.268179,3,44,52,-8,8,126600,126300,226,11974,9950
87.268179,4,50,50,0,0,126600,126300,-1266,-12334,-12334
87.268179,5,560,545,15,-15,126600,126300,792,-76692,-72897
87.268179,6,0,0,0,0,126600,126300,0,0,0
87.498641,0,121,221,-100,100,126400,126700,8700,77700,103000
87.498641,1,116,212,-96,96,126400,126700,8339,24861,49149
87.498641,2,830,819,11,-11,126400,126700,2632,-106932,-109715
87.498641,3,44,52,-8,8,126400,126700,226,11974,13998
87.498641,4,50,50,0,0,126400,126700,-1266,-12334,-12334
87.498641,5,560,555,5,-5,126400,126700,1045,-76945,-78210
87.498641,6,0,0,0,0,126400,126700,0,0,0
87.767294,0,131,221,-90,90,126700,126600,8953,79447,70447
87.767294,1,116,212,-96,96,126700,126600,8339,24861,15261
87.767294,2,830,829,1,-1,126700,126600,2506,-110806,-110706
87.767294,3,48,52,-4,4,126700,126600,328,11472,11072
87.767294,4,50,50,0,0,126700,126600,-1266,-12334,-12334
87.767294,5,560,555,5,-5,126700,126600,1045,-76945,-76445
87.767294,6,0,0,0,0,126700,126600,0,0,0
87.997818,0,131,221,-90,90,126700,126600,8953,79447,70447
87.997818,1,116,212,-96,96,126700,126600,8339,24861,15261
87.997818,2,830,829,1,-1,126700,126600,2506,-110806,-110706
87.997818,3,48,52,-4,4,126700,126600,328,11472,11072
87.997818,4,50,50,0,0,126700,126600,-1266,-12334,-12334
87.997818,5,560,555,5,-5,126700,126600,1045,-76945,-76445
87.997818,6,0,0,0,0,126700,126600,0,0,0
88.224812,0,131,221,-90,90,126700,126600,8953,79447,70447
88.224812,1,116,212,-96,96,126700,126600,8339,24861,15261
88.224812,2,830,829,1,-1,126700,126600,2506,-110806,-110706
88.224812,3,48,52,-4,4,126700,126600,328,11472,11072
88.224812,4,50,50,0,0,126700,126600,-1266,-12334,-12334
88.224812,5,560,555,5,-5,126700,126600,1045,-76945,-76445
88.224812,6,0,0,0,0,126700,126600,0,0,0
88.511779,0,131,221,-90,90,126700,126600,8953,79447,70447
88.511779,1,116,212,-96,96,126700,126600,8339,24861,15261
88.511779,2,830,829,1,-1,126700,126600,2506,-110806,-110706
88.511779,3,48,52,-4,4,126700,126600,328,11472,11072
88.511779,4,50,50,0,0,126700,126600,-1266,-12334,-12334
88.511779,5,560,555,5,-5,126700,126600,1045,-76945,-76445
88.511779,6,0,0,0,0,126700,126600,0,0,0
88.783092,0,131,221,-90,90,126700,126600,8953,79447,70447
88.783092,1,116,212,-96,96,126700,126600,8339,24861,15261
88.783092,2,830,829,1,-1,126700,126600,2506,-110806,-110706
88.783092,3,48,52,-4,4,126700,126600,328,11472,11072
88.783092,4,50,50,0,0,126700,126600,-1266,-12334,-12334
88.783092,5,560,555,5,-5,126700,126600,1045,-76945,-76445
88.783092,6,0,0,0,0,126700,126600,0,0,0
89.03907,0,131,221,-90,90,126600,126600,8953,79447,79447
89.03907,1,116,212,-96,96,126600,126600,8339,24861,24861
89.03907,2,840,841,-1,1,126600,126600,2608,-111708,-111708
89.03907,3,50,52,-2,2,126600,126600,379,11021,11021
89.03907,4,50,50,0,0,126600,126600,-1266,-12334,-12334
89.03907,5,570,565,5,-5,126600,126600,1172,-78072,-78072
89.03907,6,0,0,0,0,126600,126600,0,0,0
89.246283,0,131,221,-90,90,126600,126600,8953,79447,79447
89.246283,1,116,212,-96,96,126600,126600,8339,24861,24861
89.246283,2,840,841,-1,1,126600,126600,2608,-111708,-111708
89.246283,3,50,52,-2,2,126600,126600,379,11021,11021
89.246283,4,50,50,0,0,126600,126600,-1266,-12334,-12334
89.246283,5,570,565,5,-5,126600,126600,1172,-78072,-78072
89.246283,6,0,0,0,0,126600,126600,0,0,0
89.470059,0,131,221,-90,90,126600,126600,8953,79447,79447
89.470059,1,116,212,-96,96,126600,126600,8339,24861,24861
89.470059,2,840,841,-1,1,126600,126600,2608,-111708,-111708
89.470059,3,50,52,-2,2,126600,126600,379,11021,11021
89.470059,4,50,50,0,0,126600,126600,-1266,-12334,-12334
89.470059,5,570,565,5,-5,126600,126600,1172,-78072,-78072
89.470059,6,0,0,0,0,126600,126600,0,0,0
89.720137,0,131,221,-90,90,126600,126500,8953,79447,70447
89.720137,1,116,212,-96,96,126600,126500,8339,24861,15261
89.720137,2,840,841,-1,1,126600,126500,2608,-111708,-111808
89.720137,3,50,52,-2,2,126600,126500,379,11021,10821
89.720137,4,50,50,0,0,126600,126500,-1266,-12334,-12334
89.720137,5,570,565,5,-5,126600,126500,1172,-78072,-77572
89.720137,6,0,0,0,0,126600,126500,0,0,0
90.01438,0,131,221,-90,90,126700,126500,8953,79447,61447
90.01438,1,116,212,-96,96,126700,126500,8339,24861,5661
90.01438,2,840,841,-1,1,126700,126500,2608,-111708,-111908
90.01438,3,52,52,0,0,126700,126500,430,10570,10570
90.01438,4,50,50,0,0,126700,126500,-1266,-12334,-12334
90.01438,5,570,565,5,-5,126700,126500,1172,-78072,-77072
90.01438,6,0,0,0,0,126700,126500,0,0,0
90.225653,0,131,221,-90,90,126700,126500,8953,79447,61447
90.225653,1,116,212,-96,96,126700,126500,8339,24861,5661
90.225653,2,840,841,-1,1,126700,126500,2608,-111708,-111908
90.225653,3,52,52,0,0,126700,126500,430,10570,10570
90.225653,4,50,50,0,0,126700,126500,-1266,-12334,-12334
90.225653,5,570,565,5,-5,126700,126500,1172,-78072,-77072
90.225653,6,0,0,0,0,126700,126500,0,0,0
90.540198,0,131,221,-90,90,126700,126500,8953,79447,61447
90.540198,1,116,212,-96,96,126700,126500,8339,24861,5661
90.540198,2,840,841,-1,1,126700,126500,2608,-111708,-111908
90.540198,3,52,52,0,0,126700,126500,430,10570,10570
90.540198,4,50,50,0,0,126700,126500,-1266,-12334,-12334
90.540198,5,570,565,5,-5,126700,126500,1172,-78072,-77072
90.540198,6,0,0,0,0,126700,126500,0,0,0
90.795293,0,131,221,-90,90,126700,126500,8953,79447,61447
90.795293,1,116,212,-96,96,126700,126500,8339,24861,5661
90.795293,2,850,841,9,-9,126700,126500,2861,-112961,-111161
90.795293,3,52,52,0,0,126700,126500,430,10570,10570
90.795293,4,50,50,0,0,126700,126500,-1266,-12334,-12334
90.795293,5,570,570,0,0,126700,126500,1109,-78009,-78009
90.795293,6,0,0,0,0,126700,126500,0,0,0
90.975739,0,131,221,-90,90,126000,126500,8953,79447,102217
90.975739,1,116,212,-96,96,126000,126500,8339,24861,49149
90.975739,2,860,841,19,-19,126000,126500,2734,-112834,-117641
90.975739,3,54,52,2,-2,126000,126500,405,11195,10689
90.975739,4,50,50,0,0,126000,126500,-1266,-12334,-12334
90.975739,5,580,570,10,-10,126000,126500,983,-76883,-79413
90.975739,6,0,0,0,0,126000,126500,0,0,0
91.218588,0,131,221,-90,90,126000,126500,8953,79447,102217
91.218588,1,116,212,-96,96,126000,126500,8339,24861,49149
91.218588,2,860,841,19,-19,126000,126500,2734,-112834,-117641
91.218588,3,54,52,2,-2,126000,126500,405,11195,10689
91.218588,4,50,50,0,0,126000,126500,-1266,-12334,-12334
91.218588,5,580,570,10,-10,126000,126500,983,-76883,-79413
91.218588,6,0,0,0,0,126000,126500,0,0,0
91.503243,0,131,221,-90,90,126000,126600,8953,79447,102217
91.503243,1,116,212,-96,96,126000,126600,8339,24861,49149
91.503243,2,860,841,19,-19,126000,126600,2734,-112834,-117641
91.503243,3,54,52,2,-2,126000,126600,405,11195,10689
91.503243,4,50,50,0,0,126000,126600,-1266,-12334,-12334
91.503243,5,580,570,10,-10,126000,126600,983,-76883,-79413
91.503243,6,0,0,0,0,126000,126600,0,0,0
91.74734,0,131,221,-90,90,126500,126700,8953,79447,97447
91.74734,1,116,212,-96,96,126500,126700,8339,24861,44061
91.74734,2,860,845,15,-15,126500,126700,2683,-113183,-116183
91.74734,3,54,52,2,-2,126500,126700,405,11195,10795
91.74734,4,50,50,0,0,126500,126700,-1266,-12334,-12334
91.74734,5,580,570,10,-10,126500,126700,983,-76883,-78883
91.74734,6,0,0,0,0,126500,126700,0,0,0
92.035337,0,131,221,-90,90,127200,126700,8953,79447,56677
92.035337,1,116,212,-96,96,127200,126700,8339,24861,573
92.035337,2,860,851,9,-9,127200,126700,2607,-114307,-112030
92.035337,3,54,54,0,0,127200,126700,380,11620,11620
92.035337,4,50,50,0,0,127200,126700,-1266,-12334,-12334
92.035337,5,580,570,10,-10,127200,126700,983,-76883,-74353
92.035337,6,0,0,0,0,127200,126700,0,0,0
92.258517,0,131,221,-90,90,127200,126700,8953,79447,56677
92.258517,1,116,212,-96,96,127200,126700,8339,24861,573
92.258517,2,860,851,9,-9,127200,126700,2607,-114307,-112030
92.258517,3,54,54,0,0,127200,126700,380,11620,11620
92.258517,4,50,50,0,0,127200,126700,-1266,-12334,-12334
92.258517,5,580,570,10,-10,127200,126700,983,-76883,-74353
92.258517,6,0,0,0,0,127200,126700,0,0,0
92.481852,0,131,221,-90,90,127200,126600,8953,79447,56677
92.481852,1,116,212,-96,96,127200,126600,8339,24861,573
92.481852,2,860,851,9,-9,127200,126600,2607,-114307,-112030
92.481852,3,54,54,0,0,127200,126600,380,11620,11620
92.481852,4,50,50,0,0,127200,126600,-1266,-12334,-12334
92.481852,5,580,570,10,-10,127200,126600,983,-76883,-74353
92.481852,6,0,0,0,0,127200,126600,0,0,0
92.711383,0,131,221,-90,90,127200,126600,8953,79447,56677
92.711383,1,116,212,-96,96,127200,126600,8339,24861,573
92.711383,2,860,851,9,-9,127200,126600,2607,-114307,-112030
92.711383,3,54,54,0,0,127200,126600,380,11620,11620
92.711383,4,50,50,0,0,127200,126600,-1266,-12334,-12334
92.711383,5,580,570,10,-10,127200,126600,983,-76883,-74353
92.711383,6,0,0,0,0,127200,126600,0,0,0
93.024175,0,131,221,-90,90,127200,126900,8953,79447,56587
93.024175,1,116,212,-96,96,127200,126900,8339,24861,477
93.024175,2,860,851,9,-9,127200,126900,2607,-114307,-112021
93.024175,3,54,54,0,0,127200,126900,380,11620,11620
93.024175,4,50,50,0,0,127200,126900,-1266,-12334,-12334
93.024175,5,580,570,10,-10,127200,126900,983,-76883,-74343
93.024175,6,0,0,0,0,127200,126900,0,0,0
93.284627,0,131,221,-90,90,127200,126900,8953,79447,56587
93.284627,1,116,212,-96,96,127200,126900,8339,24861,477
93.284627,2,860,851,9,-9,127200,126900,2607,-114307,-112021
93.284627,3,54,54,0,0,127200,126900,380,11620,11620
93.284627,4,50,50,0,0,127200,126900,-1266,-12334,-12334
93.284627,5,580,570,10,-10,127200,126900,983,-76883,-74343
93.284627,6,0,0,0,0,127200,126900,0,0,0
93.512901,0,131,221,-90,90,126900,126900,8953,79447,79447
93.512901,1,116,212,-96,96,126900,126900,8339,24861,24861
93.512901,2,870,851,19,-19,126900,126900,2861,-115561,-115561
93.512901,3,54,54,0,0,126900,126900,380,11620,11620
93.512901,4,50,50,0,0,126900,126900,-1266,-12334,-12334
93.512901,5,580,580,0,0,126900,126900,856,-76756,-76756
93.512901,6,0,0,0,0,126900,126900,0,0,0
93.729851,0,131,221,-90,90,126900,127100,8953,79447,97447
93.729851,1,116,212,-96,96,126900,127100,8339,24861,44061
93.729851,2,870,851,19,-19,126900,127100,2861,-115561,-119361
93.729851,3,54,54,0,0,126900,127100,380,11620,11620
93.729851,4,50,50,0,0,126900,127100,-1266,-12334,-12334
93.729851,5,580,580,0,0,126900,127100,856,-76756,-76756
93.729851,6,0,0,0,0,126900,127100,0,0,0
93.97968,0,141,221,-80,80,126800,127300,9207,81193,101593
93.97968,1,116,212,-96,96,126800,127300,8339,24861,49341
93.97968,2,870,861,9,-9,126800,127300,2734,-118434,-120729
93.97968,3,54,54,0,0,126800,127300,380,11620,11620
93.97968,4,50,50,0,0,126800,127300,-1266,-12334,-12334
93.97968,5,580,580,0,0,126800,127300,856,-76756,-76756
93.97968,6,0,0,0,0,126800,127300,0,0,0
94.21086,0,151,221,-70,70,127300,127300,9462,80938,80938
94.21086,1,116,212,-96,96,127300,127300,8339,24861,24861
94.21086,2,880,871,9,-9,127300,127300,2862,-121562,-121562
94.21086,3,54,54,0,0,127300,127300,380,11620,11620
94.21086,4,50,50,0,0,127300,127300,-1266,-12334,-12334
94.21086,5,590,580,10,-10,127300,127300,1110,-75010,-75010
94.21086,6,0,0,0,0,127300,127300,0,0,0
94.490054,0,151,221,-70,70,127300,127300,9462,80938,80938
94.490054,1,116,212,-96,96,127300,127300,8339,24861,24861
94.490054,2,880,871,9,-9,127300,127300,2862,-121562,-121562
94.490054,3,54,54,0,0,127300,127300,380,11620,11620
94.490054,4,50,50,0,0,127300,127300,-1266,-12334,-12334
94.490054,5,590,580,10,-10,127300,127300,1110,-75010,-75010
94.490054,6,0,0,0,0,127300,127300,0,0,0
94.799123,0,151,221,-70,70,127300,127300,9462,80938,80938
94.799123,1,116,212,-96,96,127300,127300,8339,24861,24861
94.799123,2,880,871,9,-9,127300,127300,2862,-121562,-121562
94.799123,3,54,54,0,0,127300,127300,380,11620,11620
94.799123,4,50,50,0,0,127300,127300,-1266,-12334,-12334
94.799123,5,590,580,10,-10,127300,127300,1110,-75010,-75010
94.799123,6,0,0,0,0,127300,127300,0,0,0
94.998042,0,151,221,-70,70,127300,127300,9462,80938,80938
94.998042,1,116,212,-96,96,127300,127300,8339,24861,24861
94.998042,2,880,871,9,-9,127300,127300,2862,-121562,-121562
94.998042,3,54,54,0,0,127300,127300,380,11620,11620
94.998042,4,50,50,0,0,127300,127300,-1266,-12334,-12334
94.998042,5,590,580,10,-10,127300,127300,1110,-75010,-75010
94.998042,6,0,0,0,0,127300,127300,0,0,0
95.24683,0,151,221,-70,70,127300,127300,9462,80938,80938
95.24683,1,116,212,-96,96,127300,127300,8339,24861,24861
95.24683,2,880,871,9,-9,127300,127300,2862,-121562,-121562
95.24683,3,54,54,0,0,127300,127300,380,11620,11620
95.24683,4,50,50,0,0,127300,127300,-1266,-12334,-12334
95.24683,5,590,580,10,-10,127300,127300,1110,-75010,-75010
95.24683,6,0,0,0,0,127300,127300,0,0,0
95.525949,0,151,221,-70,70,127300,127300,9462,80938,80938
95.525949,1,116,212,-96,96,127300,127300,8339,24861,24861
95.525949,2,880,871,9,-9,127300,127300,2862,-121562,-121562
95.525949,3,54,54,0,0,127300,127300,380,11620,11620
95.525949,4,50,50,0,0,127300,127300,-1266,-12334,-12334
95.525949,5,590,580,10,-10,127300,127300,1110,-75010,-75010
95.525949,6,0,0,0,0,127300,127300,0,0,0
95.790853,0,151,221,-70,70,127300,127000,9462,80938,63158
95.790853,1,116,212,-96,96,127300,127000,8339,24861,477
95.790853,2,880,871,9,-9,127300,127000,2862,-121562,-119276
95.790853,3,54,54,0,0,127300,127000,380,11620,11620
95.790853,4,50,50,0,0,127300,127000,-1266,-12334,-12334
95.790853,5,590,580,10,-10,127300,127000,1110,-75010,-72470
95.790853,6,0,0,0,0,127300,127000,0,0,0
95.959327,0,151,221,-70,70,127300,127000,9462,80938,63158
95.959327,1,116,212,-96,96,127300,127000,8339,24861,477
95.959327,2,880,871,9,-9,127300,127000,2862,-121562,-119276
95.959327,3,54,54,0,0,127300,127000,380,11620,11620
95.959327,4,50,50,0,0,127300,127000,-1266,-12334,-12334
95.959327,5,590,580,10,-10,127300,127000,1110,-75010,-72470
95.959327,6,0,0,0,0,127300,127000,0,0,0
96.286385,0,151,221,-70,70,127300,126900,9462,80938,63158
96.286385,1,116,212,-96,96,127300,126900,8339,24861,477
96.286385,2,880,871,9,-9,127300,126900,2862,-121562,-119276
96.286385,3,54,54,0,0,127300,126900,380,11620,11620
96.286385,4,50,50,0,0,127300,126900,-1266,-12334,-12334
96.286385,5,590,580,10,-10,127300,126900,1110,-75010,-72470
96.286385,6,0,0,0,0,127300,126900,0,0,0
96.545773,0,151,221,-70,70,126900,126800,9462,80938,73938
96.545773,1,116,212,-96,96,126900,126800,8339,24861,15261
96.545773,2,888,871,17,-17,126900,126800,2760,-122260,-120560
96.545773,3,54,54,0,0,126900,126800,380,11620,11620
96.545773,4,50,50,0,0,126900,126800,-1266,-12334,-12334
96.545773,5,600,580,20,-20,126900,126800,983,-75883,-73883
96.545773,6,0,0,0,0,126900,126800,0,0,0
96.780618,0,151,221,-70,70,126800,126800,9462,80938,80938
96.780618,1,116,212,-96,96,126800,126800,8339,24861,24861
96.780618,2,898,871,27,-27,126800,126800,2633,-121133,-121133
96.780618,3,54,54,0,0,126800,126800,380,11620,11620
96.780618,4,50,50,0,0,126800,126800,-1266,-12334,-12334
96.780618,5,610,580,30,-30,126800,126800,856,-74756,-74756
96.780618,6,0,0,0,0,126800,126800,0,0,0
96.992545,0,181,221,-40,40,126800,126800,10223,88177,88177
96.992545,1,116,212,-96,96,126800,126800,8339,24861,24861
96.992545,2,908,881,27,-27,126800,126800,2760,-123260,-123260
96.992545,3,54,54,0,0,126800,126800,380,11620,11620
96.992545,4,50,50,0,0,126800,126800,-1266,-12334,-12334
96.992545,5,610,590,20,-20,126800,126800,729,-78629,-78629
96.992545,6,0,0,0,0,126800,126800,0,0,0
97.253418,0,201,221,-20,20,126800,127000,10730,91670,95670
97.253418,1,116,212,-96,96,126800,127000,8339,24861,44061
97.253418,2,908,881,27,-27,126800,127000,2760,-123260,-128660
97.253418,3,54,54,0,0,126800,127000,380,11620,11620
97.253418,4,50,50,0,0,126800,127000,-1266,-12334,-12334
97.253418,5,610,590,20,-20,126800,127000,729,-78629,-82629
97.253418,6,0,0,0,0,126800,127000,0,0,0
97.49244,0,201,221,-20,20,126600,127000,10730,91670,96750
97.49244,1,116,212,-96,96,126600,127000,8339,24861,49245
97.49244,2,908,891,17,-17,126600,127000,3014,-125314,-129632
97.49244,3,56,54,2,-2,126600,127000,355,11645,11137
97.49244,4,50,50,0,0,126600,127000,-1266,-12334,-12334
97.49244,5,618,590,28,-28,126600,127000,628,-77728,-84840
97.49244,6,0,0,0,0,126600,127000,0,0,0
97.718803,0,201,221,-20,20,126600,127000,10730,91670,96750
97.718803,1,116,212,-96,96,126600,127000,8339,24861,49245
97.718803,2,908,891,17,-17,126600,127000,3014,-125314,-129632
97.718803,3,56,56,0,0,126600,127000,406,11194,11194
97.718803,4,50,50,0,0,126600,127000,-1266,-12334,-12334
97.718803,5,620,590,30,-30,126600,127000,603,-77503,-85123
97.718803,6,0,0,0,0,126600,127000,0,0,0
97.964174,0,201,221,-20,20,126500,127000,10730,91670,96750
97.964174,1,116,212,-96,96,126500,127000,8339,24861,49245
97.964174,2,918,891,27,-27,126500,127000,2887,-125187,-132045
97.964174,3,56,56,0,0,126500,127000,406,11194,11194
97.964174,4,50,50,0,0,126500,127000,-1266,-12334,-12334
97.964174,5,630,590,40,-40,126500,127000,477,-76377,-86537
97.964174,6,0,0,0,0,126500,127000,0,0,0
98.255034,0,201,221,-20,20,126500,127000,10730,91670,96750
98.255034,1,116,212,-96,96,126500,127000,8339,24861,49245
98.255034,2,918,891,27,-27,126500,127000,2887,-125187,-132045
98.255034,3,56,56,0,0,126500,127000,406,11194,11194
98.255034,4,50,50,0,0,126500,127000,-1266,-12334,-12334
98.255034,5,630,590,40,-40,126500,127000,477,-76377,-86537
98.255034,6,0,0,0,0,126500,127000,0,0,0
98.477791,0,201,221,-20,20,126500,127000,10730,91670,96750
98.477791,1,116,212,-96,96,126500,127000,8339,24861,49245
98.477791,2,918,901,17,-17,126500,127000,2761,-127061,-131379
98.477791,3,56,56,0,0,126500,127000,406,11194,11194
98.477791,4,50,50,0,0,126500,127000,-1266,-12334,-12334
98.477791,5,630,590,40,-40,126500,127000,477,-76377,-86537
98.477791,6,0,0,0,0,126500,127000,0,0,0
98.754534,0,201,221,-20,20,126300,127000,10730,91670,96750
98.754534,1,116,212,-96,96,126300,127000,8339,24861,49245
98.754534,2,928,911,17,-17,126300,127000,2889,-126189,-130507
98.754534,3,58,56,2,-2,126300,127000,381,11619,11111
98.754534,4,50,50,0,0,126300,127000,-1266,-12334,-12334
98.754534,5,640,590,50,-50,126300,127000,351,-74251,-86951
98.754534,6,0,0,0,0,126300,127000,0,0,0
99.012892,0,231,221,10,-10,126300,127000,11488,96912,94372
99.012892,1,118,212,-94,94,126300,127000,8390,25210,49086
99.012892,2,938,911,27,-27,126300,127000,3142,-124442,-131300
99.012892,3,58,58,0,0,126300,127000,431,10569,10569
99.012892,4,50,50,0,0,126300,127000,-1266,-12334,-12334
99.012892,5,642,590,52,-52,126300,127000,326,-73426,-86634
99.012892,6,0,0,0,0,126300,127000,0,0,0
99.299839,0,231,221,10,-10,126400,127000,11488,96912,94372
99.299839,1,118,212,-94,94,126400,127000,8390,25210,49086
99.299839,2,938,919,19,-19,126400,127000,3041,-125141,-129967
99.299839,3,58,58,0,0,126400,127000,431,10569,10569
99.299839,4,50,50,0,0,126400,127000,-1266,-12334,-12334
99.299839,5,642,590,52,-52,126400,127000,326,-73426,-86634
99.299839,6,0,0,0,0,126400,127000,0,0,0
99.53612,0,231,221,10,-10,126400,127000,11488,96912,94372
99.53612,1,118,212,-94,94,126400,127000,8390,25210,49086
99.53612,2,938,919,19,-19,126400,127000,3041,-125141,-129967
99.53612,3,58,58,0,0,126400,127000,431,10569,10569
99.53612,4,50,50,0,0,126400,127000,-1266,-12334,-12334
99.53612,5,642,590,52,-52,126400,127000,326,-73426,-86634
99.53612,6,0,0,0,0,126400,127000,0,0,0
99.702869,0,231,221,10,-10,126400,127000,11488,96912,94372
99.702869,1,118,212,-94,94,126400,127000,8390,25210,49086
99.702869,2,938,919,19,-19,126400,127000,3041,-125141,-129967
99.702869,3,58,58,0,0,126400,127000,431,10569,10569
99.702869,4,50,50,0,0,126400,127000,-1266,-12334,-12334
99.702869,5,642,590,52,-52,126400,127000,326,-73426,-86634
99.702869,6,0,0,0,0,126400,127000,0,0,0
99.996675,0,231,221,10,-10,126400,127000,11488,96912,94372
99.996675,1,118,212,-94,94,126400,127000,8390,25210,49086
99.996675,2,938,919,19,-19,126400,127000,3041,-125141,-129967
99.996675,3,58,58,0,0,126400,127000,431,10569,10569
99.996675,4,50,50,0,0,126400,127000,-1266,-12334,-12334
99.996675,5,642,590,52,-52,126400,127000,326,-73426,-86634
99.996675,6,0,0,0,0,126400,127000,0,0,0
100.248298,0,231,221,10,-10,126400,127000,11488,96912,94372
100.248298,1,118,212,-94,94,126400,127000,8390,25210,49086
100.248298,2,938,919,19,-19,126400,127000,3041,-125141,-129967
100.248298,3,58,58,0,0,126400,127000,431,10569,10569
100.248298,4,50,50,0,0,126400,127000,-1266,-12334,-12334
100.248298,5,642,590,52,-52,126400,127000,326,-73426,-86634
100.248298,6,0,0,0,0,126400,127000,0,0,0
100.473638,0,231,221,10,-10,126400,126700,11488,96912,94382
100.473638,1,118,212,-94,94,126400,126700,8390,25210,48992
100.473638,2,948,919,29,-29,126400,126700,2915,-124015,-131352
100.473638,3,58,58,0,0,126400,126700,431,10569,10569
100.473638,4,50,50,0,0,126400,126700,-1266,-12334,-12334
100.473638,5,642,600,42,-42,126400,126700,579,-75679,-86305
100.473638,6,0,0,0,0,126400,126700,0,0,0
100.800048,0,241,221,20,-20,126600,126700,11741,99659,97659
100.800048,1,118,212,-94,94,126600,126700,8390,25210,34610
100.800048,2,958,929,29,-29,126600,126700,3042,-126142,-129042
100.800048,3,58,58,0,0,126600,126700,431,10569,10569
100.800048,4,50,50,0,0,126600,126700,-1266,-12334,-12334
100.800048,5,642,610,32,-32,126600,126700,452,-78552,-81752
100.800048,6,0,0,0,0,126600,126700,0,0,0
100.995432,0,241,221,20,-20,126700,126700,11741,99659,99659
100.995432,1,138,212,-74,74,126700,126700,8896,26704,26704
100.995432,2,958,939,19,-19,126700,126700,2915,-128015,-128015
100.995432,3,58,58,0,0,126700,126700,431,10569,10569
100.995432,4,50,50,0,0,126700,126700,-1266,-12334,-12334
100.995432,5,642,620,22,-22,126700,126700,325,-80425,-80425
100.995432,6,0,0,0,0,126700,126700,0,0,0
101.214086,0,241,221,20,-20,127300,126700,11741,99659,104719
101.214086,1,138,212,-74,74,127300,126700,8896,26704,7982
101.214086,2,958,949,9,-9,127300,126700,2788,-128888,-126611
101.214086,3,58,60,-2,2,127300,126700,406,11194,10688
101.214086,4,50,50,0,0,127300,126700,-1266,-12334,-12334
101.214086,5,642,630,12,-12,127300,126700,198,-81298,-78262
101.214086,6,0,0,0,0,127300,126700,0,0,0
101.533574,0,241,221,20,-20,127300,126700,11741,99659,104719
101.533574,1,138,212,-74,74,127300,126700,8896,26704,7982
101.533574,2,958,949,9,-9,127300,126700,2788,-128888,-126611
101.533574,3,58,60,-2,2,127300,126700,406,11194,10688
101.533574,4,50,50,0,0,127300,126700,-1266,-12334,-12334
101.533574,5,642,630,12,-12,127300,126700,198,-81298,-78262
101.533574,6,0,0,0,0,127300,126700,0,0,0
101.744205,0,241,221,20,-20,127300,126700,11741,99659,104719
101.744205,1,138,212,-74,74,127300,126700,8896,26704,7982
101.744205,2,958,949,9,-9,127300,126700,2788,-128888,-126611
101.744205,3,58,60,-2,2,127300,126700,406,11194,10688
101.744205,4,50,50,0,0,127300,126700,-1266,-12334,-12334
101.744205,5,642,630,12,-12,127300,126700,198,-81298,-78262
101.744205,6,0,0,0,0,127300,126700,0,0,0
102.014425,0,241,221,20,-20,127000,126700,11741,99659,104719
102.014425,1,138,212,-74,74,127000,126700,8896,26704,7982
102.014425,2,968,959,9,-9,127000,126700,2534,-128634,-126357
102.014425,3,58,60,-2,2,127000,126700,406,11194,10688
102.014425,4,50,50,0,0,127000,126700,-1266,-12334,-12334
102.014425,5,642,640,2,-2,127000,126700,452,-83552,-83046
102.014425,6,0,0,0,0,127000,126700,0,0,0
102.270362,0,241,221,20,-20,127100,126700,11741,99659,104719
102.270362,1,138,232,-94,94,127100,126700,9404,28196,4414
102.270362,2,968,969,-1,1,127100,126700,2788,-127888,-128141
102.270362,3,58,60,-2,2,127100,126700,406,11194,10688
102.270362,4,50,50,0,0,127100,126700,-1266,-12334,-12334
102.270362,5,642,650,-8,8,127100,126700,706,-82806,-84830
102.270362,6,0,0,0,0,127100,126700,0,0,0
102.495585,0,241,221,20,-20,127100,126700,11741,99659,104719
102.495585,1,138,232,-94,94,127100,126700,9404,28196,4414
102.495585,2,968,979,-11,11,127100,126700,3042,-127142,-129925
102.495585,3,58,60,-2,2,127100,126700,406,11194,10688
102.495585,4,50,50,0,0,127100,126700,-1266,-12334,-12334
102.495585,5,642,650,-8,8,127100,126700,706,-82806,-84830
102.495585,6,0,0,0,0,127100,126700,0,0,0
102.770319,0,241,251,-10,10,127000,126700,12504,110496,107966
102.770319,1,138,232,-94,94,127000,126700,9404,28196,4414
102.770319,2,968,989,-21,21,127000,126700,3296,-124396,-129709
102.770319,3,58,62,-4,4,127000,126700,457,11743,10731
102.770319,4,50,50,0,0,127000,126700,-1266,-12334,-12334
102.770319,5,652,650,2,-2,127000,126700,579,-87679,-87173
102.770319,6,0,0,0,0,127000,126700,0,0,0
103.004396,0,241,281,-40,40,127000,126700,13266,115734,105614
103.004396,1,138,232,-94,94,127000,126700,9404,28196,4414
103.004396,2,968,999,-31,31,127000,126700,3550,-122650,-130493
103.004396,3,58,64,-6,6,127000,126700,508,12092,10574
103.004396,4,50,50,0,0,127000,126700,-1266,-12334,-12334
103.004396,5,652,650,2,-2,127000,126700,579,-87679,-87173
103.004396,6,0,0,0,0,127000,126700,0,0,0
103.268272,0,241,311,-70,70,127100,126700,14028,120972,103262
103.268272,1,138,232,-94,94,127100,126700,9404,28196,4414
103.268272,2,972,999,-27,27,127100,126700,3500,-124200,-131031
103.268272,3,58,68,-10,10,127100,126700,610,13190,10660
103.268272,4,50,50,0,0,127100,126700,-1266,-12334,-12334
103.268272,5,652,650,2,-2,127100,126700,579,-87679,-87173
103.268272,6,0,0,0,0,127100,126700,0,0,0
103.51275,0,241,341,-100,100,127100,126700,14791,126809,101509
103.51275,1,138,232,-94,94,127100,126700,9404,28196,4414
103.51275,2,978,1009,-31,31,127100,126700,3297,-124397,-132240
103.51275,3,58,70,-12,12,127100,126700,585,13615,10579
103.51275,4,50,50,0,0,127100,126700,-1266,-12334,-12334
103.51275,5,652,650,2,-2,127100,126700,579,-87679,-87173
103.51275,6,0,0,0,0,127100,126700,0,0,0
103.793947,0,241,341,-100,100,126400,126700,14791,126809,152109
103.793947,1,138,232,-94,94,126400,126700,9404,28196,51978
103.793947,2,988,1009,-21,21,126400,126700,3170,-127270,-121957
103.793947,3,60,74,-14,14,126400,126700,662,15538,19080
103.793947,4,50,50,0,0,126400,126700,-1266,-12334,-12334
103.793947,5,662,650,12,-12,126400,126700,452,-87552,-90588
103.793947,6,0,0,0,0,126400,126700,0,0,0
104.041841,0,241,341,-100,100,126400,126700,14791,126809,152109
104.041841,1,138,232,-94,94,126400,126700,9404,28196,51978
104.041841,2,988,1009,-21,21,126400,126700,3170,-127270,-121957
104.041841,3,60,74,-14,14,126400,126700,662,15538,19080
104.041841,4,50,50,0,0,126400,126700,-1266,-12334,-12334
104.041841,5,662,650,12,-12,126400,126700,452,-87552,-90588
104.041841,6,0,0,0,0,126400,126700,0,0,0
104.211651,0,241,341,-100,100,126400,126700,14791,126809,152109
104.211651,1,138,232,-94,94,126400,126700,9404,28196,51978
104.211651,2,988,1009,-21,21,126400,126700,3170,-127270,-121957
104.211651,3,60,74,-14,14,126400,126700,662,15538,19080
104.211651,4,50,50,0,0,126400,126700,-1266,-12334,-12334
104.211651,5,662,650,12,-12,126400,126700,452,-87552,-90588
104.211651,6,0,0,0,0,126400,126700,0,0,0
104.533489,0,241,341,-100,100,127000,126700,14791,126809,101509
104.533489,1,138,232,-94,94,127000,126700,9404,28196,4414
104.533489,2,998,1009,-11,11,127000,126700,3043,-131143,-133926
104.533489,3,60,74,-14,14,127000,126700,662,15538,11996
104.533489,4,50,50,0,0,127000,126700,-1266,-12334,-12334
104.533489,5,662,650,12,-12,127000,126700,452,-87552,-84516
104.533489,6,0,0,0,0,127000,126700,0,0,0
104.768397,0,241,341,-100,100,127000,126900,14791,126809,116809
104.768397,1,138,232,-94,94,127000,126900,9404,28196,18796
104.768397,2,998,1009,-11,11,127000,126900,3043,-131143,-132243
104.768397,3,60,74,-14,14,127000,126900,662,15538,14138
104.768397,4,50,50,0,0,127000,126900,-1266,-12334,-12334
104.768397,5,662,650,12,-12,127000,126900,452,-87552,-86352
104.768397,6,0,0,0,0,127000,126900,0,0,0
105.048804,0,241,341,-100,100,127000,126900,14791,126809,116809
105.048804,1,138,232,-94,94,127000,126900,9404,28196,18796
105.048804,2,998,1009,-11,11,127000,126900,3043,-131143,-132243
105.048804,3,60,74,-14,14,127000,126900,662,15538,14138
105.048804,4,50,50,0,0,127000,126900,-1266,-12334,-12334
105.048804,5,662,650,12,-12,127000,126900,452,-87552,-86352
105.048804,6,0,0,0,0,127000,126900,0,0,0
105.293595,0,241,341,-100,100,127000,126900,14791,126809,116809
105.293595,1,138,232,-94,94,127000,126900,9404,28196,18796
105.293595,2,998,1009,-11,11,127000,126900,3043,-131143,-132243
105.293595,3,60,74,-14,14,127000,126900,662,15538,14138
105.293595,4,50,50,0,0,127000,126900,-1266,-12334,-12334
105.293595,5,662,650,12,-12,127000,126900,452,-87552,-86352
105.293595,6,0,0,0,0,127000,126900,0,0,0
105.490529,0,241,341,-100,100,127000,126900,14791,126809,116809
105.490529,1,138,232,-94,94,127000,126900,9404,28196,18796
105.490529,2,998,1009,-11,11,127000,126900,3043,-131143,-132243
105.490529,3,60,74,-14,14,127000,126900,662,15538,14138
105.490529,4,50,50,0,0,127000,126900,-1266,-12334,-12334
105.490529,5,662,650,12,-12,127000,126900,452,-87552,-86352
105.490529,6,0,0,0,0,127000,126900,0,0,0
105.777713,0,241,341,-100,100,127000,126800,14791,126809,106809
105.777713,1,138,232,-94,94,127000,126800,9404,28196,9396
105.777713,2,1008,1009,-1,1,127000,126800,2916,-133016,-133216
105.777713,3,60,74,-14,14,127000,126800,662,15538,12738
105.777713,4,50,50,0,0,127000,126800,-1266,-12334,-12334
105.777713,5,662,660,2,-2,127000,126800,706,-86806,-86406
105.777713,6,0,0,0,0,127000,126800,0,0,0
105.955699,0,241,341,-100,100,127000,126800,14791,126809,106809
105.955699,1,138,232,-94,94,127000,126800,9404,28196,9396
105.955699,2,1008,1009,-1,1,127000,126800,2916,-133016,-133216
105.955699,3,60,74,-14,14,127000,126800,662,15538,12738
105.955699,4,50,50,0,0,127000,126800,-1266,-12334,-12334
105.955699,5,662,660,2,-2,127000,126800,706,-86806,-86406
105.955699,6,0,0,0,0,127000,126800,0,0,0
106.27353,0,241,341,-100,100,127200,126800,14791,126809,101409
106.27353,1,138,232,-94,94,127200,126800,9404,28196,4320
106.27353,2,1008,1019,-11,11,127200,126800,2789,-130889,-133683
106.27353,3,60,76,-16,16,127200,126800,637,16363,12299
106.27353,4,50,50,0,0,127200,126800,-1266,-12334,-12334
106.27353,5,662,670,-8,8,127200,126800,579,-84679,-86711
106.27353,6,0,0,0,0,127200,126800,0,0,0
106.540071,0,241,341,-100,100,127200,126800,14791,126809,101409
106.540071,1,138,232,-94,94,127200,126800,9404,28196,4320
106.540071,2,1008,1029,-21,21,127200,126800,3043,-127143,-132477
106.540071,3,60,78,-18,18,127200,126800,688,17112,12540
106.540071,4,50,50,0,0,127200,126800,-1266,-12334,-12334
106.540071,5,662,670,-8,8,127200,126800,579,-84679,-86711
106.540071,6,0,0,0,0,127200,126800,0,0,0
106.767286,0,241,341,-100,100,127200,126800,14791,126809,101409
106.767286,1,138,232,-94,94,127200,126800,9404,28196,4320
106.767286,2,1008,1039,-31,31,127200,126800,3297,-123397,-131271
106.767286,3,60,80,-20,20,127200,126800,739,17861,12781
106.767286,4,50,50,0,0,127200,126800,-1266,-12334,-12334
106.767286,5,662,670,-8,8,127200,126800,579,-84679,-86711
106.767286,6,0,0,0,0,127200,126800,0,0,0
107.045728,0,241,341,-100,100,127100,126800,14791,126809,101409
107.045728,1,138,232,-94,94,127100,126800,9404,28196,4320
107.045728,2,1018,1039,-21,21,127100,126800,3551,-127651,-132985
107.045728,3,60,82,-22,22,127100,126800,714,18486,12898
107.045728,4,50,50,0,0,127100,126800,-1266,-12334,-12334
107.045728,5,662,670,-8,8,127100,126800,579,-84679,-86711
107.045728,6,0,0,0,0,127100,126800,0,0,0
107.214124,0,241,341,-100,100,127100,126800,14791,126809,101409
107.214124,1,138,232,-94,94,127100,126800,9404,28196,4320
107.214124,2,1018,1039,-21,21,127100,126800,3551,-127651,-132985
107.214124,3,60,82,-22,22,127100,126800,714,18486,12898
107.214124,4,50,50,0,0,127100,126800,-1266,-12334,-12334
107.214124,5,662,670,-8,8,127100,126800,579,-84679,-86711
107.214124,6,0,0,0,0,127100,126800,0,0,0
107.458009,0,241,341,-100,100,127400,126800,14791,126809,101409
107.458009,1,138,232,-94,94,127400,126800,9404,28196,4320
107.458009,2,1018,1049,-31,31,127400,126800,3424,-124524,-132398
107.458009,3,60,84,-24,24,127400,126800,689,19111,13015
107.458009,4,50,50,0,0,127400,126800,-1266,-12334,-12334
107.458009,5,662,670,-8,8,127400,126800,579,-84679,-86711
107.458009,6,0,0,0,0,127400,126800,0,0,0
107.727461,0,241,341,-100,100,127100,126800,14791,126809,101409
107.727461,1,138,232,-94,94,127100,126800,9404,28196,4320
107.727461,2,1020,1049,-29,29,127100,126800,3399,-125299,-132665
107.727461,3,60,86,-26,26,127100,126800,740,19660,13056
107.727461,4,50,50,0,0,127100,126800,-1266,-12334,-12334
107.727461,5,662,670,-8,8,127100,126800,579,-84679,-86711
107.727461,6,0,0,0,0,127100,126800,0,0,0
108.039735,0,241,341,-100,100,127400,126800,14791,126809,101409
108.039735,1,138,232,-94,94,127400,126800,9404,28196,4320
108.039735,2,1030,1059,-29,19,127400,126800,3145,1141955,-133411
108.039735,3,60,88,-28,26,127400,126800,715,273685,12973
108.039735,4,50,50,0,0,127400,126800,-1266,-12334,-12334
108.039735,5,672,680,-8,8,127400,126800,706,-81806,-83838
108.039735,6,0,0,0,0,127400,126800,0,0,0
108.215136,0,241,341,-100,100,127400,126500,14791,126809,101509
108.215136,1,138,232,-94,94,127400,126500,9404,28196,4414
108.215136,2,1030,1059,-29,29,127400,126500,3145,-126045,-133382
108.215136,3,60,88,-28,28,127400,126500,715,20085,13001
108.215136,4,50,50,0,0,127400,126500,-1266,-12334,-12334
108.215136,5,672,680,-8,8,127400,126500,706,-81806,-83830
108.215136,6,0,0,0,0,127400,126500,0,0,0
108.528876,0,241,341,-100,100,126900,126500,14791,126809,101509
108.528876,1,138,232,-94,94,126900,126500,9404,28196,4414
108.528876,2,1032,1059,-27,27,126900,126500,3120,-127020,-133851
108.528876,3,60,90,-30,30,126900,126500,766,20634,13044
108.528876,4,50,50,0,0,126900,126500,-1266,-12334,-12334
108.528876,5,672,680,-8,8,126900,126500,706,-81806,-83830
108.528876,6,0,0,0,0,126900,126500,0,0,0
108.715694,0,241,341,-100,100,126400,126500,14791,126809,136809
108.715694,1,138,232,-94,94,126400,126500,9404,28196,37596
108.715694,2,1042,1059,-17,17,126400,126500,2993,-131893,-130193
108.715694,3,60,90,-30,30,126400,126500,766,20634,23634
108.715694,4,50,50,0,0,126400,126500,-1266,-12334,-12334
108.715694,5,682,680,2,-2,126400,126500,579,-85679,-85879
108.715694,6,0,0,0,0,126400,126500,0,0,0
109.008829,0,241,341,-100,100,126400,126500,14791,126809,136809
109.008829,1,138,232,-94,94,126400,126500,9404,28196,37596
109.008829,2,1042,1059,-17,17,126400,126500,2993,-131893,-130193
109.008829,3,60,90,-30,30,126400,126500,766,20634,23634
109.008829,4,50,50,0,0,126400,126500,-1266,-12334,-12334
109.008829,5,682,680,2,-2,126400,126500,579,-85679,-85879
109.008829,6,0,0,0,0,126400,126500,0,0,0
109.28059,0,241,341,-100,100,126400,126100,14791,126809,101609
109.28059,1,138,232,-94,94,126400,126100,9404,28196,4508
109.28059,2,1042,1059,-17,17,126400,126100,2993,-131893,-136177
109.28059,3,60,90,-30,30,126400,126100,766,20634,13074
109.28059,4,50,50,0,0,126400,126100,-1266,-12334,-12334
109.28059,5,682,680,2,-2,126400,126100,579,-85679,-85175
109.28059,6,0,0,0,0,126400,126100,0,0,0
109.529154,0,241,341,-100,100,126400,126200,14791,126809,106809
109.529154,1,138,232,-94,94,126400,126200,9404,28196,9396
109.529154,2,1042,1059,-17,17,126400,126200,2993,-131893,-135293
109.529154,3,60,90,-30,30,126400,126200,766,20634,14634
109.529154,4,50,50,0,0,126400,126200,-1266,-12334,-12334
109.529154,5,682,680,2,-2,126400,126200,579,-85679,-85279
109.529154,6,0,0,0,0,126400,126200,0,0,0
109.799059,0,241,341,-100,100,126400,126200,14791,126809,106809
109.799059,1,138,232,-94,94,126400,126200,9404,28196,9396
109.799059,2,1042,1060,-18,18,126400,126200,3018,-131718,-135318
109.799059,3,60,90,-30,30,126400,126200,766,20634,14634
109.799059,4,50,50,0,0,126400,126200,-1266,-12334,-12334
109.799059,5,682,680,2,-2,126400,126200,579,-85679,-85279
109.799059,6,0,0,0,0,126400,126200,0,0,0
110.02056,0,241,341,-100,100,126400,126200,14791,126809,106809
110.02056,1,138,232,-94,94,126400,126200,9404,28196,9396
110.02056,2,1042,1060,-18,18,126400,126200,3018,-131718,-135318
110.02056,3,60,90,-30,30,126400,126200,766,20634,14634
110.02056,4,50,50,0,0,126400,126200,-1266,-12334,-12334
110.02056,5,682,680,2,-2,126400,126200,579,-85679,-85279
110.02056,6,0,0,0,0,126400,126200,0,0,0
110.228415,0,241,341,-100,100,126300,126100,14791,126809,106809
110.228415,1,138,232,-94,94,126300,126100,9404,28196,9396
110.228415,2,1052,1060,-8,8,126300,126100,2892,-133592,-135192
110.228415,3,60,90,-30,30,126300,126100,766,20634,14634
110.228415,4,50,50,0,0,126300,126100,-1266,-12334,-12334
110.228415,5,682,680,2,-2,126300,126100,579,-85679,-85279
110.228415,6,0,0,0,0,126300,126100,0,0,0
110.469293,0,241,341,-100,100,126300,126100,14791,126809,106809
110.469293,1,138,232,-94,94,126300,126100,9404,28196,9396
110.469293,2,1052,1060,-8,8,126300,126100,2892,-133592,-135192
110.469293,3,60,90,-30,30,126300,126100,766,20634,14634
110.469293,4,50,50,0,0,126300,126100,-1266,-12334,-12334
110.469293,5,682,680,2,-2,126300,126100,579,-85679,-85279
110.469293,6,0,0,0,0,126300,126100,0,0,0
110.752165,0,241,341,-100,100,126300,125900,14791,126809,101609
110.752165,1,138,232,-94,94,126300,125900,9404,28196,4508
110.752165,2,1052,1060,-8,8,126300,125900,2892,-133592,-135608
110.752165,3,60,90,-30,30,126300,125900,766,20634,13074
110.752165,4,50,50,0,0,126300,125900,-1266,-12334,-12334
110.752165,5,682,680,2,-2,126300,125900,579,-85679,-85175
110.752165,6,0,0,0,0,126300,125900,0,0,0
111.031594,0,241,341,-100,100,126300,125900,14791,126809,101609
111.031594,1,138,232,-94,94,126300,125900,9404,28196,4508
111.031594,2,1052,1060,-8,8,126300,125900,2892,-133592,-135608
111.031594,3,60,90,-30,30,126300,125900,766,20634,13074
111.031594,4,50,50,0,0,126300,125900,-1266,-12334,-12334
111.031594,5,682,680,2,-2,126300,125900,579,-85679,-85175
111.031594,6,0,0,0,0,126300,125900,0,0,0
111.201544,0,241,341,-100,100,126300,125900,14791,126809,101609
111.201544,1,138,232,-94,94,126300,125900,9404,28196,4508
111.201544,2,1052,1060,-8,8,126300,125900,2892,-133592,-135608
111.201544,3,60,90,-30,30,126300,125900,766,20634,13074
111.201544,4,50,50,0,0,126300,125900,-1266,-12334,-12334
111.201544,5,682,680,2,-2,126300,125900,579,-85679,-85175
111.201544,6,0,0,0,0,126300,125900,0,0,0
111.462145,0,241,341,-100,100,126300,125900,14791,126809,101609
111.462145,1,138,232,-94,94,126300,125900,9404,28196,4508
111.462145,2,1052,1060,-8,8,126300,125900,2892,-133592,-135608
111.462145,3,60,90,-30,30,126300,125900,766,20634,13074
111.462145,4,50,50,0,0,126300,125900,-1266,-12334,-12334
111.462145,5,682,680,2,-2,126300,125900,579,-85679,-85175
111.462145,6,0,0,0,0,126300,125900,0,0,0
111.709971,0,241,341,-100,100,126300,125900,14791,126809,101609
111.709971,1,138,232,-94,94,126300,125900,9404,28196,4508
111.709971,2,1052,1060,-8,8,126300,125900,2892,-133592,-135608
111.709971,3,60,90,-30,30,126300,125900,766,20634,13074
111.709971,4,50,50,0,0,126300,125900,-1266,-12334,-12334
111.709971,5,682,680,2,-2,126300,125900,579,-85679,-85175
111.709971,6,0,0,0,0,126300,125900,0,0,0
111.986947,0,241,341,-100,100,126300,126300,14791,126809,126809
111.986947,1,138,232,-94,94,126300,126300,9404,28196,28196
111.986947,2,1062,1060,2,-2,126300,126300,3145,-134845,-134845
111.986947,3,60,90,-30,30,126300,126300,766,20634,20634
111.986947,4,50,50,0,0,126300,126300,-1266,-12334,-12334
111.986947,5,682,685,-3,3,126300,126300,516,-86116,-86116
111.986947,6,0,0,0,0,126300,126300,0,0,0
112.285841,0,241,341,-100,100,126800,126300,14791,126809,101509
112.285841,1,138,232,-94,94,126800,126300,9404,28196,4414
112.285841,2,1062,1070,-8,8,126800,126300,3019,-134719,-136743
112.285841,3,60,92,-32,32,126800,126300,741,21259,13163
112.285841,4,50,50,0,0,126800,126300,-1266,-12334,-12334
112.285841,5,682,695,-13,13,126800,126300,389,-83989,-87278
112.285841,6,0,0,0,0,126800,126300,0,0,0
112.474837,0,241,341,-100,100,126500,126300,14791,126809,106809
112.474837,1,138,232,-94,94,126500,126300,9404,28196,9396
112.474837,2,1062,1080,-18,18,126500,126300,2893,-133593,-137193
112.474837,3,63,92,-29,29,126500,126300,817,20583,14783
112.474837,4,50,50,0,0,126500,126300,-1266,-12334,-12334
112.474837,5,692,698,-6,6,126500,126300,604,-85904,-87104
112.474837,6,0,0,0,0,126500,126300,0,0,0
112.725892,0,241,341,-100,100,126900,126300,14791,126809,101509
112.725892,1,138,232,-94,94,126900,126300,9404,28196,4414
112.725892,2,1062,1090,-28,28,126900,126300,2766,-130466,-137550
112.725892,3,63,94,-31,31,126900,126300,792,21408,13565
112.725892,4,50,50,0,0,126900,126300,-1266,-12334,-12334
112.725892,5,692,705,-13,13,126900,126300,515,-84415,-87704
112.725892,6,0,0,0,0,126900,126300,0,0,0
113.023514,0,241,341,-100,100,126900,126300,14791,126809,101509
113.023514,1,138,232,-94,94,126900,126300,9404,28196,4414
113.023514,2,1062,1090,-28,28,126900,126300,2766,-130466,-137550
113.023514,3,63,94,-31,31,126900,126300,792,21408,13565
113.023514,4,50,50,0,0,126900,126300,-1266,-12334,-12334
113.023514,5,692,705,-13,13,126900,126300,515,-84415,-87704
113.023514,6,0,0,0,0,126900,126300,0,0,0
113.20255,0,241,341,-100,100,126900,126300,14791,126809,101509
113.20255,1,138,232,-94,94,126900,126300,9404,28196,4414
113.20255,2,1062,1090,-28,28,126900,126300,2766,-130466,-137550
113.20255,3,63,94,-31,31,126900,126300,792,21408,13565
113.20255,4,50,50,0,0,126900,126300,-1266,-12334,-12334
113.20255,5,692,705,-13,13,126900,126300,515,-84415,-87704
113.20255,6,0,0,0,0,126900,126300,0,0,0
113.535991,0,241,341,-100,100,126900,126100,14791,126809,101609
113.535991,1,138,232,-94,94,126900,126100,9404,28196,4508
113.535991,2,1062,1090,-28,28,126900,126100,2766,-130466,-137522
113.535991,3,63,94,-31,31,126900,126100,792,21408,13596
113.535991,4,50,50,0,0,126900,126100,-1266,-12334,-12334
113.535991,5,692,705,-13,13,126900,126100,515,-84415,-87691
113.535991,6,0,0,0,0,126900,126100,0,0,0
113.78876,0,241,341,-100,100,126500,126000,14791,126809,101609
113.78876,1,138,232,-94,94,126500,126000,9404,28196,4508
113.78876,2,1064,1090,-26,26,126500,126000,2741,-131441,-137993
113.78876,3,63,96,-33,33,126500,126000,843,22157,13841
113.78876,4,50,50,0,0,126500,126000,-1266,-12334,-12334
113.78876,5,692,705,-13,13,126500,126000,515,-84415,-87691
113.78876,6,0,0,0,0,126500,126000,0,0,0
114.036952,0,241,341,-100,100,126300,125900,14791,126809,101609
114.036952,1,138,232,-94,94,126300,125900,9404,28196,4508
114.036952,2,1064,1100,-36,36,126300,125900,2994,-128694,-137766
114.036952,3,63,97,-34,34,126300,125900,868,22432,13864
114.036952,4,50,50,0,0,126300,125900,-1266,-12334,-12334
114.036952,5,692,705,-13,13,126300,125900,515,-84415,-87691
114.036952,6,0,0,0,0,126300,125900,0,0,0
114.281819,0,241,341,-100,100,126300,125900,14791,126809,101609
114.281819,1,138,232,-94,94,126300,125900,9404,28196,4508
114.281819,2,1065,1100,-35,35,126300,125900,3019,-129119,-137939
114.281819,3,63,98,-35,35,126300,125900,855,22745,13925
114.281819,4,50,50,0,0,126300,125900,-1266,-12334,-12334
114.281819,5,692,705,-13,13,126300,125900,515,-84415,-87691
114.281819,6,0,0,0,0,126300,125900,0,0,0
114.516843,0,241,341,-100,100,126300,125900,14791,126809,101609
114.516843,1,138,232,-94,94,126300,125900,9404,28196,4508
114.516843,2,1067,1100,-33,33,126300,125900,2994,-129894,-138210
114.516843,3,63,100,-37,37,126300,125900,906,23094,13770
114.516843,4,50,50,0,0,126300,125900,-1266,-12334,-12334
114.516843,5,692,705,-13,13,126300,125900,515,-84415,-87691
114.516843,6,0,0,0,0,126300,125900,0,0,0
114.735164,0,241,341,-100,100,126300,125900,14791,126809,101609
114.735164,1,138,232,-94,94,126300,125900,9404,28196,4508
114.735164,2,1067,1100,-33,33,126300,125900,2994,-129894,-138210
114.735164,3,63,100,-37,37,126300,125900,906,23094,13770
114.735164,4,50,50,0,0,126300,125900,-1266,-12334,-12334
114.735164,5,692,705,-13,13,126300,125900,515,-84415,-87691
114.735164,6,0,0,0,0,126300,125900,0,0,0
115.0305,0,241,341,-100,100,126300,125900,14791,126809,101609
115.0305,1,138,232,-94,94,126300,125900,9404,28196,4508
115.0305,2,1067,1100,-33,33,126300,125900,2994,-129894,-138210
115.0305,3,63,100,-37,37,126300,125900,906,23094,13770
115.0305,4,50,50,0,0,126300,125900,-1266,-12334,-12334
115.0305,5,692,705,-13,13,126300,125900,515,-84415,-87691
115.0305,6,0,0,0,0,126300,125900,0,0,0
115.218162,0,241,341,-100,100,126300,125900,14791,126809,101609
115.218162,1,138,232,-94,94,126300,125900,9404,28196,4508
115.218162,2,1077,1100,-23,23,126300,125900,2944,-133844,-139640
115.218162,3,63,102,-39,39,126300,125900,881,23519,13691
115.218162,4,50,50,0,0,126300,125900,-1266,-12334,-12334
115.218162,5,692,713,-21,21,126300,125900,717,-83017,-88309
115.218162,6,0,0,0,0,126300,125900,0,0,0
115.479764,0,241,341,-100,100,126200,125900,14791,126809,101609
115.479764,1,138,232,-94,94,126200,125900,9404,28196,4508
115.479764,2,1087,1110,-23,23,126200,125900,2767,-133667,-139463
115.479764,3,63,102,-39,39,126200,125900,881,23519,13691
115.479764,4,50,50,0,0,126200,125900,-1266,-12334,-12334
115.479764,5,702,723,-21,21,126200,125900,1147,-85447,-90739
115.479764,6,0,0,0,0,126200,125900,0,0,0
115.783501,0,241,341,-100,100,126100,125900,14791,126809,106809
115.783501,1,138,232,-94,94,126100,125900,9404,28196,9396
115.783501,2,1087,1110,-23,23,126100,125900,2767,-133667,-138267
115.783501,3,63,102,-39,39,126100,125900,881,23519,15719
115.783501,4,50,50,0,0,126100,125900,-1266,-12334,-12334
115.783501,5,712,723,-11,11,126100,125900,1021,-89321,-91521
115.783501,6,0,0,0,0,126100,125900,0,0,0
115.975602,0,241,341,-100,100,126100,125900,14791,126809,106809
115.975602,1,138,232,-94,94,126100,125900,9404,28196,9396
115.975602,2,1087,1110,-23,23,126100,125900,2767,-133667,-138267
115.975602,3,63,102,-39,39,126100,125900,881,23519,15719
115.975602,4,50,50,0,0,126100,125900,-1266,-12334,-12334
115.975602,5,712,723,-11,11,126100,125900,1021,-89321,-91521
115.975602,6,0,0,0,0,126100,125900,0,0,0
116.204228,0,241,341,-100,100,126100,125900,14791,126809,106809
116.204228,1,138,232,-94,94,126100,125900,9404,28196,9396
116.204228,2,1087,1110,-23,23,126100,125900,2767,-133667,-138267
116.204228,3,63,102,-39,39,126100,125900,881,23519,15719
116.204228,4,50,50,0,0,126100,125900,-1266,-12334,-12334
116.204228,5,712,723,-11,11,126100,125900,1021,-89321,-91521
116.204228,6,0,0,0,0,126100,125900,0,0,0
116.505997,0,241,341,-100,100,126500,126000,14791,126809,101609
116.505997,1,138,232,-94,94,126500,126000,9404,28196,4508
116.505997,2,1087,1120,-33,33,126500,126000,2641,-133541,-141857
116.505997,3,63,104,-41,41,126500,126000,856,23544,13212
116.505997,4,50,50,0,0,126500,126000,-1266,-12334,-12334
116.505997,5,712,723,-11,11,126500,126000,1021,-89321,-92093
116.505997,6,0,0,0,0,126500,126000,0,0,0
116.75708,0,241,341,-100,100,126500,126000,14791,126809,101609
116.75708,1,138,232,-94,94,126500,126000,9404,28196,4508
116.75708,2,1087,1120,-33,33,126500,126000,2641,-133541,-141857
116.75708,3,63,104,-41,41,126500,126000,856,23544,13212
116.75708,4,50,50,0,0,126500,126000,-1266,-12334,-12334
116.75708,5,712,723,-11,11,126500,126000,1021,-89321,-92093
116.75708,6,0,0,0,0,126500,126000,0,0,0
116.974762,0,241,341,-100,100,126500,126000,14791,126809,101609
116.974762,1,138,232,-94,94,126500,126000,9404,28196,4508
116.974762,2,1087,1120,-33,33,126500,126000,2641,-133541,-141857
116.974762,3,63,104,-41,41,126500,126000,856,23544,13212
116.974762,4,50,50,0,0,126500,126000,-1266,-12334,-12334
116.974762,5,712,723,-11,11,126500,126000,1021,-89321,-92093
116.974762,6,0,0,0,0,126500,126000,0,0,0
117.287427,0,241,341,-100,100,126500,126000,14791,126809,101609
117.287427,1,138,232,-94,94,126500,126000,9404,28196,4508
117.287427,2,1087,1120,-33,33,126500,126000,2641,-133541,-141857
117.287427,3,63,104,-41,41,126500,126000,856,23544,13212
117.287427,4,50,50,0,0,126500,126000,-1266,-12334,-12334
117.287427,5,712,723,-11,11,126500,126000,1021,-89321,-92093
117.287427,6,0,0,0,0,126500,126000,0,0,0
117.482358,0,241,341,-100,100,126300,126000,14791,126809,101609
117.482358,1,138,232,-94,94,126300,126000,9404,28196,4508
117.482358,2,1097,1120,-23,23,126300,126000,2591,-137491,-143287
117.482358,3,63,106,-43,43,126300,126000,831,23969,13133
117.482358,4,50,50,0,0,126300,126000,-1266,-12334,-12334
117.482358,5,712,731,-19,19,126300,126000,1223,-87923,-92711
117.482358,6,0,0,0,0,126300,126000,0,0,0
117.780359,0,241,341,-100,100,126300,126000,14791,126809,101609
117.780359,1,138,232,-94,94,126300,126000,9404,28196,4508
117.780359,2,1097,1120,-23,23,126300,126000,2591,-137491,-143287
117.780359,3,63,106,-43,43,126300,126000,831,23969,13133
117.780359,4,50,50,0,0,126300,126000,-1266,-12334,-12334
117.780359,5,712,731,-19,19,126300,126000,1223,-87923,-92711
117.780359,6,0,0,0,0,126300,126000,0,0,0
117.966742,0,241,341,-100,100,125700,126000,14791,126809,152009
117.966742,1,138,232,-94,94,125700,126000,9404,28196,51884
117.966742,2,1107,1120,-13,13,125700,126000,2465,-140365,-137089
117.966742,3,63,106,-43,43,125700,126000,831,23969,34805
117.966742,4,50,50,0,0,125700,126000,-1266,-12334,-12334
117.966742,5,722,731,-9,9,125700,126000,1097,-90797,-88529
117.966742,6,0,0,0,0,125700,126000,0,0,0
118.293512,0,241,341,-100,100,125700,126000,14791,126809,152009
118.293512,1,138,232,-94,94,125700,126000,9404,28196,51884
118.293512,2,1107,1120,-13,13,125700,126000,2465,-140365,-137089
118.293512,3,63,106,-43,43,125700,126000,831,23969,34805
118.293512,4,50,50,0,0,125700,126000,-1266,-12334,-12334
118.293512,5,722,731,-9,9,125700,126000,1097,-90797,-88529
118.293512,6,0,0,0,0,125700,126000,0,0,0
118.545245,0,241,341,-100,100,125700,126000,14791,126809,152009
118.545245,1,138,232,-94,94,125700,126000,9404,28196,51884
118.545245,2,1107,1120,-13,13,125700,126000,2465,-140365,-137089
118.545245,3,63,106,-43,43,125700,126000,831,23969,34805
118.545245,4,50,50,0,0,125700,126000,-1266,-12334,-12334
118.545245,5,722,731,-9,9,125700,126000,1097,-90797,-88529
118.545245,6,0,0,0,0,125700,126000,0,0,0
118.771707,0,241,341,-100,100,125700,126000,14791,126809,152009
118.771707,1,138,232,-94,94,125700,126000,9404,28196,51884
118.771707,2,1107,1120,-13,13,125700,126000,2465,-140365,-137089
118.771707,3,63,106,-43,43,125700,126000,831,23969,34805
118.771707,4,50,50,0,0,125700,126000,-1266,-12334,-12334
118.771707,5,722,731,-9,9,125700,126000,1097,-90797,-88529
118.771707,6,0,0,0,0,125700,126000,0,0,0
118.996641,0,241,341,-100,100,125700,126000,14791,126809,152009
118.996641,1,138,232,-94,94,125700,126000,9404,28196,51884
118.996641,2,1107,1120,-13,13,125700,126000,2465,-140365,-137089
118.996641,3,63,106,-43,43,125700,126000,831,23969,34805
118.996641,4,50,50,0,0,125700,126000,-1266,-12334,-12334
118.996641,5,722,731,-9,9,125700,126000,1097,-90797,-88529
118.996641,6,0,0,0,0,125700,126000,0,0,0
119.276796,0,241,341,-100,100,125700,126000,14791,126809,152009
119.276796,1,138,232,-94,94,125700,126000,9404,28196,51884
119.276796,2,1107,1120,-13,13,125700,126000,2465,-140365,-137089
119.276796,3,63,106,-43,43,125700,126000,831,23969,34805
119.276796,4,50,50,0,0,125700,126000,-1266,-12334,-12334
119.276796,5,722,731,-9,9,125700,126000,1097,-90797,-88529
119.276796,6,0,0,0,0,125700,126000,0,0,0
119.524474,0,241,341,-100,100,125700,126000,14791,126809,152009
119.524474,1,138,232,-94,94,125700,126000,9404,28196,51884
119.524474,2,1107,1120,-13,13,125700,126000,2465,-140365,-137089
119.524474,3,63,106,-43,43,125700,126000,831,23969,34805
119.524474,4,50,50,0,0,125700,126000,-1266,-12334,-12334
119.524474,5,722,731,-9,9,125700,126000,1097,-90797,-88529
119.524474,6,0,0,0,0,125700,126000,0,0,0
119.733668,0,241,341,-100,100,125700,126000,14791,126809,152009
119.733668,1,138,232,-94,94,125700,126000,9404,28196,51884
119.733668,2,1107,1120,-13,13,125700,126000,2465,-140365,-137089
119.733668,3,63,106,-43,43,125700,126000,831,23969,34805
119.733668,4,50,50,0,0,125700,126000,-1266,-12334,-12334
119.733668,5,722,731,-9,9,125700,126000,1097,-90797,-88529
119.733668,6,0,0,0,0,125700,126000,0,0,0
119.96598,0,241,341,-100,100,125700,126000,14791,126809,152009
119.96598,1,138,232,-94,94,125700,126000,9404,28196,51884
119.96598,2,1107,1120,-13,13,125700,126000,2465,-140365,-137089
119.96598,3,63,106,-43,43,125700,126000,831,23969,34805
119.96598,4,50,50,0,0,125700,126000,-1266,-12334,-12334
119.96598,5,722,731,-9,9,125700,126000,1097,-90797,-88529
119.96598,6,0,0,0,0,125700,126000,0,0,0
120.275068,0,241,341,-100,100,126500,126000,14791,126809,101609
120.275068,1,138,232,-94,94,126500,126000,9404,28196,4508
120.275068,2,1107,1130,-23,23,126500,126000,2339,-138239,-144035
120.275068,3,63,108,-45,45,126500,126000,806,24594,13254
120.275068,4,50,50,0,0,126500,126000,-1266,-12334,-12334
120.275068,5,722,741,-19,19,126500,126000,971,-88671,-93459
120.275068,6,0,0,0,0,126500,126000,0,0,0
120.462193,0,241,341,-100,100,126500,126000,14791,126809,101609
120.462193,1,138,232,-94,94,126500,126000,9404,28196,4508
120.462193,2,1107,1131,-24,24,126500,126000,2364,-137864,-143912
120.462193,3,63,108,-45,45,126500,126000,806,24594,13254
120.462193,4,50,50,0,0,126500,126000,-1266,-12334,-12334
120.462193,5,722,751,-29,29,126500,126000,1224,-84924,-92232
120.462193,6,0,0,0,0,126500,126000,0,0,0
120.786218,0,241,341,-100,100,125700,126000,14791,126809,152009
120.786218,1,138,232,-94,94,125700,126000,9404,28196,51884
120.786218,2,1117,1140,-23,23,125700,126000,2124,-137924,-132128
120.786218,3,63,109,-46,46,125700,126000,793,24907,36499
120.786218,4,60,50,10,-10,125700,126000,-1392,-9208,-11728
120.786218,5,732,761,-29,29,125700,126000,1730,-87430,-80122
120.786218,6,0,0,0,0,125700,126000,0,0,0
121.03452,0,241,341,-100,100,126400,126000,14791,126809,101609
121.03452,1,138,232,-94,94,126400,126000,9404,28196,4508
121.03452,2,1117,1140,-23,23,126400,126000,2124,-137924,-143720
121.03452,3,63,110,-47,47,126400,126000,780,25020,13176
121.03452,4,60,50,10,-10,126400,126000,-1392,-9208,-6688
121.03452,5,733,761,-28,28,126400,126000,1755,-87755,-94811
121.03452,6,0,0,0,0,126400,126000,0,0,0
121.271743,0,241,341,-100,100,126500,126000,14791,126809,101609
121.271743,1,138,232,-94,94,126500,126000,9404,28196,4508
121.271743,2,1117,1143,-26,26,126500,126000,2086,-136986,-143538
121.271743,3,63,110,-47,47,126500,126000,780,25020,13176
121.271743,4,60,50,10,-10,126500,126000,-1392,-9208,-6688
121.271743,5,733,761,-28,28,126500,126000,1755,-87755,-94811
121.271743,6,0,0,0,0,126500,126000,0,0,0
121.530224,0,241,341,-100,100,126500,126000,14791,126809,101609
121.530224,1,138,232,-94,94,126500,126000,9404,28196,4508
121.530224,2,1117,1143,-26,26,126500,126000,2086,-136986,-143538
121.530224,3,63,110,-47,47,126500,126000,780,25020,13176
121.530224,4,60,50,10,-10,126500,126000,-1392,-9208,-6688
121.530224,5,733,761,-28,28,126500,126000,1755,-87755,-94811
121.530224,6,0,0,0,0,126500,126000,0,0,0
121.746359,0,241,341,-100,100,126500,126000,14791,126809,101609
121.746359,1,138,232,-94,94,126500,126000,9404,28196,4508
121.746359,2,1117,1143,-26,26,126500,126000,2086,-136986,-143538
121.746359,3,63,110,-47,47,126500,126000,780,25020,13176
121.746359,4,60,50,10,-10,126500,126000,-1392,-9208,-6688
121.746359,5,733,761,-28,28,126500,126000,1755,-87755,-94811
121.746359,6,0,0,0,0,126500,126000,0,0,0
121.95982,0,241,341,-100,100,126100,126000,14791,126809,116809
121.95982,1,138,232,-94,94,126100,126000,9404,28196,18796
121.95982,2,1127,1143,-16,16,126100,126000,1960,-140860,-142460
121.95982,3,63,110,-47,47,126100,126000,780,25020,20320
121.95982,4,64,50,14,-14,126100,126000,-1442,-9958,-8558
121.95982,5,743,761,-18,18,126100,126000,1629,-90629,-92429
121.95982,6,0,0,0,0,126100,126000,0,0,0
122.235588,0,241,341,-100,100,126200,126000,14791,126809,106809
122.235588,1,138,232,-94,94,126200,126000,9404,28196,9396
122.235588,2,1137,1153,-16,16,126200,126000,1708,-140608,-143808
122.235588,3,63,110,-47,47,126200,126000,780,25020,15620
122.235588,4,64,50,14,-14,126200,126000,-1442,-9958,-7158
122.235588,5,753,771,-18,18,126200,126000,2134,-93134,-96734
122.235588,6,0,0,0,0,126200,126000,0,0,0
122.516541,0,241,341,-100,100,126200,126000,14791,126809,106809
122.516541,1,138,232,-94,94,126200,126000,9404,28196,9396
122.516541,2,1137,1153,-16,16,126200,126000,1708,-140608,-143808
122.516541,3,63,110,-47,47,126200,126000,780,25020,15620
122.516541,4,64,50,14,-14,126200,126000,-1442,-9958,-7158
122.516541,5,753,771,-18,18,126200,126000,2134,-93134,-96734
122.516541,6,0,0,0,0,126200,126000,0,0,0
122.730584,0,241,341,-100,100,126100,126000,14791,126809,116809
122.730584,1,138,232,-94,94,126100,126000,9404,28196,18796
122.730584,2,1141,1163,-22,22,126100,126000,1532,-139232,-141432
122.730584,3,63,110,-47,47,126100,126000,780,25020,20320
122.730584,4,70,50,20,-20,126100,126000,-1518,-11082,-9082
122.730584,5,763,781,-18,18,126100,126000,2638,-95638,-97438
122.730584,6,0,0,0,0,126100,126000,0,0,0
122.961893,0,241,341,-100,100,126100,126000,14791,126809,116809
122.961893,1,138,232,-94,94,126100,126000,9404,28196,18796
122.961893,2,1141,1163,-22,22,126100,126000,1532,-139232,-141432
122.961893,3,63,110,-47,47,126100,126000,780,25020,20320
122.961893,4,70,50,20,-20,126100,126000,-1518,-11082,-9082
122.961893,5,763,781,-18,18,126100,126000,2638,-95638,-97438
122.961893,6,0,0,0,0,126100,126000,0,0,0
123.250771,0,241,341,-100,100,126200,126000,14791,126809,106809
123.250771,1,138,232,-94,94,126200,126000,9404,28196,9396
123.250771,2,1151,1163,-12,12,126200,126000,1406,-142106,-144506
123.250771,3,63,110,-47,47,126200,126000,780,25020,15620
123.250771,4,70,50,20,-20,126200,126000,-1518,-11082,-7082
123.250771,5,773,781,-8,8,126200,126000,2512,-98512,-100112
123.250771,6,0,0,0,0,126200,126000,0,0,0
123.46489,0,241,341,-100,100,126200,125800,14791,126809,101609
123.46489,1,138,232,-94,94,126200,125800,9404,28196,4508
123.46489,2,1151,1163,-12,12,126200,125800,1406,-142106,-145130
123.46489,3,63,110,-47,47,126200,125800,780,25020,13176
123.46489,4,70,50,20,-20,126200,125800,-1518,-11082,-6042
123.46489,5,773,781,-8,8,126200,125800,2512,-98512,-100528
123.46489,6,0,0,0,0,126200,125800,0,0,0
123.727088,0,241,341,-100,100,126100,125800,14791,126809,101609
123.727088,1,138,232,-94,94,126100,125800,9404,28196,4508
123.727088,2,1155,1163,-8,8,126100,125800,1356,-143656,-145672
123.727088,3,63,114,-51,51,126100,125800,880,26120,13268
123.727088,4,70,50,20,-20,126100,125800,-1518,-11082,-6042
123.727088,5,773,781,-8,8,126100,125800,2512,-98512,-100528
123.727088,6,0,0,0,0,126100,125800,0,0,0
123.960814,0,241,341,-100,100,126100,125800,14791,126809,101609
123.960814,1,138,232,-94,94,126100,125800,9404,28196,4508
123.960814,2,1155,1163,-8,8,126100,125800,1356,-143656,-145672
123.960814,3,63,114,-51,51,126100,125800,880,26120,13268
123.960814,4,70,50,20,-20,126100,125800,-1518,-11082,-6042
123.960814,5,773,781,-8,8,126100,125800,2512,-98512,-100528
123.960814,6,0,0,0,0,126100,125800,0,0,0
124.209908,0,241,341,-100,100,126100,126000,14791,126809,116809
124.209908,1,138,232,-94,94,126100,126000,9404,28196,18796
124.209908,2,1155,1163,-8,8,126100,126000,1356,-143656,-144456
124.209908,3,63,114,-51,51,126100,126000,880,26120,21020
124.209908,4,70,50,20,-20,126100,126000,-1518,-11082,-9082
124.209908,5,773,781,-8,8,126100,126000,2512,-98512,-99312
124.209908,6,0,0,0,0,126100,126000,0,0,0
124.496504,0,241,341,-100,100,126200,126000,14791,126809,106809
124.496504,1,138,232,-94,94,126200,126000,9404,28196,9396
124.496504,2,1165,1173,-8,8,126200,126000,1482,-146782,-148382
124.496504,3,68,114,-46,46,126200,126000,1006,25494,16294
124.496504,4,70,50,20,-20,126200,126000,-1518,-11082,-7082
124.496504,5,783,781,2,-2,126200,126000,2764,-97764,-97364
124.496504,6,0,0,0,0,126200,126000,0,0,0
124.726162,0,241,341,-100,100,125800,126000,14791,126809,146809
124.726162,1,138,232,-94,94,125800,126000,9404,28196,46996
124.726162,2,1175,1173,2,-2,125800,126000,1356,-148656,-149056
124.726162,3,68,114,-46,46,125800,126000,1006,25494,34694
124.726162,4,70,50,20,-20,125800,126000,-1518,-11082,-15082
124.726162,5,784,781,3,-3,125800,126000,2751,-97751,-98351
124.726162,6,0,0,0,0,125800,126000,0,0,0
124.952108,0,241,341,-100,100,125700,126000,14791,126809,152009
124.952108,1,138,232,-94,94,125700,126000,9404,28196,51884
124.952108,2,1185,1173,12,-12,125700,126000,1230,-147530,-150554
124.952108,3,68,114,-46,46,125700,126000,1006,25494,37086
124.952108,4,70,50,20,-20,125700,126000,-1518,-11082,-16122
124.952108,5,793,781,12,-12,125700,126000,2638,-96738,-99762
124.952108,6,0,0,0,0,125700,126000,0,0,0
125.289658,0,241,341,-100,100,125900,125800,14791,126809,116809
125.289658,1,138,232,-94,94,125900,125800,9404,28196,18796
125.289658,2,1185,1173,12,-12,125900,125800,1230,-147530,-146330
125.289658,3,72,114,-42,42,125900,125800,1107,25393,21193
125.289658,4,70,50,20,-20,125900,125800,-1518,-11082,-9082
125.289658,5,793,785,8,-8,125900,125800,2588,-97088,-96288
125.289658,6,0,0,0,0,125900,125800,0,0,0
125.530562,0,241,341,-100,100,125900,125800,14791,126809,116809
125.530562,1,138,232,-94,94,125900,125800,9404,28196,18796
125.530562,2,1185,1183,2,-2,125900,125800,1104,-148404,-148204
125.530562,3,72,114,-42,42,125900,125800,1107,25393,21193
125.530562,4,70,50,20,-20,125900,125800,-1518,-11082,-9082
125.530562,5,803,785,18,-18,125900,125800,2840,-97340,-95540
125.530562,6,0,0,0,0,125900,125800,0,0,0
125.705603,0,241,341,-100,100,126200,126000,14791,126809,106809
125.705603,1,138,232,-94,94,126200,126000,9404,28196,9396
125.705603,2,1185,1183,2,-2,126200,126000,1104,-148404,-148004
125.705603,3,80,114,-34,34,126200,126000,1309,23591,16791
125.705603,4,70,50,20,-20,126200,126000,-1518,-11082,-7082
125.705603,5,803,785,18,-18,126200,126000,2840,-97340,-93740
125.705603,6,0,0,0,0,126200,126000,0,0,0
125.985772,0,241,341,-100,100,126200,126000,14791,126809,106809
125.985772,1,138,232,-94,94,126200,126000,9404,28196,9396
125.985772,2,1185,1183,2,-2,126200,126000,1104,-148404,-148004
125.985772,3,80,114,-34,34,126200,126000,1309,23591,16791
125.985772,4,70,50,20,-20,126200,126000,-1518,-11082,-7082
125.985772,5,803,785,18,-18,126200,126000,2840,-97340,-93740
125.985772,6,0,0,0,0,126200,126000,0,0,0
126.225232,0,241,341,-100,100,126200,126000,14791,126809,106809
126.225232,1,138,232,-94,94,126200,126000,9404,28196,9396
126.225232,2,1185,1183,2,-2,126200,126000,1104,-148404,-148004
126.225232,3,80,114,-34,34,126200,126000,1309,23591,16791
126.225232,4,70,50,20,-20,126200,126000,-1518,-11082,-7082
126.225232,5,803,785,18,-18,126200,126000,2840,-97340,-93740
126.225232,6,0,0,0,0,126200,126000,0,0,0
126.54829,0,241,341,-100,100,125900,126000,14791,126809,136809
126.54829,1,138,232,-94,94,125900,126000,9404,28196,37596
126.54829,2,1195,1183,12,-12,125900,126000,978,-149278,-150478
126.54829,3,80,114,-34,34,125900,126000,1309,23591,26991
126.54829,4,70,50,20,-20,125900,126000,-1518,-11082,-13082
126.54829,5,803,795,8,-8,125900,126000,3092,-97592,-98392
126.54829,6,0,0,0,0,125900,126000,0,0,0
126.74762,0,241,341,-100,100,125900,126000,14791,126809,136809
126.74762,1,138,232,-94,94,125900,126000,9404,28196,37596
126.74762,2,1195,1183,12,-12,125900,126000,978,-149278,-150478
126.74762,3,80,114,-34,34,125900,126000,1309,23591,26991
126.74762,4,70,50,20,-20,125900,126000,-1518,-11082,-13082
126.74762,5,803,795,8,-8,125900,126000,3092,-97592,-98392
126.74762,6,0,0,0,0,125900,126000,0,0,0
127.019591,0,241,341,-100,100,125800,126000,14791,126809,146809
127.019591,1,138,232,-94,94,125800,126000,9404,28196,46996
127.019591,2,1195,1193,2,-2,125800,126000,852,-150152,-150552
127.019591,3,83,114,-31,31,125800,126000,1384,23516,29716
127.019591,4,70,50,20,-20,125800,126000,-1518,-11082,-15082
127.019591,5,813,798,15,-15,125800,126000,3306,-98106,-101106
127.019591,6,0,0,0,0,125800,126000,0,0,0
127.236983,0,241,341,-100,100,126400,126000,14791,126809,101609
127.236983,1,138,232,-94,94,126400,126000,9404,28196,4508
127.236983,2,1202,1203,-1,1,126400,126000,902,-150202,-150454
127.236983,3,83,116,-33,33,126400,126000,1359,24141,15825
127.236983,4,70,50,20,-20,126400,126000,-1518,-11082,-6042
127.236983,5,813,805,8,-8,126400,126000,3218,-98718,-96702
127.236983,6,0,0,0,0,126400,126000,0,0,0
127.479816,0,241,341,-100,100,126400,126000,14791,126809,101609
127.479816,1,138,232,-94,94,126400,126000,9404,28196,4508
127.479816,2,1202,1203,-1,1,126400,126000,902,-150202,-150454
127.479816,3,83,116,-33,33,126400,126000,1359,24141,15825
127.479816,4,70,50,20,-20,126400,126000,-1518,-11082,-6042
127.479816,5,813,805,8,-8,126400,126000,3218,-98718,-96702
127.479816,6,0,0,0,0,126400,126000,0,0,0
127.738072,0,241,341,-100,100,126400,126000,14791,126809,101609
127.738072,1,138,232,-94,94,126400,126000,9404,28196,4508
127.738072,2,1202,1203,-1,1,126400,126000,902,-150202,-150454
127.738072,3,83,116,-33,33,126400,126000,1359,24141,15825
127.738072,4,70,50,20,-20,126400,126000,-1518,-11082,-6042
127.738072,5,813,805,8,-8,126400,126000,3218,-98718,-96702
127.738072,6,0,0,0,0,126400,126000,0,0,0
128.050167,0,241,341,-100,100,126200,126000,14791,126809,106809
128.050167,1,138,232,-94,94,126200,126000,9404,28196,9396
128.050167,2,1202,1213,-11,11,126200,126000,1153,-149453,-151653
128.050167,3,83,118,-35,35,126200,126000,1334,24766,17766
128.050167,4,70,50,20,-20,126200,126000,-1518,-11082,-7082
128.050167,5,813,805,8,-8,126200,126000,3218,-98718,-97118
128.050167,6,0,0,0,0,126200,126000,0,0,0
128.25458,0,241,341,-100,100,126200,125600,14791,126809,101709
128.25458,1,138,232,-94,94,126200,125600,9404,28196,4602
128.25458,2,1202,1213,-11,11,126200,125600,1153,-149453,-152214
128.25458,3,83,118,-35,35,126200,125600,1334,24766,15981
128.25458,4,70,50,20,-20,126200,125600,-1518,-11082,-6062
128.25458,5,813,805,8,-8,126200,125600,3218,-98718,-96710
128.25458,6,0,0,0,0,126200,125600,0,0,0
128.521855,0,241,341,-100,100,125700,125600,14791,126809,116809
128.521855,1,138,232,-94,94,125700,125600,9404,28196,18796
128.521855,2,1202,1213,-11,11,125700,125600,1153,-149453,-150553
128.521855,3,83,118,-35,35,125700,125600,1334,24766,21266
128.521855,4,70,50,20,-20,125700,125600,-1518,-11082,-9082
128.521855,5,813,815,-2,2,125700,125600,3469,-99969,-100169
128.521855,6,0,0,0,0,125700,125600,0,0,0
128.72032,0,241,341,-100,100,125700,125600,14791,126809,116809
128.72032,1,138,232,-94,94,125700,125600,9404,28196,18796
128.72032,2,1202,1213,-11,11,125700,125600,1153,-149453,-150553
128.72032,3,83,118,-35,35,125700,125600,1334,24766,21266
128.72032,4,70,50,20,-20,125700,125600,-1518,-11082,-9082
128.72032,5,813,815,-2,2,125700,125600,3469,-99969,-100169
128.72032,6,0,0,0,0,125700,125600,0,0,0
129.024506,0,241,341,-100,100,125700,125600,14791,126809,116809
129.024506,1,138,232,-94,94,125700,125600,9404,28196,18796
129.024506,2,1212,1213,-1,1,125700,125600,1027,-152327,-152427
129.024506,3,83,118,-35,35,125700,125600,1334,24766,21266
129.024506,4,70,50,20,-20,125700,125600,-1518,-11082,-9082
129.024506,5,823,815,8,-8,125700,125600,3343,-101843,-101043
129.024506,6,0,0,0,0,125700,125600,0,0,0
129.253011,0,241,341,-100,100,125700,125600,14791,126809,116809
129.253011,1,138,232,-94,94,125700,125600,9404,28196,18796
129.253011,2,1212,1213,-1,1,125700,125600,1027,-152327,-152427
129.253011,3,83,118,-35,35,125700,125600,1334,24766,21266
129.253011,4,70,50,20,-20,125700,125600,-1518,-11082,-9082
129.253011,5,823,815,8,-8,125700,125600,3343,-101843,-101043
129.253011,6,0,0,0,0,125700,125600,0,0,0
129.462571,0,241,341,-100,100,125700,125600,14791,126809,116809
129.462571,1,138,232,-94,94,125700,125600,9404,28196,18796
129.462571,2,1212,1213,-1,1,125700,125600,1027,-152327,-152427
129.462571,3,83,118,-35,35,125700,125600,1334,24766,21266
129.462571,4,70,50,20,-20,125700,125600,-1518,-11082,-9082
129.462571,5,823,815,8,-8,125700,125600,3343,-101843,-101043
129.462571,6,0,0,0,0,125700,125600,0,0,0
129.795023,0,241,341,-100,100,125700,125600,14791,126809,116809
129.795023,1,138,232,-94,94,125700,125600,9404,28196,18796
129.795023,2,1222,1213,9,-9,125700,125600,901,-153201,-152301
129.795023,3,83,118,-35,35,125700,125600,1334,24766,21266
129.795023,4,70,50,20,-20,125700,125600,-1518,-11082,-9082
129.795023,5,823,815,8,-8,125700,125600,3343,-101843,-101043
129.795023,6,0,0,0,0,125700,125600,0,0,0
130.04006,0,241,341,-100,100,125800,125600,14791,126809,106809
130.04006,1,138,232,-94,94,125800,125600,9404,28196,9396
130.04006,2,1222,1223,-1,1,125800,125600,1153,-153453,-153653
130.04006,3,83,118,-35,35,125800,125600,1334,24766,17766
130.04006,4,70,50,20,-20,125800,125600,-1518,-11082,-7082
130.04006,5,833,815,18,-18,125800,125600,3217,-102717,-99117
130.04006,6,0,0,0,0,125800,125600,0,0,0
130.250806,0,241,341,-100,100,125800,125600,14791,126809,106809
130.250806,1,138,232,-94,94,125800,125600,9404,28196,9396
130.250806,2,1222,1223,-1,1,125800,125600,1153,-153453,-153653
130.250806,3,83,118,-35,35,125800,125600,1334,24766,17766
130.250806,4,70,50,20,-20,125800,125600,-1518,-11082,-7082
130.250806,5,833,815,18,-18,125800,125600,3217,-102717,-99117
130.250806,6,0,0,0,0,125800,125600,0,0,0
130.504889,0,241,341,-100,100,125800,125600,14791,126809,106809
130.504889,1,138,232,-94,94,125800,125600,9404,28196,9396
130.504889,2,1222,1223,-1,1,125800,125600,1153,-153453,-153653
130.504889,3,83,118,-35,35,125800,125600,1334,24766,17766
130.504889,4,70,50,20,-20,125800,125600,-1518,-11082,-7082
130.504889,5,833,815,18,-18,125800,125600,3217,-102717,-99117
130.504889,6,0,0,0,0,125800,125600,0,0,0
130.724694,0,241,341,-100,100,125800,125600,14791,126809,106809
130.724694,1,138,232,-94,94,125800,125600,9404,28196,9396
130.724694,2,1222,1223,-1,1,125800,125600,1153,-153453,-153653
130.724694,3,83,118,-35,35,125800,125600,1334,24766,17766
130.724694,4,70,50,20,-20,125800,125600,-1518,-11082,-7082
130.724694,5,833,815,18,-18,125800,125600,3217,-102717,-99117
130.724694,6,0,0,0,0,125800,125600,0,0,0
130.997941,0,241,341,-100,100,125800,125600,14791,126809,106809
130.997941,1,138,232,-94,94,125800,125600,9404,28196,9396
130.997941,2,1222,1223,-1,1,125800,125600,1153,-153453,-153653
130.997941,3,83,118,-35,35,125800,125600,1334,24766,17766
130.997941,4,70,50,20,-20,125800,125600,-1518,-11082,-7082
130.997941,5,833,815,18,-18,125800,125600,3217,-102717,-99117
130.997941,6,0,0,0,0,125800,125600,0,0,0
131.23118,0,241,341,-100,100,125800,125600,14791,126809,106809
131.23118,1,138,232,-94,94,125800,125600,9404,28196,9396
131.23118,2,1222,1223,-1,1,125800,125600,1153,-153453,-153653
131.23118,3,83,118,-35,35,125800,125600,1334,24766,17766
131.23118,4,70,50,20,-20,125800,125600,-1518,-11082,-7082
131.23118,5,833,815,18,-18,125800,125600,3217,-102717,-99117
131.23118,6,0,0,0,0,125800,125600,0,0,0
131.536802,0,241,341,-100,100,125800,125600,14791,126809,106809
131.536802,1,138,232,-94,94,125800,125600,9404,28196,9396
131.536802,2,1222,1223,-1,1,125800,125600,1153,-153453,-153653
131.536802,3,83,118,-35,35,125800,125600,1334,24766,17766
131.536802,4,70,50,20,-20,125800,125600,-1518,-11082,-7082
131.536802,5,833,815,18,-18,125800,125600,3217,-102717,-99117
131.536802,6,0,0,0,0,125800,125600,0,0,0
131.724809,0,241,341,-100,100,125800,125700,14791,126809,116809
131.724809,1,138,232,-94,94,125800,125700,9404,28196,18796
131.724809,2,1222,1223,-1,1,125800,125700,1153,-153453,-153553
131.724809,3,83,118,-35,35,125800,125700,1334,24766,21266
131.724809,4,70,50,20,-20,125800,125700,-1518,-11082,-9082
131.724809,5,833,815,18,-18,125800,125700,3217,-102717,-100917
131.724809,6,0,0,0,0,125800,125700,0,0,0
131.979246,0,241,341,-100,100,125800,125700,14791,126809,116809
131.979246,1,138,232,-94,94,125800,125700,9404,28196,18796
131.979246,2,1222,1223,-1,1,125800,125700,1153,-153453,-153553
131.979246,3,83,118,-35,35,125800,125700,1334,24766,21266
131.979246,4,70,50,20,-20,125800,125700,-1518,-11082,-9082
131.979246,5,833,815,18,-18,125800,125700,3217,-102717,-100917
131.979246,6,0,0,0,0,125800,125700,0,0,0
132.288474,0,241,341,-100,100,126200,125700,14791,126809,101709
132.288474,1,138,232,-94,94,126200,125700,9404,28196,4602
132.288474,2,1232,1233,-1,1,126200,125700,1279,-153579,-153830
132.288474,3,83,120,-37,37,126200,125700,1309,25391,16104
132.288474,4,70,50,20,-20,126200,125700,-1518,-11082,-6062
132.288474,5,833,825,8,-8,126200,125700,3091,-102591,-100583
132.288474,6,0,0,0,0,126200,125700,0,0,0
132.504814,0,241,341,-100,100,126200,125700,14791,126809,101709
132.504814,1,138,232,-94,94,126200,125700,9404,28196,4602
132.504814,2,1232,1243,-11,11,126200,125700,1531,-150831,-153592
132.504814,3,83,122,-39,39,126200,125700,1359,25941,16152
132.504814,4,70,50,20,-20,126200,125700,-1518,-11082,-6062
132.504814,5,833,835,-2,2,126200,125700,3343,-99843,-100345
132.504814,6,0,0,0,0,126200,125700,0,0,0
132.78808,0,241,341,-100,100,125900,125700,14791,126809,106809
132.78808,1,138,232,-94,94,125900,125700,9404,28196,9396
132.78808,2,1242,1253,-11,11,125900,125700,1657,-148957,-151157
132.78808,3,83,124,-41,41,125900,125700,1409,26491,18291
132.78808,4,70,50,20,-20,125900,125700,-1518,-11082,-7082
132.78808,5,839,835,4,-4,125900,125700,3267,-100367,-99567
132.78808,6,0,0,0,0,125900,125700,0,0,0
132.998263,0,241,341,-100,100,125700,125700,14791,126809,126809
132.998263,1,138,232,-94,94,125700,125700,9404,28196,28196
132.998263,2,1252,1253,-1,1,125700,125700,1531,-150831,-150831
132.998263,3,83,124,-41,41,125700,125700,1409,26491,26491
132.998263,4,70,50,20,-20,125700,125700,-1518,-11082,-11082
132.998263,5,843,835,8,-8,125700,125700,3217,-100317,-100317
132.998263,6,0,0,0,0,125700,125700,0,0,0
133.275511,0,241,341,-100,100,125700,125700,14791,126809,126809
133.275511,1,138,232,-94,94,125700,125700,9404,28196,28196
133.275511,2,1252,1253,-1,1,125700,125700,1531,-150831,-150831
133.275511,3,83,124,-41,41,125700,125700,1409,26491,26491
133.275511,4,70,50,20,-20,125700,125700,-1518,-11082,-11082
133.275511,5,843,835,8,-8,125700,125700,3217,-100317,-100317
133.275511,6,0,0,0,0,125700,125700,0,0,0
133.48366,0,241,341,-100,100,125700,125700,14791,126809,126809
133.48366,1,138,232,-94,94,125700,125700,9404,28196,28196
133.48366,2,1252,1253,-1,1,125700,125700,1531,-150831,-150831
133.48366,3,83,124,-41,41,125700,125700,1409,26491,26491
133.48366,4,70,50,20,-20,125700,125700,-1518,-11082,-11082
133.48366,5,843,835,8,-8,125700,125700,3217,-100317,-100317
133.48366,6,0,0,0,0,125700,125700,0,0,0
133.764487,0,241,341,-100,100,125700,125700,14791,126809,126809
133.764487,1,138,232,-94,94,125700,125700,9404,28196,28196
133.764487,2,1252,1253,-1,1,125700,125700,1531,-150831,-150831
133.764487,3,83,124,-41,41,125700,125700,1409,26491,26491
133.764487,4,70,50,20,-20,125700,125700,-1518,-11082,-11082
133.764487,5,843,835,8,-8,125700,125700,3217,-100317,-100317
133.764487,6,0,0,0,0,125700,125700,0,0,0
134.024451,0,241,341,-100,100,126100,125700,14791,126809,101709
134.024451,1,138,232,-94,94,126100,125700,9404,28196,4602
134.024451,2,1262,1253,9,-9,126100,125700,1783,-152083,-149824
134.024451,3,83,124,-41,41,126100,125700,1409,26491,16200
134.024451,4,70,50,20,-20,126100,125700,-1518,-11082,-6062
134.024451,5,843,845,-2,2,126100,125700,3091,-100191,-100693
134.024451,6,0,0,0,0,126100,125700,0,0,0
134.270257,0,241,341,-100,100,126100,125700,14791,126809,101709
134.270257,1,138,232,-94,94,126100,125700,9404,28196,4602
134.270257,2,1262,1253,9,-9,126100,125700,1783,-152083,-149824
134.270257,3,83,124,-41,41,126100,125700,1409,26491,16200
134.270257,4,70,50,20,-20,126100,125700,-1518,-11082,-6062
134.270257,5,843,845,-2,2,126100,125700,3091,-100191,-100693
134.270257,6,0,0,0,0,126100,125700,0,0,0
134.524436,0,241,341,-100,100,126100,126100,14791,126809,126809
134.524436,1,138,232,-94,94,126100,126100,9404,28196,28196
134.524436,2,1262,1253,9,-9,126100,126100,1783,-152083,-152083
134.524436,3,83,124,-41,41,126100,126100,1409,26491,26491
134.524436,4,70,50,20,-20,126100,126100,-1518,-11082,-11082
134.524436,5,843,845,-2,2,126100,126100,3091,-100191,-100191
134.524436,6,0,0,0,0,126100,126100,0,0,0
134.794094,0,241,341,-100,100,126200,126100,14791,126809,116809
134.794094,1,138,232,-94,94,126200,126100,9404,28196,18796
134.794094,2,1262,1255,7,-7,126200,126100,1758,-152058,-151358
134.794094,3,83,124,-41,41,126200,126100,1409,26491,22391
134.794094,4,70,50,20,-20,126200,126100,-1518,-11082,-9082
134.794094,5,843,845,-2,2,126200,126100,3091,-100191,-100391
134.794094,6,0,0,0,0,126200,126100,0,0,0
134.989091,0,241,341,-100,100,126200,126100,14791,126809,116809
134.989091,1,138,232,-94,94,126200,126100,9404,28196,18796
134.989091,2,1262,1255,7,-7,126200,126100,1758,-152058,-151358
134.989091,3,83,124,-41,41,126200,126100,1409,26491,22391
134.989091,4,70,50,20,-20,126200,126100,-1518,-11082,-9082
134.989091,5,843,845,-2,2,126200,126100,3091,-100191,-100391
134.989091,6,0,0,0,0,126200,126100,0,0,0
135.204097,0,241,341,-100,100,126200,126200,14791,126809,126809
135.204097,1,138,232,-94,94,126200,126200,9404,28196,28196
135.204097,2,1262,1255,7,-7,126200,126200,1758,-152058,-152058
135.204097,3,83,124,-41,41,126200,126200,1409,26491,26491
135.204097,4,70,50,20,-20,126200,126200,-1518,-11082,-11082
135.204097,5,843,845,-2,2,126200,126200,3091,-100191,-100191
135.204097,6,0,0,0,0,126200,126200,0,0,0
135.515984,0,241,341,-100,100,126200,126000,14791,126809,106809
135.515984,1,138,232,-94,94,126200,126000,9404,28196,9396
135.515984,2,1262,1255,7,-7,126200,126000,1758,-152058,-150658
135.515984,3,83,124,-41,41,126200,126000,1409,26491,18291
135.515984,4,70,50,20,-20,126200,126000,-1518,-11082,-7082
135.515984,5,843,845,-2,2,126200,126000,3091,-100191,-100591
135.515984,6,0,0,0,0,126200,126000,0,0,0
135.730314,0,241,341,-100,100,126200,126000,14791,126809,106809
135.730314,1,138,232,-94,94,126200,126000,9404,28196,9396
135.730314,2,1262,1255,7,-7,126200,126000,1758,-152058,-150658
135.730314,3,83,124,-41,41,126200,126000,1409,26491,18291
135.730314,4,70,50,20,-20,126200,126000,-1518,-11082,-7082
135.730314,5,843,845,-2,2,126200,126000,3091,-100191,-100591
135.730314,6,0,0,0,0,126200,126000,0,0,0
136.022762,0,241,341,-100,100,126100,126000,14791,126809,116809
136.022762,1,138,232,-94,94,126100,126000,9404,28196,18796
136.022762,2,1262,1265,-3,3,126100,126000,1632,-151932,-152232
136.022762,3,83,124,-41,41,126100,126000,1409,26491,22391
136.022762,4,70,50,20,-20,126100,126000,-1518,-11082,-9082
136.022762,5,853,845,8,-8,126100,126000,3343,-102443,-101643
136.022762,6,0,0,0,0,126100,126000,0,0,0
136.221041,0,241,341,-100,100,126200,126000,14791,126809,106809
136.221041,1,138,232,-94,94,126200,126000,9404,28196,9396
136.221041,2,1262,1275,-13,13,126200,126000,1506,-149806,-152406
136.221041,3,83,124,-41,41,126200,126000,1409,26491,18291
136.221041,4,70,50,20,-20,126200,126000,-1518,-11082,-7082
136.221041,5,853,845,8,-8,126200,126000,3343,-102443,-100843
136.221041,6,0,0,0,0,126200,126000,0,0,0
136.472783,0,241,341,-100,100,126200,126000,14791,126809,106809
136.472783,1,138,232,-94,94,126200,126000,9404,28196,9396
136.472783,2,1262,1275,-13,13,126200,126000,1506,-149806,-152406
136.472783,3,83,124,-41,41,126200,126000,1409,26491,18291
136.472783,4,70,50,20,-20,126200,126000,-1518,-11082,-7082
136.472783,5,853,845,8,-8,126200,126000,3343,-102443,-100843
136.472783,6,0,0,0,0,126200,126000,0,0,0
136.782714,0,241,341,-100,100,126200,126000,14791,126809,106809
136.782714,1,138,232,-94,94,126200,126000,9404,28196,9396
136.782714,2,1262,1275,-13,13,126200,126000,1506,-149806,-152406
136.782714,3,83,124,-41,41,126200,126000,1409,26491,18291
136.782714,4,70,50,20,-20,126200,126000,-1518,-11082,-7082
136.782714,5,853,845,8,-8,126200,126000,3343,-102443,-100843
136.782714,6,0,0,0,0,126200,126000,0,0,0
136.975229,0,241,341,-100,100,125600,126000,14791,126809,152009
136.975229,1,138,232,-94,94,125600,126000,9404,28196,51884
136.975229,2,1272,1275,-3,3,125600,126000,1380,-151680,-150924
136.975229,3,83,124,-41,41,125600,126000,1409,26491,36823
136.975229,4,80,50,30,-30,125600,126000,-1644,-11956,-19516
136.975229,5,863,845,18,-18,125600,126000,3217,-103317,-107853
136.975229,6,0,0,0,0,125600,126000,0,0,0
137.221624,0,241,341,-100,100,126200,125600,14791,126809,101709
137.221624,1,138,232,-94,94,126200,125600,9404,28196,4602
137.221624,2,1272,1285,-13,13,126200,125600,1254,-150554,-153817
137.221624,3,83,126,-43,43,126200,125600,1384,27116,16323
137.221624,4,80,50,30,-30,126200,125600,-1644,-11956,-4426
137.221624,5,863,845,18,-18,126200,125600,3217,-103317,-98799
137.221624,6,0,0,0,0,126200,125600,0,0,0
137.53241,0,241,341,-100,100,126000,125600,14791,126809,101709
137.53241,1,138,232,-94,94,126000,125600,9404,28196,4602
137.53241,2,1272,1295,-23,23,126000,125600,1128,-149428,-155201
137.53241,3,83,128,-45,45,126000,125600,1359,27541,16246
137.53241,4,80,50,30,-30,126000,125600,-1644,-11956,-4426
137.53241,5,863,845,18,-18,126000,125600,3217,-103317,-98799
137.53241,6,0,0,0,0,126000,125600,0,0,0
137.703473,0,241,341,-100,100,125600,125600,14791,126809,126809
137.703473,1,138,232,-94,94,125600,125600,9404,28196,28196
137.703473,2,1282,1296,-14,14,125600,125600,1027,-153027,-153027
137.703473,3,83,128,-45,45,125600,125600,1359,27541,27541
137.703473,4,80,50,30,-30,125600,125600,-1644,-11956,-11956
137.703473,5,873,845,28,-28,125600,125600,3091,-104191,-104191
137.703473,6,0,0,0,0,125600,125600,0,0,0
137.959001,0,241,341,-100,100,125600,125600,14791,126809,126809
137.959001,1,138,232,-94,94,125600,125600,9404,28196,28196
137.959001,2,1282,1296,-14,14,125600,125600,1027,-153027,-153027
137.959001,3,83,128,-45,45,125600,125600,1359,27541,27541
137.959001,4,80,50,30,-30,125600,125600,-1644,-11956,-11956
137.959001,5,873,845,28,-28,125600,125600,3091,-104191,-104191
137.959001,6,0,0,0,0,125600,125600,0,0,0
138.239433,0,241,341,-100,100,125900,125600,14791,126809,101709
138.239433,1,138,232,-94,94,125900,125600,9404,28196,4602
138.239433,2,1292,1296,-4,4,125900,125600,901,-154901,-155905
138.239433,3,83,128,-45,45,125900,125600,1359,27541,16246
138.239433,4,80,50,30,-30,125900,125600,-1644,-11956,-4426
138.239433,5,873,855,18,-18,125900,125600,3343,-104443,-99925
138.239433,6,0,0,0,0,125900,125600,0,0,0
138.488617,0,241,341,-100,100,125600,125600,14791,126809,126809
138.488617,1,138,232,-94,94,125600,125600,9404,28196,28196
138.488617,2,1292,1296,-4,4,125600,125600,901,-154901,-154901
138.488617,3,83,128,-45,45,125600,125600,1359,27541,27541
138.488617,4,80,50,30,-30,125600,125600,-1644,-11956,-11956
138.488617,5,873,865,8,-8,125600,125600,3594,-106694,-106694
138.488617,6,0,0,0,0,125600,125600,0,0,0
138.787842,0,241,341,-100,100,125600,125600,14791,126809,126809
138.787842,1,138,232,-94,94,125600,125600,9404,28196,28196
138.787842,2,1292,1296,-4,4,125600,125600,901,-154901,-154901
138.787842,3,83,128,-45,45,125600,125600,1359,27541,27541
138.787842,4,80,50,30,-30,125600,125600,-1644,-11956,-11956
138.787842,5,873,865,8,-8,125600,125600,3594,-106694,-106694
138.787842,6,0,0,0,0,125600,125600,0,0,0
138.955393,0,241,341,-100,100,125600,125600,14791,126809,126809
138.955393,1,138,232,-94,94,125600,125600,9404,28196,28196
138.955393,2,1292,1296,-4,4,125600,125600,901,-154901,-154901
138.955393,3,83,128,-45,45,125600,125600,1359,27541,27541
138.955393,4,80,50,30,-30,125600,125600,-1644,-11956,-11956
138.955393,5,873,865,8,-8,125600,125600,3594,-106694,-106694
138.955393,6,0,0,0,0,125600,125600,0,0,0
139.261381,0,241,341,-100,100,125600,125600,14791,126809,126809
139.261381,1,138,232,-94,94,125600,125600,9404,28196,28196
139.261381,2,1292,1296,-4,4,125600,125600,901,-154901,-154901
139.261381,3,83,128,-45,45,125600,125600,1359,27541,27541
139.261381,4,80,50,30,-30,125600,125600,-1644,-11956,-11956
139.261381,5,873,865,8,-8,125600,125600,3594,-106694,-106694
139.261381,6,0,0,0,0,125600,125600,0,0,0
139.524107,0,241,341,-100,100,126400,125600,14791,126809,101709
139.524107,1,138,232,-94,94,126400,125600,9404,28196,4602
139.524107,2,1292,1306,-14,14,126400,125600,775,-153775,-157289
139.524107,3,83,130,-47,47,126400,125600,1334,28166,16369
139.524107,4,80,50,30,-30,126400,125600,-1644,-11956,-4426
139.524107,5,873,875,-2,2,126400,125600,3468,-105568,-106070
139.524107,6,0,0,0,0,126400,125600,0,0,0
139.756743,0,241,341,-100,100,126400,125600,14791,126809,101709
139.756743,1,138,232,-94,94,126400,125600,9404,28196,4602
139.756743,2,1292,1306,-14,14,126400,125600,775,-153775,-157289
139.756743,3,83,130,-47,47,126400,125600,1334,28166,16369
139.756743,4,80,50,30,-30,126400,125600,-1644,-11956,-4426
139.756743,5,873,875,-2,2,126400,125600,3468,-105568,-106070
139.756743,6,0,0,0,0,126400,125600,0,0,0
140.006941,0,241,341,-100,100,126000,125600,14791,126809,101709
140.006941,1,138,232,-94,94,126000,125600,9404,28196,4602
140.006941,2,1302,1306,-4,4,126000,125600,649,-157649,-158653
140.006941,3,83,130,-47,47,126000,125600,1334,28166,16369
140.006941,4,80,50,30,-30,126000,125600,-1644,-11956,-4426
140.006941,5,873,885,-12,12,126000,125600,3720,-103820,-106832
140.006941,6,0,0,0,0,126000,125600,0,0,0
140.266331,0,241,341,-100,100,126000,125600,14791,126809,101709
140.266331,1,138,232,-94,94,126000,125600,9404,28196,4602
140.266331,2,1302,1306,-4,4,126000,125600,649,-157649,-158653
140.266331,3,83,130,-47,47,126000,125600,1334,28166,16369
140.266331,4,80,50,30,-30,126000,125600,-1644,-11956,-4426
140.266331,5,873,885,-12,12,126000,125600,3720,-103820,-106832
140.266331,6,0,0,0,0,126000,125600,0,0,0
140.45769,0,241,341,-100,100,126400,125600,14791,126809,101709
140.45769,1,138,232,-94,94,126400,125600,9404,28196,4602
140.45769,2,1312,1316,-4,4,126400,125600,397,-157397,-158401
140.45769,3,83,132,-49,49,126400,125600,1309,28791,16492
140.45769,4,80,50,30,-30,126400,125600,-1644,-11956,-4426
140.45769,5,883,895,-12,12,126400,125600,3468,-101568,-104580
140.45769,6,0,0,0,0,126400,125600,0,0,0
140.7467,0,241,341,-100,100,126400,125600,14791,126809,101709
140.7467,1,138,232,-94,94,126400,125600,9404,28196,4602
140.7467,2,1312,1316,-4,4,126400,125600,397,-157397,-158401
140.7467,3,83,132,-49,49,126400,125600,1309,28791,16492
140.7467,4,80,50,30,-30,126400,125600,-1644,-11956,-4426
140.7467,5,883,895,-12,12,126400,125600,3468,-101568,-104580
140.7467,6,0,0,0,0,126400,125600,0,0,0
141.047046,0,241,341,-100,100,125600,125600,14791,126809,126809
141.047046,1,138,232,-94,94,125600,125600,9404,28196,28196
141.047046,2,1322,1316,6,-6,125600,125600,271,-157271,-157271
141.047046,3,83,132,-49,49,125600,125600,1309,28791,28791
141.047046,4,80,50,30,-30,125600,125600,-1644,-11956,-11956
141.047046,5,893,895,-2,2,125600,125600,3342,-102442,-102442
141.047046,6,0,0,0,0,125600,125600,0,0,0
141.266434,0,241,341,-100,100,125600,125600,14791,126809,126809
141.266434,1,138,232,-94,94,125600,125600,9404,28196,28196
141.266434,2,1322,1316,6,-6,125600,125600,271,-157271,-157271
141.266434,3,83,132,-49,49,125600,125600,1309,28791,28791
141.266434,4,80,50,30,-30,125600,125600,-1644,-11956,-11956
141.266434,5,893,895,-2,2,125600,125600,3342,-102442,-102442
141.266434,6,0,0,0,0,125600,125600,0,0,0
141.516778,0,241,341,-100,100,125900,125600,14791,126809,101709
141.516778,1,138,232,-94,94,125900,125600,9404,28196,4602
141.516778,2,1322,1331,-9,9,125900,125600,82,-158082,-160341
141.516778,3,88,132,-44,44,125900,125600,1435,28165,17121
141.516778,4,80,50,30,-30,125900,125600,-1644,-11956,-4426
141.516778,5,903,895,8,-8,125900,125600,3594,-102694,-100686
141.516778,6,0,0,0,0,125900,125600,0,0,0
141.770271,0,241,341,-100,100,125900,125900,14791,126809,126809
141.770271,1,138,232,-94,94,125900,125900,9404,28196,28196
141.770271,2,1322,1331,-9,9,125900,125900,82,-158082,-158082
141.770271,3,88,132,-44,44,125900,125900,1435,28165,28165
141.770271,4,80,50,30,-30,125900,125900,-1644,-11956,-11956
141.770271,5,903,895,8,-8,125900,125900,3594,-102694,-102694
141.770271,6,0,0,0,0,125900,125900,0,0,0
142.019112,0,241,341,-100,100,126000,125900,14791,126809,116809
142.019112,1,138,232,-94,94,126000,125900,9404,28196,18796
142.019112,2,1328,1331,-3,3,126000,125900,233,-159433,-159733
142.019112,3,92,132,-40,40,126000,125900,1536,27264,23264
142.019112,4,80,50,30,-30,126000,125900,-1644,-11956,-8956
142.019112,5,903,905,-2,2,126000,125900,3468,-102568,-102768
142.019112,6,0,0,0,0,126000,125900,0,0,0
142.230462,0,241,341,-100,100,126000,125900,14791,126809,116809
142.230462,1,138,232,-94,94,126000,125900,9404,28196,18796
142.230462,2,1328,1331,-3,3,126000,125900,233,-159433,-159733
142.230462,3,92,132,-40,40,126000,125900,1536,27264,23264
142.230462,4,80,50,30,-30,126000,125900,-1644,-11956,-8956
142.230462,5,903,905,-2,2,126000,125900,3468,-102568,-102768
142.230462,6,0,0,0,0,126000,125900,0,0,0
142.52403,0,241,341,-100,100,126000,125900,14791,126809,116809
142.52403,1,138,232,-94,94,126000,125900,9404,28196,18796
142.52403,2,1328,1331,-3,3,126000,125900,233,-159433,-159733
142.52403,3,92,132,-40,40,126000,125900,1536,27264,23264
142.52403,4,80,50,30,-30,126000,125900,-1644,-11956,-8956
142.52403,5,903,905,-2,2,126000,125900,3468,-102568,-102768
142.52403,6,0,0,0,0,126000,125900,0,0,0
142.767614,0,241,341,-100,100,126000,125900,14791,126809,116809
142.767614,1,138,232,-94,94,126000,125900,9404,28196,18796
142.767614,2,1328,1331,-3,3,126000,125900,233,-159433,-159733
142.767614,3,92,132,-40,40,126000,125900,1536,27264,23264
142.767614,4,80,50,30,-30,126000,125900,-1644,-11956,-8956
142.767614,5,903,905,-2,2,126000,125900,3468,-102568,-102768
142.767614,6,0,0,0,0,126000,125900,0,0,0
143.040805,0,241,341,-100,100,126000,125900,14791,126809,116809
143.040805,1,138,232,-94,94,126000,125900,9404,28196,18796
143.040805,2,1328,1331,-3,3,126000,125900,233,-159433,-159733
143.040805,3,92,132,-40,40,126000,125900,1536,27264,23264
143.040805,4,80,50,30,-30,126000,125900,-1644,-11956,-8956
143.040805,5,903,905,-2,2,126000,125900,3468,-102568,-102768
143.040805,6,0,0,0,0,126000,125900,0,0,0
143.27811,0,241,341,-100,100,126000,125900,14791,126809,116809
143.27811,1,138,232,-94,94,126000,125900,9404,28196,18796
143.27811,2,1328,1331,-3,3,126000,125900,233,-159433,-159733
143.27811,3,92,132,-40,40,126000,125900,1536,27264,23264
143.27811,4,80,50,30,-30,126000,125900,-1644,-11956,-8956
143.27811,5,903,905,-2,2,126000,125900,3468,-102568,-102768
143.27811,6,0,0,0,0,126000,125900,0,0,0
143.520736,0,241,341,-100,100,126000,125900,14791,126809,116809
143.520736,1,138,232,-94,94,126000,125900,9404,28196,18796
143.520736,2,1328,1331,-3,3,126000,125900,233,-159433,-159733
143.520736,3,92,132,-40,40,126000,125900,1536,27264,23264
143.520736,4,80,50,30,-30,126000,125900,-1644,-11956,-8956
143.520736,5,903,905,-2,2,126000,125900,3468,-102568,-102768
143.520736,6,0,0,0,0,126000,125900,0,0,0
143.765285,0,241,341,-100,100,126000,125900,14791,126809,116809
143.765285,1,138,232,-94,94,126000,125900,9404,28196,18796
143.765285,2,1328,1331,-3,3,126000,125900,233,-159433,-159733
143.765285,3,92,132,-40,40,126000,125900,1536,27264,23264
143.765285,4,80,50,30,-30,126000,125900,-1644,-11956,-8956
143.765285,5,903,905,-2,2,126000,125900,3468,-102568,-102768
143.765285,6,0,0,0,0,126000,125900,0,0,0
143.972034,0,241,341,-100,100,126000,126200,14791,126809,146809
143.972034,1,138,232,-94,94,126000,126200,9404,28196,46996
143.972034,2,1330,1331,-1,1,126000,126200,208,-159208,-159008
143.972034,3,92,132,-40,40,126000,126200,1536,27264,35264
143.972034,4,80,50,30,-30,126000,126200,-1644,-11956,-17956
143.972034,5,903,905,-2,2,126000,126200,3468,-102568,-102168
143.972034,6,0,0,0,0,126000,126200,0,0,0
144.297881,0,241,341,-100,100,126400,126400,14791,126809,126809
144.297881,1,138,232,-94,94,126400,126400,9404,28196,28196
144.297881,2,1330,1351,-21,21,126400,126400,-45,-161155,-161155
144.297881,3,100,132,-32,32,126400,126400,1738,25462,25462
144.297881,4,80,50,30,-30,126400,126400,-1644,-11956,-11956
144.297881,5,913,910,3,-3,126400,126400,3657,-102757,-102757
144.297881,6,0,0,0,0,126400,126400,0,0,0
144.489673,0,241,341,-100,100,126600,126300,14791,126809,101509
144.489673,1,138,232,-94,94,126600,126300,9404,28196,4414
144.489673,2,1340,1351,-11,11,126600,126300,208,-163608,-166391
144.489673,3,106,132,-26,26,126600,126300,1890,23510,16932
144.489673,4,80,50,30,-30,126600,126300,-1644,-11956,-4366
144.489673,5,913,910,3,-3,126600,126300,3657,-102757,-101998
144.489673,6,0,0,0,0,126600,126300,0,0,0
144.731302,0,241,341,-100,100,126400,126200,14791,126809,106809
144.731302,1,138,232,-94,94,126400,126200,9404,28196,9396
144.731302,2,1350,1351,-1,1,126400,126200,461,-165861,-166061
144.731302,3,106,132,-26,26,126400,126200,1890,23510,18310
144.731302,4,80,50,30,-30,126400,126200,-1644,-11956,-5956
144.731302,5,913,920,-7,7,126400,126200,3531,-101631,-103031
144.731302,6,0,0,0,0,126400,126200,0,0,0
144.973551,0,241,341,-100,100,126400,126200,14791,126809,106809
144.973551,1,138,232,-94,94,126400,126200,9404,28196,9396
144.973551,2,1350,1351,-1,1,126400,126200,461,-165861,-166061
144.973551,3,106,132,-26,26,126400,126200,1890,23510,18310
144.973551,4,80,50,30,-30,126400,126200,-1644,-11956,-5956
144.973551,5,913,920,-7,7,126400,126200,3531,-101631,-103031
144.973551,6,0,0,0,0,126400,126200,0,0,0
145.228572,0,241,341,-100,100,126400,126200,14791,126809,106809
145.228572,1,138,232,-94,94,126400,126200,9404,28196,9396
145.228572,2,1350,1351,-1,1,126400,126200,461,-165861,-166061
145.228572,3,106,132,-26,26,126400,126200,1890,23510,18310
145.228572,4,80,50,30,-30,126400,126200,-1644,-11956,-5956
145.228572,5,913,920,-7,7,126400,126200,3531,-101631,-103031
145.228572,6,0,0,0,0,126400,126200,0,0,0
145.454538,0,241,341,-100,100,126400,126200,14791,126809,106809
145.454538,1,138,232,-94,94,126400,126200,9404,28196,9396
145.454538,2,1350,1351,-1,1,126400,126200,461,-165861,-166061
145.454538,3,106,132,-26,26,126400,126200,1890,23510,18310
145.454538,4,80,50,30,-30,126400,126200,-1644,-11956,-5956
145.454538,5,913,920,-7,7,126400,126200,3531,-101631,-103031
145.454538,6,0,0,0,0,126400,126200,0,0,0
145.753262,0,241,341,-100,100,126800,126200,14791,126809,101609
145.753262,1,138,232,-94,94,126800,126200,9404,28196,4508
145.753262,2,1350,1364,-14,14,126800,126200,296,-164696,-168224
145.753262,3,109,132,-23,23,126800,126200,1966,23134,17338
145.753262,4,80,50,30,-30,126800,126200,-1644,-11956,-4396
145.753262,5,913,930,-17,17,126800,126200,3404,-99504,-103788
145.753262,6,0,0,0,0,126800,126200,0,0,0
146.001402,0,241,341,-100,100,126800,126200,14791,126809,101609
146.001402,1,138,232,-94,94,126800,126200,9404,28196,4508
146.001402,2,1350,1364,-14,14,126800,126200,296,-164696,-168224
146.001402,3,109,132,-23,23,126800,126200,1966,23134,17338
146.001402,4,80,50,30,-30,126800,126200,-1644,-11956,-4396
146.001402,5,913,930,-17,17,126800,126200,3404,-99504,-103788
146.001402,6,0,0,0,0,126800,126200,0,0,0
146.248459,0,241,341,-100,100,126200,126200,14791,126809,126809
146.248459,1,138,232,-94,94,126200,126200,9404,28196,28196
146.248459,2,1360,1364,-4,4,126200,126200,169,-166569,-166569
146.248459,3,109,132,-23,23,126200,126200,1966,23134,23134
146.248459,4,80,50,30,-30,126200,126200,-1644,-11956,-11956
146.248459,5,923,930,-7,7,126200,126200,3278,-100378,-100378
146.248459,6,0,0,0,0,126200,126200,0,0,0
146.480484,0,241,341,-100,100,126600,126200,14791,126809,101609
146.480484,1,138,232,-94,94,126600,126200,9404,28196,4508
146.480484,2,1360,1374,-14,14,126600,126200,422,-165822,-169350
146.480484,3,109,132,-23,23,126600,126200,1966,23134,17338
146.480484,4,80,50,30,-30,126600,126200,-1644,-11956,-4396
146.480484,5,933,930,3,-3,126600,126200,3151,-102251,-101495
146.480484,6,0,0,0,0,126600,126200,0,0,0
146.77718,0,241,341,-100,100,126600,126400,14791,126809,106809
146.77718,1,138,232,-94,94,126600,126400,9404,28196,9396
146.77718,2,1360,1374,-14,14,126600,126400,422,-165822,-168622
146.77718,3,109,132,-23,23,126600,126400,1966,23134,18534
146.77718,4,80,50,30,-30,126600,126400,-1644,-11956,-5956
146.77718,5,933,930,3,-3,126600,126400,3151,-102251,-101651
146.77718,6,0,0,0,0,126600,126400,0,0,0
146.967008,0,241,341,-100,100,126600,126800,14791,126809,146809
146.967008,1,138,232,-94,94,126600,126800,9404,28196,46996
146.967008,2,1370,1374,-4,4,126600,126800,295,-166695,-165895
146.967008,3,109,132,-23,23,126600,126800,1966,23134,27734
146.967008,4,80,50,30,-30,126600,126800,-1644,-11956,-17956
146.967008,5,933,940,-7,7,126600,126800,3404,-102504,-101104
146.967008,6,0,0,0,0,126600,126800,0,0,0
147.214768,0,241,341,-100,100,127000,126900,14791,126809,116809
147.214768,1,138,232,-94,94,127000,126900,9404,28196,18796
147.214768,2,1375,1376,-1,1,127000,126900,397,-166797,-166897
147.214768,3,111,134,-23,23,127000,126900,1992,22308,20008
147.214768,4,80,50,30,-30,127000,126900,-1644,-11956,-8956
147.214768,5,933,940,-7,7,127000,126900,3404,-102504,-103204
147.214768,6,0,0,0,0,127000,126900,0,0,0
147.508755,0,241,341,-100,100,127100,127000,14791,126809,116809
147.508755,1,138,232,-94,94,127100,127000,9404,28196,18796
147.508755,2,1375,1376,-1,1,127100,127000,397,-166797,-166897
147.508755,3,113,134,-21,21,127100,127000,2043,21657,19557
147.508755,4,80,50,30,-30,127100,127000,-1644,-11956,-8956
147.508755,5,933,942,-9,9,127100,127000,3379,-102279,-103179
147.508755,6,0,0,0,0,127100,127000,0,0,0
147.733544,0,241,341,-100,100,127100,127000,14791,126809,116809
147.733544,1,138,232,-94,94,127100,127000,9404,28196,18796
147.733544,2,1381,1376,5,-5,127100,127000,550,-167550,-167050
147.733544,3,115,134,-19,19,127100,127000,2094,21406,19506
147.733544,4,80,50,30,-30,127100,127000,-1644,-11956,-8956
147.733544,5,933,950,-17,17,127100,127000,3278,-102178,-103878
147.733544,6,0,0,0,0,127100,127000,0,0,0
148.046807,0,241,341,-100,100,127100,127000,14791,126809,116809
148.046807,1,138,232,-94,94,127100,127000,9404,28196,18796
148.046807,2,1381,1376,5,-5,127100,127000,550,-167550,-167050
148.046807,3,115,134,-19,19,127100,127000,2094,21406,19506
148.046807,4,80,50,30,-30,127100,127000,-1644,-11956,-8956
148.046807,5,933,950,-17,17,127100,127000,3278,-102178,-103878
148.046807,6,0,0,0,0,127100,127000,0,0,0
148.288332,0,241,341,-100,100,127300,127000,14791,126809,101409
148.288332,1,138,232,-94,94,127300,127000,9404,28196,4320
148.288332,2,1381,1386,-5,5,127300,127000,423,-168423,-169693
148.288332,3,115,134,-19,19,127300,127000,2094,21406,16580
148.288332,4,80,50,30,-30,127300,127000,-1644,-11956,-4336
148.288332,5,933,950,-17,17,127300,127000,3278,-102178,-106496
148.288332,6,0,0,0,0,127300,127000,0,0,0
148.500906,0,241,341,-100,100,127300,127000,14791,126809,101409
148.500906,1,138,232,-94,94,127300,127000,9404,28196,4320
148.500906,2,1381,1386,-5,5,127300,127000,423,-168423,-169693
148.500906,3,115,134,-19,19,127300,127000,2094,21406,16580
148.500906,4,80,50,30,-30,127300,127000,-1644,-11956,-4336
148.500906,5,933,950,-17,17,127300,127000,3278,-102178,-106496
148.500906,6,0,0,0,0,127300,127000,0,0,0
148.797456,0,241,341,-100,100,126700,127000,14791,126809,152209
148.797456,1,138,232,-94,94,126700,127000,9404,28196,52072
148.797456,2,1391,1386,5,-5,126700,127000,296,-169296,-170566
148.797456,3,115,134,-19,19,126700,127000,2094,21406,26232
148.797456,4,80,50,30,-30,126700,127000,-1644,-11956,-19576
148.797456,5,943,950,-7,7,126700,127000,3151,-103051,-101273
148.797456,6,0,0,0,0,126700,127000,0,0,0
149.025416,0,241,341,-100,100,127200,127300,14791,126809,136809
149.025416,1,138,232,-94,94,127200,127300,9404,28196,37596
149.025416,2,1391,1396,-5,5,127200,127300,169,-173169,-172669
149.025416,3,115,134,-19,19,127200,127300,2094,21406,23306
149.025416,4,80,50,30,-30,127200,127300,-1644,-11956,-14956
149.025416,5,943,954,-11,11,127200,127300,3100,-103800,-102700
149.025416,6,0,0,0,0,127200,127300,0,0,0
149.276353,0,241,341,-100,100,127300,127400,14791,126809,136809
149.276353,1,138,232,-94,94,127300,127400,9404,28196,37596
149.276353,2,1401,1396,5,-5,127300,127400,424,-173424,-173924
149.276353,3,119,134,-15,15,127300,127400,2196,21304,22804
149.276353,4,80,50,30,-30,127300,127400,-1644,-11956,-14956
149.276353,5,953,954,-1,1,127300,127400,3355,-104055,-103955
149.276353,6,0,0,0,0,127300,127400,0,0,0
149.486529,0,241,341,-100,100,127300,127400,14791,126809,136809
149.486529,1,200,232,-32,32,127300,127400,10985,32815,36015
149.486529,2,1411,1396,15,-15,127300,127400,679,-172679,-174179
149.486529,3,123,134,-11,11,127300,127400,2298,21602,22702
149.486529,4,80,50,30,-30,127300,127400,-1644,-11956,-14956
149.486529,5,963,954,9,-9,127300,127400,3610,-103310,-104210
149.486529,6,0,0,0,0,127300,127400,0,0,0
149.724305,0,241,341,-100,100,127300,127400,14791,126809,136809
149.724305,1,200,232,-32,32,127300,127400,10985,32815,36015
149.724305,2,1411,1396,15,-15,127300,127400,679,-172679,-174179
149.724305,3,123,134,-11,11,127300,127400,2298,21602,22702
149.724305,4,80,50,30,-30,127300,127400,-1644,-11956,-14956
149.724305,5,963,954,9,-9,127300,127400,3610,-103310,-104210
149.724305,6,0,0,0,0,127300,127400,0,0,0
149.995494,0,241,341,-100,100,127300,127400,14791,126809,136809
149.995494,1,200,232,-32,32,127300,127400,10985,32815,36015
149.995494,2,1411,1406,5,-5,127300,127400,934,-173934,-174434
149.995494,3,123,134,-11,11,127300,127400,2298,21602,22702
149.995494,4,80,50,30,-30,127300,127400,-1644,-11956,-14956
149.995494,5,973,954,19,-19,127300,127400,3483,-103183,-105083
149.995494,6,0,0,0,0,127300,127400,0,0,0
150.246656,0,241,341,-100,100,126800,127400,14791,126809,152309
150.246656,1,200,232,-32,32,126800,127400,10985,32815,40975
150.246656,2,1421,1406,15,-15,126800,127400,807,-172807,-176632
150.246656,3,125,134,-9,9,126800,127400,2273,22427,24722
150.246656,4,80,50,30,-30,126800,127400,-1644,-11956,-19606
150.246656,5,983,954,29,-29,126800,127400,3356,-100056,-107451
150.246656,6,0,0,0,0,126800,127400,0,0,0
150.477024,0,241,341,-100,100,127400,127400,14791,126809,126809
150.477024,1,200,232,-32,32,127400,127400,10985,32815,32815
150.477024,2,1421,1408,13,-13,127400,127400,782,-172982,-172982
150.477024,3,127,134,-7,7,127400,127400,2324,22376,22376
150.477024,4,80,50,30,-30,127400,127400,-1644,-11956,-11956
150.477024,5,983,954,29,-29,127400,127400,3356,-100056,-100056
150.477024,6,0,0,0,0,127400,127400,0,0,0
150.753622,0,241,341,-100,100,127500,127400,14791,126809,116809
150.753622,1,200,232,-32,32,127500,127400,10985,32815,29615
150.753622,2,1431,1418,13,-13,127500,127400,528,-173728,-172428
150.753622,3,127,134,-7,7,127500,127400,2324,22376,21676
150.753622,4,80,50,30,-30,127500,127400,-1644,-11956,-8956
150.753622,5,983,964,19,-19,127500,127400,3611,-101311,-99411
150.753622,6,0,0,0,0,127500,127400,0,0,0
150.951869,0,241,341,-100,100,127500,127400,14791,126809,116809
150.951869,1,200,232,-32,32,127500,127400,10985,32815,29615
150.951869,2,1431,1418,13,-13,127500,127400,528,-173728,-172428
150.951869,3,127,134,-7,7,127500,127400,2324,22376,21676
150.951869,4,80,50,30,-30,127500,127400,-1644,-11956,-8956
150.951869,5,983,964,19,-19,127500,127400,3611,-101311,-99411
150.951869,6,0,0,0,0,127500,127400,0,0,0
151.221727,0,241,341,-100,100,127300,127300,14791,126809,126809
151.221727,1,200,232,-32,32,127300,127300,10985,32815,32815
151.221727,2,1431,1420,11,-11,127300,127300,503,-173903,-173903
151.221727,3,129,134,-5,5,127300,127300,2375,22325,22325
151.221727,4,80,50,30,-30,127300,127300,-1644,-11956,-11956
151.221727,5,983,964,19,-19,127300,127300,3611,-101311,-101311
151.221727,6,0,0,0,0,127300,127300,0,0,0
151.500927,0,241,341,-100,100,127300,127300,14791,126809,126809
151.500927,1,200,232,-32,32,127300,127300,10985,32815,32815
151.500927,2,1431,1420,11,-11,127300,127300,503,-173903,-173903
151.500927,3,129,134,-5,5,127300,127300,2375,22325,22325
151.500927,4,80,50,30,-30,127300,127300,-1644,-11956,-11956
151.500927,5,983,964,19,-19,127300,127300,3611,-101311,-101311
151.500927,6,0,0,0,0,127300,127300,0,0,0
151.799227,0,241,341,-100,100,126800,127400,14791,126809,152309
151.799227,1,200,232,-32,32,126800,127400,10985,32815,40975
151.799227,2,1441,1434,7,-7,126800,127400,580,-175380,-177165
151.799227,3,135,134,1,-1,126800,127400,2452,23048,22793
151.799227,4,80,50,30,-30,126800,127400,-1644,-11956,-19606
151.799227,5,993,974,19,-19,126800,127400,3738,-102438,-107283
151.799227,6,0,0,0,0,126800,127400,0,0,0
151.975027,0,241,341,-100,100,126800,127400,14791,126809,152309
151.975027,1,200,232,-32,32,126800,127400,10985,32815,40975
151.975027,2,1441,1434,7,-7,126800,127400,580,-175380,-177165
151.975027,3,135,134,1,-1,126800,127400,2452,23048,22793
151.975027,4,80,50,30,-30,126800,127400,-1644,-11956,-19606
151.975027,5,993,974,19,-19,126800,127400,3738,-102438,-107283
151.975027,6,0,0,0,0,126800,127400,0,0,0
152.231535,0,241,341,-100,100,127000,127600,14791,126809,152309
152.231535,1,200,232,-32,32,127000,127600,10985,32815,40975
152.231535,2,1451,1434,17,-17,127000,127600,453,-173253,-177588
152.231535,3,137,134,3,-3,127000,127600,2427,24073,23308
152.231535,4,80,50,30,-30,127000,127600,-1644,-11956,-19606
152.231535,5,1003,974,29,-29,127000,127600,3611,-98311,-105706
152.231535,6,0,0,0,0,127000,127600,0,0,0
152.471954,0,241,341,-100,100,127500,127700,14791,126809,146809
152.471954,1,235,232,3,-3,127500,127700,11878,38922,38322
152.471954,2,1461,1434,27,-27,127500,127700,708,-171508,-176908
152.471954,3,137,134,3,-3,127500,127700,2427,24073,23473
152.471954,4,80,50,30,-30,127500,127700,-1644,-11956,-17956
152.471954,5,1003,974,29,-29,127500,127700,3611,-98311,-104111
152.471954,6,0,0,0,0,127500,127700,0,0,0
152.723377,0,241,341,-100,100,127600,127700,14791,126809,136809
152.723377,1,235,232,3,-3,127600,127700,11878,38922,38622
152.723377,2,1461,1444,17,-17,127600,127700,580,-173380,-175080
152.723377,3,139,134,5,-5,127600,127700,2402,24698,24198
152.723377,4,80,50,30,-30,127600,127700,-1644,-11956,-14956
152.723377,5,1013,974,39,-39,127600,127700,3484,-95184,-99084
152.723377,6,0,0,0,0,127600,127700,0,0,0
153.027211,0,241,341,-100,100,127500,127700,14791,126809,146809
153.027211,1,235,232,3,-3,127500,127700,11878,38922,38322
153.027211,2,1471,1444,27,-27,127500,127700,835,-171635,-177035
153.027211,3,139,134,5,-5,127500,127700,2402,24698,23698
153.027211,4,80,50,30,-30,127500,127700,-1644,-11956,-17956
153.027211,5,1013,984,29,-29,127500,127700,3356,-98056,-103856
153.027211,6,0,0,0,0,127500,127700,0,0,0
153.239261,0,241,341,-100,100,127600,127700,14791,126809,136809
153.239261,1,325,232,93,-93,127600,127700,14173,45627,36327
153.239261,2,1471,1444,27,-27,127600,127700,835,-171635,-174335
153.239261,3,139,134,5,-5,127600,127700,2402,24698,24198
153.239261,4,80,50,30,-30,127600,127700,-1644,-11956,-14956
153.239261,5,1013,984,29,-29,127600,127700,3356,-98056,-100956
153.239261,6,0,0,0,0,127600,127700,0,0,0
153.459055,0,241,341,-100,100,127600,127700,14791,126809,136809
153.459055,1,325,232,93,-93,127600,127700,14173,45627,36327
153.459055,2,1471,1444,27,-27,127600,127700,835,-171635,-174335
153.459055,3,139,134,5,-5,127600,127700,2402,24698,24198
153.459055,4,80,50,30,-30,127600,127700,-1644,-11956,-14956
153.459055,5,1013,984,29,-29,127600,127700,3356,-98056,-100956
153.459055,6,0,0,0,0,127600,127700,0,0,0
153.776046,0,271,341,-70,70,127600,127700,15557,132043,139043
153.776046,1,325,232,93,-93,127600,127700,14173,45627,36327
153.776046,2,1481,1444,37,-37,127600,127700,1090,-169890,-173590
153.776046,3,141,134,7,-7,127600,127700,2453,25047,24347
153.776046,4,80,50,30,-30,127600,127700,-1644,-11956,-14956
153.776046,5,1013,984,29,-29,127600,127700,3356,-98056,-100956
153.776046,6,0,0,0,0,127600,127700,0,0,0
154.01557,0,271,341,-70,70,127500,127700,15557,132043,146043
154.01557,1,325,232,93,-93,127500,127700,14173,45627,27027
154.01557,2,1481,1454,27,-27,127500,127700,1345,-172145,-177545
154.01557,3,143,134,9,-9,127500,127700,2427,25273,23473
154.01557,4,80,50,30,-30,127500,127700,-1644,-11956,-17956
154.01557,5,1021,984,37,-37,127500,127700,3254,-97154,-104554
154.01557,6,0,0,0,0,127500,127700,0,0,0
154.21253,0,271,341,-70,70,127500,127700,15557,132043,146043
154.21253,1,325,232,93,-93,127500,127700,14173,45627,27027
154.21253,2,1481,1454,27,-27,127500,127700,1345,-172145,-177545
154.21253,3,143,134,9,-9,127500,127700,2427,25273,23473
154.21253,4,80,50,30,-30,127500,127700,-1644,-11956,-17956
154.21253,5,1021,984,37,-37,127500,127700,3254,-97154,-104554
154.21253,6,0,0,0,0,127500,127700,0,0,0
154.5379,0,271,341,-70,70,127500,127700,15557,132043,146043
154.5379,1,325,232,93,-93,127500,127700,14173,45627,27027
154.5379,2,1481,1454,27,-27,127500,127700,1345,-172145,-177545
154.5379,3,143,134,9,-9,127500,127700,2427,25273,23473
154.5379,4,80,50,30,-30,127500,127700,-1644,-11956,-17956
154.5379,5,1021,984,37,-37,127500,127700,3254,-97154,-104554
154.5379,6,0,0,0,0,127500,127700,0,0,0
154.795298,0,301,341,-40,40,127600,127700,16322,138278,142278
154.795298,1,325,232,93,-93,127600,127700,14173,45627,36327
154.795298,2,1491,1464,27,-27,127600,127700,1472,-175272,-177972
154.795298,3,143,134,9,-9,127600,127700,2427,25273,24373
154.795298,4,80,50,30,-30,127600,127700,-1644,-11956,-14956
154.795298,5,1021,984,37,-37,127600,127700,3254,-97154,-100854
154.795298,6,0,0,0,0,127600,127700,0,0,0
154.98936,0,331,341,-10,10,127700,127700,17088,144712,144712
154.98936,1,325,232,93,-93,127700,127700,14173,45627,45627
154.98936,2,1501,1464,37,-37,127700,127700,1727,-174527,-174527
154.98936,3,143,134,9,-9,127700,127700,2427,25273,25273
154.98936,4,80,50,30,-30,127700,127700,-1644,-11956,-11956
154.98936,5,1021,984,37,-37,127700,127700,3254,-97154,-97154
154.98936,6,0,0,0,0,127700,127700,0,0,0
155.269361,0,331,341,-10,10,127500,127800,17088,144712,147272
155.269361,1,325,232,93,-93,127500,127800,14173,45627,21819
155.269361,2,1501,1484,17,-17,127500,127800,1854,-179454,-183806
155.269361,3,145,134,11,-11,127500,127800,2401,25499,22683
155.269361,4,80,50,30,-30,127500,127800,-1644,-11956,-19636
155.269361,5,1029,984,45,-45,127500,127800,3152,-95452,-106972
155.269361,6,0,0,0,0,127500,127800,0,0,0
155.495999,0,331,341,-10,10,127500,127800,17088,144712,147272
155.495999,1,325,232,93,-93,127500,127800,14173,45627,21819
155.495999,2,1511,1484,27,-27,127500,127800,2109,-177709,-184621
155.495999,3,145,134,11,-11,127500,127800,2401,25499,22683
155.495999,4,80,50,30,-30,127500,127800,-1644,-11956,-19636
155.495999,5,1029,1004,25,-25,127500,127800,2896,-100196,-106596
155.495999,6,0,0,0,0,127500,127800,0,0,0
155.792727,0,331,341,-10,10,127200,127800,17088,144712,147272
155.792727,1,325,232,93,-93,127200,127800,14173,45627,21819
155.792727,2,1521,1494,27,-27,127200,127800,2236,-178836,-185748
155.792727,3,147,134,13,-13,127200,127800,2376,25924,22596
155.792727,4,80,50,30,-30,127200,127800,-1644,-11956,-19636
155.792727,5,1039,1004,35,-35,127200,127800,2768,-99068,-108028
155.792727,6,0,0,0,0,127200,127800,0,0,0
155.989215,0,331,341,-10,10,127200,127800,17088,144712,147272
155.989215,1,325,232,93,-93,127200,127800,14173,45627,21819
155.989215,2,1521,1494,27,-27,127200,127800,2236,-178836,-185748
155.989215,3,147,134,13,-13,127200,127800,2376,25924,22596
155.989215,4,80,50,30,-30,127200,127800,-1644,-11956,-19636
155.989215,5,1039,1004,35,-35,127200,127800,2768,-99068,-108028
155.989215,6,0,0,0,0,127200,127800,0,0,0
156.277709,0,331,341,-10,10,127200,127800,17088,144712,147272
156.277709,1,325,232,93,-93,127200,127800,14173,45627,21819
156.277709,2,1521,1494,27,-27,127200,127800,2236,-178836,-185748
156.277709,3,147,134,13,-13,127200,127800,2376,25924,22596
156.277709,4,80,50,30,-30,127200,127800,-1644,-11956,-19636
156.277709,5,1039,1004,35,-35,127200,127800,2768,-99068,-108028
156.277709,6,0,0,0,0,127200,127800,0,0,0
156.501442,0,331,341,-10,10,127200,127800,17088,144712,147272
156.501442,1,325,232,93,-93,127200,127800,14173,45627,21819
156.501442,2,1521,1494,27,-27,127200,127800,2236,-178836,-185748
156.501442,3,147,134,13,-13,127200,127800,2376,25924,22596
156.501442,4,80,50,30,-30,127200,127800,-1644,-11956,-19636
156.501442,5,1039,1004,35,-35,127200,127800,2768,-99068,-108028
156.501442,6,0,0,0,0,127200,127800,0,0,0
156.783896,0,331,341,-10,10,127200,127800,17088,144712,147272
156.783896,1,325,232,93,-93,127200,127800,14173,45627,21819
156.783896,2,1521,1494,27,-27,127200,127800,2236,-178836,-185748
156.783896,3,147,134,13,-13,127200,127800,2376,25924,22596
156.783896,4,80,50,30,-30,127200,127800,-1644,-11956,-19636
156.783896,5,1039,1004,35,-35,127200,127800,2768,-99068,-108028
156.783896,6,0,0,0,0,127200,127800,0,0,0
156.995585,0,331,341,-10,10,127200,127800,17088,144712,147272
156.995585,1,325,232,93,-93,127200,127800,14173,45627,21819
156.995585,2,1521,1494,27,-27,127200,127800,2236,-178836,-185748
156.995585,3,147,134,13,-13,127200,127800,2376,25924,22596
156.995585,4,80,50,30,-30,127200,127800,-1644,-11956,-19636
156.995585,5,1039,1004,35,-35,127200,127800,2768,-99068,-108028
156.995585,6,0,0,0,0,127200,127800,0,0,0
157.271465,0,331,341,-10,10,127200,127800,17088,144712,147272
157.271465,1,325,232,93,-93,127200,127800,14173,45627,21819
157.271465,2,1521,1494,27,-27,127200,127800,2236,-178836,-185748
157.271465,3,147,134,13,-13,127200,127800,2376,25924,22596
157.271465,4,80,50,30,-30,127200,127800,-1644,-11956,-19636
157.271465,5,1039,1004,35,-35,127200,127800,2768,-99068,-108028
157.271465,6,0,0,0,0,127200,127800,0,0,0
157.493004,0,341,341,0,0,127300,127800,17343,145457,145457
157.493004,1,325,232,93,-93,127300,127800,14173,45627,21819
157.493004,2,1521,1504,17,-17,127300,127800,2109,-181709,-186061
157.493004,3,147,134,13,-13,127300,127800,2376,25924,22596
157.493004,4,80,50,30,-30,127300,127800,-1644,-11956,-19636
157.493004,5,1039,1004,35,-35,127300,127800,2768,-99068,-108028
157.493004,6,0,0,0,0,127300,127800,0,0,0
157.737857,0,351,341,10,-10,127500,127800,17598,147202,144642
157.737857,1,325,232,93,-93,127500,127800,14173,45627,21819
157.737857,2,1531,1514,17,-17,127500,127800,2237,-183837,-188189
157.737857,3,147,134,13,-13,127500,127800,2376,25924,22596
157.737857,4,80,50,30,-30,127500,127800,-1644,-11956,-19636
157.737857,5,1039,1014,25,-25,127500,127800,2640,-100940,-107340
157.737857,6,0,0,0,0,127500,127800,0,0,0
157.978048,0,351,341,10,-10,127500,127800,17598,147202,144642
157.978048,1,325,232,93,-93,127500,127800,14173,45627,21819
157.978048,2,1531,1514,17,-17,127500,127800,2237,-183837,-188189
157.978048,3,147,134,13,-13,127500,127800,2376,25924,22596
157.978048,4,80,50,30,-30,127500,127800,-1644,-11956,-19636
157.978048,5,1039,1014,25,-25,127500,127800,2640,-100940,-107340
157.978048,6,0,0,0,0,127500,127800,0,0,0
158.299239,0,351,341,10,-10,127500,127600,17598,147202,146202
158.299239,1,325,232,93,-93,127500,127600,14173,45627,36327
158.299239,2,1531,1514,17,-17,127500,127600,2237,-183837,-185537
158.299239,3,147,134,13,-13,127500,127600,2376,25924,24624
158.299239,4,80,50,30,-30,127500,127600,-1644,-11956,-14956
158.299239,5,1039,1014,25,-25,127500,127600,2640,-100940,-103440
158.299239,6,0,0,0,0,127500,127600,0,0,0
158.538311,0,351,341,10,-10,127900,127600,17598,147202,149752
158.538311,1,325,232,93,-93,127900,127600,14173,45627,69342
158.538311,2,1531,1524,7,-7,127900,127600,2109,-184709,-182924
158.538311,3,147,134,13,-13,127900,127600,2376,25924,29239
158.538311,4,80,50,30,-30,127900,127600,-1644,-11956,-4306
158.538311,5,1039,1014,25,-25,127900,127600,2640,-100940,-94565
158.538311,6,0,0,0,0,127900,127600,0,0,0
158.743314,0,351,345,6,-6,127200,127600,17700,147900,146370
158.743314,1,325,232,93,-93,127200,127600,14173,45627,21912
158.743314,2,1541,1524,17,-17,127200,127600,1981,-184581,-188916
158.743314,3,147,136,11,-11,127200,127600,2427,25673,22868
158.743314,4,80,50,30,-30,127200,127600,-1644,-11956,-19606
158.743314,5,1049,1014,35,-35,127200,127600,2512,-99812,-108737
158.743314,6,0,0,0,0,127200,127600,0,0,0
158.957029,0,351,345,6,-6,128000,127600,17700,147900,149430
158.957029,1,325,232,93,-93,128000,127600,14173,45627,69342
158.957029,2,1541,1534,7,-7,128000,127600,1853,-184453,-182668
158.957029,3,147,136,11,-11,128000,127600,2427,25673,28478
158.957029,4,80,50,30,-30,128000,127600,-1644,-11956,-4306
158.957029,5,1049,1014,35,-35,128000,127600,2512,-99812,-90887
158.957029,6,0,0,0,0,128000,127600,0,0,0
159.299182,0,351,345,6,-6,128000,127600,17700,147900,149430
159.299182,1,325,232,93,-93,128000,127600,14173,45627,69342
159.299182,2,1541,1534,7,-7,128000,127600,1853,-184453,-182668
159.299182,3,147,136,11,-11,128000,127600,2427,25673,28478
159.299182,4,80,50,30,-30,128000,127600,-1644,-11956,-4306
159.299182,5,1049,1014,35,-35,128000,127600,2512,-99812,-90887
159.299182,6,0,0,0,0,128000,127600,0,0,0
159.518107,0,351,345,6,-6,128000,127600,17700,147900,149430
159.518107,1,325,232,93,-93,128000,127600,14173,45627,69342
159.518107,2,1541,1534,7,-7,128000,127600,1853,-184453,-182668
159.518107,3,147,136,11,-11,128000,127600,2427,25673,28478
159.518107,4,80,50,30,-30,128000,127600,-1644,-11956,-4306
159.518107,5,1049,1014,35,-35,128000,127600,2512,-99812,-90887
159.518107,6,0,0,0,0,128000,127600,0,0,0
159.783593,0,351,345,6,-6,128000,127600,17700,147900,149430
159.783593,1,325,232,93,-93,128000,127600,14173,45627,69342
159.783593,2,1541,1534,7,-7,128000,127600,1853,-184453,-182668
159.783593,3,147,136,11,-11,128000,127600,2427,25673,28478
159.783593,4,80,50,30,-30,128000,127600,-1644,-11956,-4306
159.783593,5,1049,1014,35,-35,128000,127600,2512,-99812,-90887
159.783593,6,0,0,0,0,128000,127600,0,0,0
159.969591,0,351,345,6,-6,128000,127600,17700,147900,149430
159.969591,1,325,232,93,-93,128000,127600,14173,45627,69342
159.969591,2,1541,1534,7,-7,128000,127600,1853,-184453,-182668
159.969591,3,147,136,11,-11,128000,127600,2427,25673,28478
159.969591,4,80,50,30,-30,128000,127600,-1644,-11956,-4306
159.969591,5,1049,1014,35,-35,128000,127600,2512,-99812,-90887
159.969591,6,0,0,0,0,128000,127600,0,0,0
160.212474,0,351,345,6,-6,128000,127300,17700,147900,149430
160.212474,1,325,232,93,-93,128000,127300,14173,45627,69342
160.212474,2,1541,1534,7,-7,128000,127300,1853,-184453,-182668
160.212474,3,147,136,11,-11,128000,127300,2427,25673,28478
160.212474,4,80,50,30,-30,128000,127300,-1644,-11956,-4306
160.212474,5,1049,1014,35,-35,128000,127300,2512,-99812,-90887
160.212474,6,0,0,0,0,128000,127300,0,0,0
160.549339,0,351,355,-4,4,127200,127400,17955,149645,150445
160.549339,1,325,232,93,-93,127200,127400,14173,45627,27027
160.549339,2,1551,1534,17,-17,127200,127400,1725,-187325,-190725
160.549339,3,147,138,9,-9,127200,127400,2478,25422,23622
160.549339,4,80,50,30,-30,127200,127400,-1644,-11956,-17956
160.549339,5,1049,1014,35,-35,127200,127400,2512,-99812,-106812
160.549339,6,0,0,0,0,127200,127400,0,0,0
160.761572,0,351,355,-4,4,126900,127400,17955,149645,150665
160.761572,1,325,232,93,-93,126900,127400,14173,45627,21912
160.761572,2,1561,1534,27,-27,126900,127400,1598,-184198,-191083
160.761572,3,149,140,9,-9,126900,127400,2504,25796,23501
160.761572,4,80,50,30,-30,126900,127400,-1644,-11956,-19606
160.761572,5,1059,1014,45,-45,126900,127400,2385,-94685,-106160
160.761572,6,0,0,0,0,126900,127400,0,0,0
160.974944,0,361,355,6,-6,127300,127400,18210,151390,150790
160.974944,1,325,232,93,-93,127300,127400,14173,45627,36327
160.974944,2,1561,1534,27,-27,127300,127400,1598,-184198,-186898
160.974944,3,149,140,9,-9,127300,127400,2504,25796,24896
160.974944,4,80,50,30,-30,127300,127400,-1644,-11956,-14956
160.974944,5,1059,1024,35,-35,127300,127400,2258,-98558,-102058
160.974944,6,0,0,0,0,127300,127400,0,0,0
161.220724,0,361,355,6,-6,127400,127400,18210,151390,151390
161.220724,1,325,232,93,-93,127400,127400,14173,45627,45627
161.220724,2,1561,1544,17,-17,127400,127400,1471,-187071,-187071
161.220724,3,149,140,9,-9,127400,127400,2504,25796,25796
161.220724,4,80,50,30,-30,127400,127400,-1644,-11956,-11956
161.220724,5,1059,1034,25,-25,127400,127400,2131,-101431,-101431
161.220724,6,0,0,0,0,127400,127400,0,0,0
161.477256,0,361,355,6,-6,127400,127400,18210,151390,151390
161.477256,1,325,232,93,-93,127400,127400,14173,45627,45627
161.477256,2,1561,1544,17,-17,127400,127400,1471,-187071,-187071
161.477256,3,149,140,9,-9,127400,127400,2504,25796,25796
161.477256,4,80,50,30,-30,127400,127400,-1644,-11956,-11956
161.477256,5,1059,1034,25,-25,127400,127400,2131,-101431,-101431
161.477256,6,0,0,0,0,127400,127400,0,0,0
161.741817,0,361,355,6,-6,127400,127400,18210,151390,151390
161.741817,1,325,232,93,-93,127400,127400,14173,45627,45627
161.741817,2,1561,1544,17,-17,127400,127400,1471,-187071,-187071
161.741817,3,149,140,9,-9,127400,127400,2504,25796,25796
161.741817,4,80,50,30,-30,127400,127400,-1644,-11956,-11956
161.741817,5,1059,1034,25,-25,127400,127400,2131,-101431,-101431
161.741817,6,0,0,0,0,127400,127400,0,0,0
161.991472,0,361,355,6,-6,127400,127700,18210,151390,149860
161.991472,1,325,232,93,-93,127400,127700,14173,45627,21912
161.991472,2,1561,1544,17,-17,127400,127700,1471,-187071,-191406
161.991472,3,149,140,9,-9,127400,127700,2504,25796,23501
161.991472,4,80,50,30,-30,127400,127700,-1644,-11956,-19606
161.991472,5,1059,1034,25,-25,127400,127700,2131,-101431,-107806
161.991472,6,0,0,0,0,127400,127700,0,0,0
162.201777,0,361,355,6,-6,127600,127700,18210,151390,150790
162.201777,1,325,232,93,-93,127600,127700,14173,45627,36327
162.201777,2,1571,1544,27,-27,127600,127700,1726,-186326,-189026
162.201777,3,149,140,9,-9,127600,127700,2504,25796,24896
162.201777,4,80,50,30,-30,127600,127700,-1644,-11956,-14956
162.201777,5,1059,1034,25,-25,127600,127700,2131,-101431,-103931
162.201777,6,0,0,0,0,127600,127700,0,0,0
162.456679,0,391,355,36,-36,127600,128000,18976,159624,150408
162.456679,1,325,232,93,-93,127600,128000,14173,45627,21819
162.456679,2,1581,1544,37,-37,127600,128000,1981,-183581,-193053
162.456679,3,151,140,11,-11,127600,128000,2555,26345,23529
162.456679,4,80,50,30,-30,127600,128000,-1644,-11956,-19636
162.456679,5,1059,1034,25,-25,127600,128000,2131,-101431,-107831
162.456679,6,0,0,0,0,127600,128000,0,0,0
162.702737,0,391,355,36,-36,127600,128000,18976,159624,150408
162.702737,1,325,232,93,-93,127600,128000,14173,45627,21819
162.702737,2,1589,1544,45,-45,127600,128000,2185,-180585,-192105
162.702737,3,151,140,11,-11,127600,128000,2555,26345,23529
162.702737,4,80,50,30,-30,127600,128000,-1644,-11956,-19636
162.702737,5,1069,1034,35,-35,127600,128000,2386,-97686,-106646
162.702737,6,0,0,0,0,127600,128000,0,0,0
162.959003,0,391,355,36,-36,127600,128000,18976,159624,150408
162.959003,1,325,232,93,-93,127600,128000,14173,45627,21819
162.959003,2,1589,1554,35,-35,127600,128000,2134,-184334,-193294
162.959003,3,153,140,13,-13,127600,128000,2529,26771,23443
162.959003,4,80,50,30,-30,127600,128000,-1644,-11956,-19636
162.959003,5,1077,1034,43,-43,127600,128000,2590,-95490,-106498
162.959003,6,0,0,0,0,127600,128000,0,0,0
163.274915,0,391,355,36,-36,127600,128000,18976,159624,150408
163.274915,1,325,232,93,-93,127600,128000,14173,45627,21819
163.274915,2,1589,1554,35,-35,127600,128000,2134,-184334,-193294
163.274915,3,153,140,13,-13,127600,128000,2529,26771,23443
163.274915,4,80,50,30,-30,127600,128000,-1644,-11956,-19636
163.274915,5,1077,1034,43,-43,127600,128000,2590,-95490,-106498
163.274915,6,0,0,0,0,127600,128000,0,0,0
163.50535,0,391,355,36,-36,127600,128000,18976,159624,150408
163.50535,1,325,232,93,-93,127600,128000,14173,45627,21819
163.50535,2,1589,1554,35,-35,127600,128000,2134,-184334,-193294
163.50535,3,153,140,13,-13,127600,128000,2529,26771,23443
163.50535,4,80,50,30,-30,127600,128000,-1644,-11956,-19636
163.50535,5,1077,1034,43,-43,127600,128000,2590,-95490,-106498
163.50535,6,0,0,0,0,127600,128000,0,0,0
163.724053,0,391,355,36,-36,127800,128000,18976,159624,152424
163.724053,1,325,232,93,-93,127800,128000,14173,45627,27027
163.724053,2,1589,1554,35,-35,127800,128000,2134,-184334,-191334
163.724053,3,155,140,15,-15,127800,128000,2580,27320,24320
163.724053,4,80,50,30,-30,127800,128000,-1644,-11956,-17956
163.724053,5,1077,1034,43,-43,127800,128000,2590,-95490,-104090
163.724053,6,0,0,0,0,127800,128000,0,0,0
163.98781,0,421,355,66,-66,127800,128000,19743,164857,151657
163.98781,1,325,232,93,-93,127800,128000,14173,45627,27027
163.98781,2,1609,1554,55,-55,127800,128000,2262,-179462,-190462
163.98781,3,159,140,19,-19,127800,128000,2605,28295,24495
163.98781,4,80,50,30,-30,127800,128000,-1644,-11956,-17956
163.98781,5,1077,1035,42,-42,127800,128000,2577,-95877,-104277
163.98781,6,0,0,0,0,127800,128000,0,0,0
164.23186,0,430,355,75,-75,127600,128000,19973,166427,147227
164.23186,1,325,232,93,-93,127600,128000,14173,45627,21819
164.23186,2,1609,1564,45,-45,127600,128000,2517,-185717,-197237
164.23186,3,159,140,19,-19,127600,128000,2605,28295,23431
164.23186,4,80,50,30,-30,127600,128000,-1644,-11956,-19636
164.23186,5,1087,1044,43,-43,127600,128000,2334,-95234,-106242
164.23186,6,0,0,0,0,127600,128000,0,0,0
164.482226,0,455,355,100,-100,127900,128000,20613,170887,160887
164.482226,1,325,232,93,-93,127900,128000,14173,45627,36327
164.482226,2,1609,1564,45,-45,127900,128000,2517,-185717,-190217
164.482226,3,159,140,19,-19,127900,128000,2605,28295,26395
164.482226,4,80,50,30,-30,127900,128000,-1644,-11956,-14956
164.482226,5,1087,1045,42,-42,127900,128000,2321,-95721,-99921
164.482226,6,0,0,0,0,127900,128000,0,0,0
164.800093,0,455,355,100,-100,127900,128000,20613,170887,160887
164.800093,1,325,232,93,-93,127900,128000,14173,45627,36327
164.800093,2,1609,1564,45,-45,127900,128000,2517,-185717,-190217
164.800093,3,159,140,19,-19,127900,128000,2605,28295,26395
164.800093,4,80,50,30,-30,127900,128000,-1644,-11956,-14956
164.800093,5,1087,1045,42,-42,127900,128000,2321,-95721,-99921
164.800093,6,0,0,0,0,127900,128000,0,0,0
165.03366,0,455,355,100,-100,127700,128000,20613,170887,145287
165.03366,1,325,232,93,-93,127700,128000,14173,45627,21819
165.03366,2,1617,1564,53,-53,127700,128000,2415,-183215,-196783
165.03366,3,163,140,23,-23,127700,128000,2630,29070,23182
165.03366,4,80,50,30,-30,127700,128000,-1644,-11956,-19636
165.03366,5,1087,1045,42,-42,127700,128000,2321,-95721,-106473
165.03366,6,0,0,0,0,127700,128000,0,0,0
165.232493,0,455,355,100,-100,127700,128000,20613,170887,145287
165.232493,1,325,232,93,-93,127700,128000,14173,45627,21819
165.232493,2,1617,1566,51,-51,127700,128000,2389,-184189,-197245
165.232493,3,165,140,25,-25,127700,128000,2681,29619,23219
165.232493,4,80,50,30,-30,127700,128000,-1644,-11956,-19636
165.232493,5,1087,1045,42,-42,127700,128000,2321,-95721,-106473
165.232493,6,0,0,0,0,127700,128000,0,0,0
165.479253,0,455,355,100,-100,127700,128000,20613,170887,145287
165.479253,1,325,232,93,-93,127700,128000,14173,45627,21819
165.479253,2,1617,1568,49,-49,127700,128000,2363,-185163,-197707
165.479253,3,167,140,27,-27,127700,128000,2732,30168,23256
165.479253,4,80,50,30,-30,127700,128000,-1644,-11956,-19636
165.479253,5,1087,1045,42,-42,127700,128000,2321,-95721,-106473
165.479253,6,0,0,0,0,127700,128000,0,0,0
165.764061,0,455,355,100,-100,127900,128000,20613,170887,160887
165.764061,1,325,232,93,-93,127900,128000,14173,45627,36327
165.764061,2,1617,1578,39,-39,127900,128000,2235,-189035,-192935
165.764061,3,167,140,27,-27,127900,128000,2732,30168,27468
165.764061,4,80,50,30,-30,127900,128000,-1644,-11956,-14956
165.764061,5,1087,1048,39,-39,127900,128000,2283,-96583,-100483
165.764061,6,0,0,0,0,127900,128000,0,0,0
165.991817,0,455,355,100,-100,127900,128000,20613,170887,160887
165.991817,1,325,232,93,-93,127900,128000,14173,45627,36327
165.991817,2,1617,1578,39,-39,127900,128000,2235,-189035,-192935
165.991817,3,167,140,27,-27,127900,128000,2732,30168,27468
165.991817,4,80,50,30,-30,127900,128000,-1644,-11956,-14956
165.991817,5,1087,1048,39,-39,127900,128000,2283,-96583,-100483
165.991817,6,0,0,0,0,127900,128000,0,0,0
166.212002,0,455,355,100,-100,127900,128000,20613,170887,160887
166.212002,1,325,232,93,-93,127900,128000,14173,45627,36327
166.212002,2,1617,1578,39,-39,127900,128000,2235,-189035,-192935
166.212002,3,167,140,27,-27,127900,128000,2732,30168,27468
166.212002,4,80,50,30,-30,127900,128000,-1644,-11956,-14956
166.212002,5,1087,1048,39,-39,127900,128000,2283,-96583,-100483
166.212002,6,0,0,0,0,127900,128000,0,0,0
166.535173,0,455,355,100,-100,127800,128000,20613,170887,150887
166.535173,1,325,232,93,-93,127800,128000,14173,45627,27027
166.535173,2,1617,1588,29,-29,127800,128000,2491,-192291,-198091
166.535173,3,167,140,27,-27,127800,128000,2732,30168,24768
166.535173,4,80,50,30,-30,127800,128000,-1644,-11956,-17956
166.535173,5,1097,1048,49,-49,127800,128000,2155,-94455,-104255
166.535173,6,0,0,0,0,127800,128000,0,0,0
166.769861,0,455,355,100,-100,127800,128000,20613,170887,150887
166.769861,1,325,232,93,-93,127800,128000,14173,45627,27027
166.769861,2,1617,1588,29,-29,127800,128000,2491,-192291,-198091
166.769861,3,167,140,27,-27,127800,128000,2732,30168,24768
166.769861,4,80,50,30,-30,127800,128000,-1644,-11956,-17956
166.769861,5,1097,1048,49,-49,127800,128000,2155,-94455,-104255
166.769861,6,0,0,0,0,127800,128000,0,0,0
167.02749,0,455,355,100,-100,127800,128000,20613,170887,150887
167.02749,1,325,232,93,-93,127800,128000,14173,45627,27027
167.02749,2,1617,1588,29,-29,127800,128000,2491,-192291,-198091
167.02749,3,167,140,27,-27,127800,128000,2732,30168,24768
167.02749,4,80,50,30,-30,127800,128000,-1644,-11956,-17956
167.02749,5,1097,1048,49,-49,127800,128000,2155,-94455,-104255
167.02749,6,0,0,0,0,127800,128000,0,0,0
167.290757,0,455,355,100,-100,127800,128000,20613,170887,150887
167.290757,1,325,232,93,-93,127800,128000,14173,45627,27027
167.290757,2,1617,1588,29,-29,127800,128000,2491,-192291,-198091
167.290757,3,167,140,27,-27,127800,128000,2732,30168,24768
167.290757,4,80,50,30,-30,127800,128000,-1644,-11956,-17956
167.290757,5,1097,1048,49,-49,127800,128000,2155,-94455,-104255
167.290757,6,0,0,0,0,127800,128000,0,0,0
167.522269,0,455,355,100,-100,127800,128000,20613,170887,150887
167.522269,1,325,232,93,-93,127800,128000,14173,45627,27027
167.522269,2,1617,1598,19,-19,127800,128000,2747,-193547,-197347
167.522269,3,167,140,27,-27,127800,128000,2732,30168,24768
167.522269,4,80,50,30,-30,127800,128000,-1644,-11956,-17956
167.522269,5,1097,1048,49,-49,127800,128000,2155,-94455,-104255
167.522269,6,0,0,0,0,127800,128000,0,0,0
167.774538,0,455,355,100,-100,127800,127700,20613,170887,180887
167.774538,1,325,232,93,-93,127800,127700,14173,45627,54927
167.774538,2,1617,1608,9,-9,127800,127700,3003,-194803,-193903
167.774538,3,167,140,27,-27,127800,127700,2732,30168,32868
167.774538,4,80,50,30,-30,127800,127700,-1644,-11956,-8956
167.774538,5,1097,1048,49,-49,127800,127700,2155,-94455,-89555
167.774538,6,0,0,0,0,127800,127700,0,0,0
167.987802,0,455,355,100,-100,127800,127700,20613,170887,180887
167.987802,1,325,232,93,-93,127800,127700,14173,45627,54927
167.987802,2,1617,1618,-1,1,127800,127700,3259,-195059,-195159
167.987802,3,167,142,25,-25,127800,127700,2783,30117,32617
167.987802,4,80,50,30,-30,127800,127700,-1644,-11956,-8956
167.987802,5,1097,1048,49,-49,127800,127700,2155,-94455,-89555
167.987802,6,0,0,0,0,127800,127700,0,0,0
168.256501,0,455,355,100,-100,127800,127700,20613,170887,180887
168.256501,1,325,232,93,-93,127800,127700,14173,45627,54927
168.256501,2,1617,1618,-1,1,127800,127700,3259,-195059,-195159
168.256501,3,167,142,25,-25,127800,127700,2783,30117,32617
168.256501,4,80,50,30,-30,127800,127700,-1644,-11956,-8956
168.256501,5,1097,1048,49,-49,127800,127700,2155,-94455,-89555
168.256501,6,0,0,0,0,127800,127700,0,0,0
168.470172,0,455,355,100,-100,127800,127700,20613,170887,180887
168.470172,1,325,232,93,-93,127800,127700,14173,45627,54927
168.470172,2,1617,1618,-1,1,127800,127700,3259,-195059,-195159
168.470172,3,167,142,25,-25,127800,127700,2783,30117,32617
168.470172,4,80,50,30,-30,127800,127700,-1644,-11956,-8956
168.470172,5,1097,1048,49,-49,127800,127700,2155,-94455,-89555
168.470172,6,0,0,0,0,127800,127700,0,0,0
168.717736,0,455,355,100,-100,127800,127800,20613,170887,170887
168.717736,1,325,232,93,-93,127800,127800,14173,45627,45627
168.717736,2,1617,1618,-1,1,127800,127800,3259,-195059,-195059
168.717736,3,167,142,25,-25,127800,127800,2783,30117,30117
168.717736,4,80,50,30,-30,127800,127800,-1644,-11956,-11956
168.717736,5,1097,1048,49,-49,127800,127800,2155,-94455,-94455
168.717736,6,0,0,0,0,127800,127800,0,0,0
169.016508,0,455,355,100,-100,127800,127800,20613,170887,170887
169.016508,1,325,232,93,-93,127800,127800,14173,45627,45627
169.016508,2,1617,1618,-1,1,127800,127800,3259,-195059,-195059
169.016508,3,167,142,25,-25,127800,127800,2783,30117,30117
169.016508,4,80,50,30,-30,127800,127800,-1644,-11956,-11956
169.016508,5,1097,1048,49,-49,127800,127800,2155,-94455,-94455
169.016508,6,0,0,0,0,127800,127800,0,0,0
169.281429,0,455,355,100,-100,128000,127800,20613,170887,190887
169.281429,1,325,232,93,-93,128000,127800,14173,45627,64227
169.281429,2,1627,1618,9,-9,128000,127800,3515,-195915,-194115
169.281429,3,167,142,25,-25,128000,127800,2783,30117,35117
169.281429,4,80,50,30,-30,128000,127800,-1644,-11956,-5956
169.281429,5,1097,1058,39,-39,128000,127800,2143,-96443,-88643
169.281429,6,0,0,0,0,128000,127800,0,0,0
169.467505,0,455,355,100,-100,127800,127800,20613,170887,170887
169.467505,1,325,232,93,-93,127800,127800,14173,45627,45627
169.467505,2,1637,1618,19,-19,127800,127800,3771,-196171,-196171
169.467505,3,167,142,25,-25,127800,127800,2783,30117,30117
169.467505,4,80,50,30,-30,127800,127800,-1644,-11956,-11956
169.467505,5,1097,1068,29,-29,127800,127800,2015,-98315,-98315
169.467505,6,0,0,0,0,127800,127800,0,0,0
169.731276,0,455,355,100,-100,128000,127800,20613,170887,190887
169.731276,1,325,232,93,-93,128000,127800,14173,45627,64227
169.731276,2,1637,1618,19,-19,128000,127800,3771,-196171,-192371
169.731276,3,167,142,25,-25,128000,127800,2783,30117,35117
169.731276,4,80,50,30,-30,128000,127800,-1644,-11956,-5956
169.731276,5,1097,1068,29,-29,128000,127800,2015,-98315,-92515
169.731276,6,0,0,0,0,128000,127800,0,0,0
170.002461,0,455,355,100,-100,128000,127800,20613,170887,190887
170.002461,1,325,232,93,-93,128000,127800,14173,45627,64227
170.002461,2,1637,1618,19,-19,128000,127800,3771,-196171,-192371
170.002461,3,167,142,25,-25,128000,127800,2783,30117,35117
170.002461,4,80,50,30,-30,128000,127800,-1644,-11956,-5956
170.002461,5,1097,1068,29,-29,128000,127800,2015,-98315,-92515
170.002461,6,0,0,0,0,128000,127800,0,0,0
170.252761,0,455,355,100,-100,128000,127800,20613,170887,190887
170.252761,1,325,232,93,-93,128000,127800,14173,45627,64227
170.252761,2,1637,1618,19,-19,128000,127800,3771,-196171,-192371
170.252761,3,167,142,25,-25,128000,127800,2783,30117,35117
170.252761,4,80,50,30,-30,128000,127800,-1644,-11956,-5956
170.252761,5,1097,1068,29,-29,128000,127800,2015,-98315,-92515
170.252761,6,0,0,0,0,128000,127800,0,0,0
170.518493,0,455,355,100,-100,127700,127800,20613,170887,160887
170.518493,1,325,232,93,-93,127700,127800,14173,45627,36327
170.518493,2,1637,1628,9,-9,127700,127800,3643,-197043,-197943
170.518493,3,167,142,25,-25,127700,127800,2783,30117,27617
170.518493,4,80,50,30,-30,127700,127800,-1644,-11956,-14956
170.518493,5,1097,1078,19,-19,127700,127800,1887,-99187,-101087
170.518493,6,0,0,0,0,127700,127800,0,0,0
170.722846,0,455,355,100,-100,127700,127800,20613,170887,160887
170.722846,1,325,232,93,-93,127700,127800,14173,45627,36327
170.722846,2,1637,1628,9,-9,127700,127800,3643,-197043,-197943
170.722846,3,167,142,25,-25,127700,127800,2783,30117,27617
170.722846,4,80,50,30,-30,127700,127800,-1644,-11956,-14956
170.722846,5,1097,1078,19,-19,127700,127800,1887,-99187,-101087
170.722846,6,0,0,0,0,127700,127800,0,0,0
171.048559,0,455,355,100,-100,127700,127800,20613,170887,160887
171.048559,1,325,232,93,-93,127700,127800,14173,45627,36327
171.048559,2,1637,1628,9,-9,127700,127800,3643,-197043,-197943
171.048559,3,167,142,25,-25,127700,127800,2783,30117,27617
171.048559,4,80,50,30,-30,127700,127800,-1644,-11956,-14956
171.048559,5,1097,1078,19,-19,127700,127800,1887,-99187,-101087
171.048559,6,0,0,0,0,127700,127800,0,0,0
171.229458,0,455,355,100,-100,127700,127800,20613,170887,160887
171.229458,1,325,232,93,-93,127700,127800,14173,45627,36327
171.229458,2,1647,1628,19,-19,127700,127800,3515,-196915,-198815
171.229458,3,167,142,25,-25,127700,127800,2783,30117,27617
171.229458,4,80,50,30,-30,127700,127800,-1644,-11956,-14956
171.229458,5,1097,1078,19,-19,127700,127800,1887,-99187,-101087
171.229458,6,0,0,0,0,127700,127800,0,0,0
171.485301,0,455,355,100,-100,127700,127800,20613,170887,160887
171.485301,1,325,232,93,-93,127700,127800,14173,45627,36327
171.485301,2,1647,1628,19,-19,127700,127800,3515,-196915,-198815
171.485301,3,167,142,25,-25,127700,127800,2783,30117,27617
171.485301,4,80,50,30,-30,127700,127800,-1644,-11956,-14956
171.485301,5,1097,1078,19,-19,127700,127800,1887,-99187,-101087
171.485301,6,0,0,0,0,127700,127800,0,0,0
171.721413,0,455,355,100,-100,127700,127800,20613,170887,160887
171.721413,1,325,232,93,-93,127700,127800,14173,45627,36327
171.721413,2,1647,1628,19,-19,127700,127800,3515,-196915,-198815
171.721413,3,167,142,25,-25,127700,127800,2783,30117,27617
171.721413,4,80,50,30,-30,127700,127800,-1644,-11956,-14956
171.721413,5,1097,1078,19,-19,127700,127800,1887,-99187,-101087
171.721413,6,0,0,0,0,127700,127800,0,0,0
171.980372,0,455,355,100,-100,127700,127800,20613,170887,160887
171.980372,1,325,232,93,-93,127700,127800,14173,45627,36327
171.980372,2,1647,1628,19,-19,127700,127800,3515,-196915,-198815
171.980372,3,167,142,25,-25,127700,127800,2783,30117,27617
171.980372,4,80,50,30,-30,127700,127800,-1644,-11956,-14956
171.980372,5,1097,1078,19,-19,127700,127800,1887,-99187,-101087
171.980372,6,0,0,0,0,127700,127800,0,0,0
172.207658,0,455,355,100,-100,127700,127800,20613,170887,160887
172.207658,1,325,232,93,-93,127700,127800,14173,45627,36327
172.207658,2,1647,1628,19,-19,127700,127800,3515,-196915,-198815
172.207658,3,167,142,25,-25,127700,127800,2783,30117,27617
172.207658,4,80,50,30,-30,127700,127800,-1644,-11956,-14956
172.207658,5,1097,1078,19,-19,127700,127800,1887,-99187,-101087
172.207658,6,0,0,0,0,127700,127800,0,0,0
172.5124,0,455,355,100,-100,127700,127800,20613,170887,160887
172.5124,1,325,232,93,-93,127700,127800,14173,45627,36327
172.5124,2,1647,1628,19,-19,127700,127800,3515,-196915,-198815
172.5124,3,167,142,25,-25,127700,127800,2783,30117,27617
172.5124,4,80,50,30,-30,127700,127800,-1644,-11956,-14956
172.5124,5,1097,1078,19,-19,127700,127800,1887,-99187,-101087
172.5124,6,0,0,0,0,127700,127800,0,0,0
172.761095,0,455,355,100,-100,127700,127800,20613,170887,160887
172.761095,1,325,232,93,-93,127700,127800,14173,45627,36327
172.761095,2,1647,1628,19,-19,127700,127800,3515,-196915,-198815
172.761095,3,167,142,25,-25,127700,127800,2783,30117,27617
172.761095,4,80,50,30,-30,127700,127800,-1644,-11956,-14956
172.761095,5,1097,1088,9,-9,127700,127800,2142,-101442,-102342
172.761095,6,0,0,0,0,127700,127800,0,0,0
173.029943,0,455,355,100,-100,127700,127800,20613,170887,160887
173.029943,1,325,232,93,-93,127700,127800,14173,45627,36327
173.029943,2,1647,1628,19,-19,127700,127800,3515,-196915,-198815
173.029943,3,167,142,25,-25,127700,127800,2783,30117,27617
173.029943,4,80,50,30,-30,127700,127800,-1644,-11956,-14956
173.029943,5,1097,1088,9,-9,127700,127800,2142,-101442,-102342
173.029943,6,0,0,0,0,127700,127800,0,0,0
173.236866,0,455,355,100,-100,127800,127800,20613,170887,170887
173.236866,1,325,232,93,-93,127800,127800,14173,45627,45627
173.236866,2,1647,1638,9,-9,127800,127800,3387,-198787,-198787
173.236866,3,167,142,25,-25,127800,127800,2783,30117,30117
173.236866,4,80,50,30,-30,127800,127800,-1644,-11956,-11956
173.236866,5,1107,1088,19,-19,127800,127800,2398,-100698,-100698
173.236866,6,0,0,0,0,127800,127800,0,0,0
173.504206,0,455,355,100,-100,127800,127800,20613,170887,170887
173.504206,1,325,232,93,-93,127800,127800,14173,45627,45627
173.504206,2,1647,1638,9,-9,127800,127800,3387,-198787,-198787
173.504206,3,167,142,25,-25,127800,127800,2783,30117,30117
173.504206,4,80,50,30,-30,127800,127800,-1644,-11956,-11956
173.504206,5,1107,1088,19,-19,127800,127800,2398,-100698,-100698
173.504206,6,0,0,0,0,127800,127800,0,0,0
173.776886,0,455,355,100,-100,127800,127800,20613,170887,170887
173.776886,1,325,232,93,-93,127800,127800,14173,45627,45627
173.776886,2,1647,1638,9,-9,127800,127800,3387,-198787,-198787
173.776886,3,167,142,25,-25,127800,127800,2783,30117,30117
173.776886,4,80,50,30,-30,127800,127800,-1644,-11956,-11956
173.776886,5,1107,1088,19,-19,127800,127800,2398,-100698,-100698
173.776886,6,0,0,0,0,127800,127800,0,0,0
173.953211,0,455,355,100,-100,128000,127800,20613,170887,190887
173.953211,1,325,232,93,-93,128000,127800,14173,45627,64227
173.953211,2,1647,1638,9,-9,128000,127800,3387,-198787,-196987
173.953211,3,167,142,25,-25,128000,127800,2783,30117,35117
173.953211,4,80,50,30,-30,128000,127800,-1644,-11956,-5956
173.953211,5,1107,1088,19,-19,128000,127800,2398,-100698,-96898
173.953211,6,0,0,0,0,128000,127800,0,0,0
174.236899,0,455,355,100,-100,128000,128000,20613,170887,170887
174.236899,1,325,232,93,-93,128000,128000,14173,45627,45627
174.236899,2,1647,1638,9,-9,128000,128000,3387,-198787,-198787
174.236899,3,167,142,25,-25,128000,128000,2783,30117,30117
174.236899,4,80,50,30,-30,128000,128000,-1644,-11956,-11956
174.236899,5,1107,1088,19,-19,128000,128000,2398,-100698,-100698
174.236899,6,0,0,0,0,128000,128000,0,0,0
174.481044,0,455,355,100,-100,128000,128000,20613,170887,170887
174.481044,1,325,232,93,-93,128000,128000,14173,45627,45627
174.481044,2,1647,1638,9,-9,128000,128000,3387,-198787,-198787
174.481044,3,167,142,25,-25,128000,128000,2783,30117,30117
174.481044,4,80,50,30,-30,128000,128000,-1644,-11956,-11956
174.481044,5,1107,1088,19,-19,128000,128000,2398,-100698,-100698
174.481044,6,0,0,0,0,128000,128000,0,0,0
174.709782,0,455,355,100,-100,128000,128000,20613,170887,170887
174.709782,1,325,232,93,-93,128000,128000,14173,45627,45627
174.709782,2,1647,1638,9,-9,128000,128000,3387,-198787,-198787
174.709782,3,167,142,25,-25,128000,128000,2783,30117,30117
174.709782,4,80,50,30,-30,128000,128000,-1644,-11956,-11956
174.709782,5,1107,1088,19,-19,128000,128000,2398,-100698,-100698
174.709782,6,0,0,0,0,128000,128000,0,0,0
174.977057,0,455,355,100,-100,128000,128000,20613,170887,170887
174.977057,1,325,232,93,-93,128000,128000,14173,45627,45627
174.977057,2,1657,1638,19,-19,128000,128000,3643,-198043,-198043
174.977057,3,167,142,25,-25,128000,128000,2783,30117,30117
174.977057,4,80,50,30,-30,128000,128000,-1644,-11956,-11956
174.977057,5,1107,1088,19,-19,128000,128000,2398,-100698,-100698
174.977057,6,0,0,0,0,128000,128000,0,0,0
175.203799,0,455,355,100,-100,128000,128400,20613,170887,145187
175.203799,1,325,232,93,-93,128000,128400,14173,45627,21726
175.203799,2,1667,1638,29,-29,128000,128400,3899,-194299,-201752
175.203799,3,169,142,27,-27,128000,128400,2834,30866,23927
175.203799,4,80,50,30,-30,128000,128400,-1644,-11956,-19666
175.203799,5,1117,1088,29,-29,128000,128400,2654,-96954,-104407
175.203799,6,0,0,0,0,128000,128400,0,0,0
175.532724,0,455,355,100,-100,128000,128400,20613,170887,145187
175.532724,1,325,232,93,-93,128000,128400,14173,45627,21726
175.532724,2,1677,1638,39,-39,128000,128400,4155,-191555,-201578
175.532724,3,171,142,29,-29,128000,128400,2885,31415,23962
175.532724,4,80,50,30,-30,128000,128400,-1644,-11956,-19666
175.532724,5,1127,1088,39,-39,128000,128400,2910,-94210,-104233
175.532724,6,0,0,0,0,128000,128400,0,0,0
175.796549,0,455,355,100,-100,128000,128400,20613,170887,145187
175.796549,1,325,232,93,-93,128000,128400,14173,45627,21726
175.796549,2,1687,1638,49,-49,128000,128400,4411,-188811,-201404
175.796549,3,173,142,31,-31,128000,128400,2936,31964,23997
175.796549,4,80,50,30,-30,128000,128400,-1644,-11956,-19666
175.796549,5,1127,1088,39,-39,128000,128400,2910,-94210,-104233
175.796549,6,0,0,0,0,128000,128400,0,0,0
175.963011,0,455,355,100,-100,128000,128400,20613,170887,145187
175.963011,1,325,232,93,-93,128000,128400,14173,45627,21726
175.963011,2,1697,1638,59,-59,128000,128400,4667,-185067,-200230
175.963011,3,175,142,33,-33,128000,128400,2987,32713,24232
175.963011,4,80,50,30,-30,128000,128400,-1644,-11956,-19666
175.963011,5,1137,1088,49,-49,128000,128400,3166,-90466,-103059
175.963011,6,0,0,0,0,128000,128400,0,0,0
176.230494,0,455,355,100,-100,128000,128400,20613,170887,145187
176.230494,1,325,232,93,-93,128000,128400,14173,45627,21726
176.230494,2,1697,1638,59,-59,128000,128400,4667,-185067,-200230
176.230494,3,177,142,35,-35,128000,128400,3038,33262,24267
176.230494,4,80,50,30,-30,128000,128400,-1644,-11956,-19666
176.230494,5,1137,1088,49,-49,128000,128400,3166,-90466,-103059
176.230494,6,0,0,0,0,128000,128400,0,0,0
176.526226,0,455,355,100,-100,127900,128400,20613,170887,145187
176.526226,1,325,232,93,-93,127900,128400,14173,45627,21726
176.526226,2,1697,1640,57,-57,127900,128400,4641,-186041,-200690
176.526226,3,179,142,37,-37,127900,128400,3089,34011,24502
176.526226,4,80,50,30,-30,127900,128400,-1644,-11956,-19666
176.526226,5,1137,1088,49,-49,127900,128400,3166,-90466,-103059
176.526226,6,0,0,0,0,127900,128400,0,0,0
176.709138,0,455,355,100,-100,127900,128400,20613,170887,145187
176.709138,1,325,232,93,-93,127900,128400,14173,45627,21726
176.709138,2,1697,1642,55,-55,127900,128400,4615,-187015,-201150
176.709138,3,181,142,39,-39,127900,128400,3140,34760,24737
176.709138,4,80,50,30,-30,127900,128400,-1644,-11956,-19666
176.709138,5,1137,1088,49,-49,127900,128400,3166,-90466,-103059
176.709138,6,0,0,0,0,127900,128400,0,0,0
176.987447,0,455,355,100,-100,128100,128400,20613,170887,145187
176.987447,1,325,232,93,-93,128100,128400,14173,45627,21726
176.987447,2,1697,1642,55,-55,128100,128400,4615,-187015,-201150
176.987447,3,183,142,41,-41,128100,128400,3191,35509,24972
176.987447,4,80,50,30,-30,128100,128400,-1644,-11956,-19666
176.987447,5,1137,1088,49,-49,128100,128400,3166,-90466,-103059
176.987447,6,0,0,0,0,128100,128400,0,0,0
177.23551,0,455,355,100,-100,128000,128400,20613,170887,145187
177.23551,1,325,232,93,-93,128000,128400,14173,45627,21726
177.23551,2,1697,1644,53,-53,128000,128400,4589,-187989,-201610
177.23551,3,185,142,43,-43,128000,128400,3242,36058,25007
177.23551,4,80,50,30,-30,128000,128400,-1644,-11956,-19666
177.23551,5,1137,1088,49,-49,128000,128400,3166,-90466,-103059
177.23551,6,0,0,0,0,128000,128400,0,0,0
177.456913,0,455,355,100,-100,128000,128400,20613,170887,145187
177.456913,1,325,232,93,-93,128000,128400,14173,45627,21726
177.456913,2,1697,1646,51,-51,128000,128400,4563,-188963,-202070
177.456913,3,187,142,45,-45,128000,128400,3293,36607,25042
177.456913,4,80,50,30,-30,128000,128400,-1644,-11956,-19666
177.456913,5,1137,1088,49,-49,128000,128400,3166,-90466,-103059
177.456913,6,0,0,0,0,128000,128400,0,0,0
177.746058,0,455,355,100,-100,128200,128400,20613,170887,150887
177.746058,1,325,232,93,-93,128200,128400,14173,45627,27027
177.746058,2,1697,1652,45,-45,128200,128400,4486,-191886,-200886
177.746058,3,189,142,47,-47,128200,128400,3344,37156,27756
177.746058,4,80,50,30,-30,128200,128400,-1644,-11956,-17956
177.746058,5,1137,1088,49,-49,128200,128400,3166,-90466,-100266
177.746058,6,0,0,0,0,128200,128400,0,0,0
178.048401,0,455,355,100,-100,128200,128400,20613,170887,150887
178.048401,1,325,232,93,-93,128200,128400,14173,45627,27027
178.048401,2,1697,1652,45,-45,128200,128400,4486,-191886,-200886
178.048401,3,189,142,47,-47,128200,128400,3344,37156,27756
178.048401,4,80,50,30,-30,128200,128400,-1644,-11956,-17956
178.048401,5,1137,1088,49,-49,128200,128400,3166,-90466,-100266
178.048401,6,0,0,0,0,128200,128400,0,0,0
178.282569,0,455,355,100,-100,128200,128400,20613,170887,150887
178.282569,1,325,232,93,-93,128200,128400,14173,45627,27027
178.282569,2,1697,1652,45,-45,128200,128400,4486,-191886,-200886
178.282569,3,189,142,47,-47,128200,128400,3344,37156,27756
178.282569,4,80,50,30,-30,128200,128400,-1644,-11956,-17956
178.282569,5,1137,1088,49,-49,128200,128400,3166,-90466,-100266
178.282569,6,0,0,0,0,128200,128400,0,0,0
178.542184,0,455,355,100,-100,128300,128400,20613,170887,160887
178.542184,1,325,232,93,-93,128300,128400,14173,45627,36327
178.542184,2,1697,1662,35,-35,128300,128400,4358,-195758,-199258
178.542184,3,189,142,47,-47,128300,128400,3344,37156,32456
178.542184,4,80,50,30,-30,128300,128400,-1644,-11956,-14956
178.542184,5,1137,1098,39,-39,128300,128400,3038,-93338,-97238
178.542184,6,0,0,0,0,128300,128400,0,0,0
178.705662,0,455,355,100,-100,128300,128400,20613,170887,160887
178.705662,1,325,232,93,-93,128300,128400,14173,45627,36327
178.705662,2,1697,1662,35,-35,128300,128400,4358,-195758,-199258
178.705662,3,189,142,47,-47,128300,128400,3344,37156,32456
178.705662,4,80,50,30,-30,128300,128400,-1644,-11956,-14956
178.705662,5,1137,1098,39,-39,128300,128400,3038,-93338,-97238
178.705662,6,0,0,0,0,128300,128400,0,0,0
178.993778,0,455,355,100,-100,128300,128400,20613,170887,160887
178.993778,1,325,232,93,-93,128300,128400,14173,45627,36327
178.993778,2,1697,1662,35,-35,128300,128400,4358,-195758,-199258
178.993778,3,189,142,47,-47,128300,128400,3344,37156,32456
178.993778,4,80,50,30,-30,128300,128400,-1644,-11956,-14956
178.993778,5,1137,1098,39,-39,128300,128400,3038,-93338,-97238
178.993778,6,0,0,0,0,128300,128400,0,0,0
179.267016,0,455,355,100,-100,128100,128400,20613,170887,145187
179.267016,1,325,232,93,-93,128100,128400,14173,45627,21726
179.267016,2,1697,1667,30,-30,128100,128400,4294,-197194,-204904
179.267016,3,189,142,47,-47,128100,128400,3344,37156,25077
179.267016,4,80,50,30,-30,128100,128400,-1644,-11956,-19666
179.267016,5,1137,1098,39,-39,128100,128400,3038,-93338,-103361
179.267016,6,0,0,0,0,128100,128400,0,0,0
179.542996,0,455,355,100,-100,128100,128400,20613,170887,145187
179.542996,1,325,232,93,-93,128100,128400,14173,45627,21726
179.542996,2,1697,1667,30,-30,128100,128400,4294,-197194,-204904
179.542996,3,189,142,47,-47,128100,128400,3344,37156,25077
179.542996,4,80,50,30,-30,128100,128400,-1644,-11956,-19666
179.542996,5,1137,1098,39,-39,128100,128400,3038,-93338,-103361
179.542996,6,0,0,0,0,128100,128400,0,0,0
179.763961,0,455,355,100,-100,127800,128300,20613,170887,145187
179.763961,1,325,232,93,-93,127800,128300,14173,45627,21726
179.763961,2,1707,1667,40,-40,127800,128300,4166,-195066,-205346
179.763961,3,191,142,49,-49,127800,128300,3318,37582,24989
179.763961,4,80,50,30,-30,127800,128300,-1644,-11956,-19666
179.763961,5,1147,1098,49,-49,127800,128300,2910,-91210,-103803
179.763961,6,0,0,0,0,127800,128300,0,0,0
180.026611,0,455,355,100,-100,127900,128300,20613,170887,145187
180.026611,1,325,232,93,-93,127900,128300,14173,45627,21726
180.026611,2,1707,1677,30,-30,127900,128300,4422,-199322,-207032
180.026611,3,191,142,49,-49,127900,128300,3318,37582,24989
180.026611,4,80,50,30,-30,127900,128300,-1644,-11956,-19666
180.026611,5,1157,1098,59,-59,127900,128300,2782,-88082,-103245
180.026611,6,0,0,0,0,127900,128300,0,0,0
180.257735,0,455,355,100,-100,128000,128300,20613,170887,145187
180.257735,1,325,232,93,-93,128000,128300,14173,45627,21726
180.257735,2,1707,1680,27,-27,128000,128300,4499,-200599,-207538
180.257735,3,191,142,49,-49,128000,128300,3318,37582,24989
180.257735,4,80,50,30,-30,128000,128300,-1644,-11956,-19666
180.257735,5,1157,1098,59,-59,128000,128300,2782,-88082,-103245
180.257735,6,0,0,0,0,128000,128300,0,0,0
180.463848,0,455,355,100,-100,128100,128300,20613,170887,150887
180.463848,1,325,232,93,-93,128100,128300,14173,45627,27027
180.463848,2,1727,1680,47,-47,128100,128300,4627,-194727,-204127
180.463848,3,193,142,51,-51,128100,128300,3292,38408,28208
180.463848,4,80,50,30,-30,128100,128300,-1644,-11956,-17956
180.463848,5,1167,1098,69,-69,128100,128300,2654,-82954,-96754
180.463848,6,0,0,0,0,128100,128300,0,0,0
180.74485,0,455,355,100,-100,128100,128300,20613,170887,150887
180.74485,1,325,232,93,-93,128100,128300,14173,45627,27027
180.74485,2,1737,1680,57,-57,128100,128300,4499,-190599,-201999
180.74485,3,195,142,53,-53,128100,128300,3343,38957,28357
180.74485,4,80,50,30,-30,128100,128300,-1644,-11956,-17956
180.74485,5,1167,1104,63,-63,128100,128300,2577,-87077,-99677
180.74485,6,0,0,0,0,128100,128300,0,0,0
181.014933,0,455,355,100,-100,128200,128300,20613,170887,160887
181.014933,1,325,232,93,-93,128200,128300,14173,45627,36327
181.014933,2,1737,1680,57,-57,128200,128300,4499,-190599,-196299
181.014933,3,197,142,55,-55,128200,128300,3394,39506,34006
181.014933,4,80,50,30,-30,128200,128300,-1644,-11956,-14956
181.014933,5,1167,1106,61,-61,128200,128300,2551,-88051,-94151
181.014933,6,0,0,0,0,128200,128300,0,0,0
181.246014,0,455,355,100,-100,128200,128700,20613,170887,145187
181.246014,1,325,232,93,-93,128200,128700,14173,45627,21726
181.246014,2,1737,1680,57,-57,128200,128700,4499,-190599,-205248
181.246014,3,201,142,59,-59,128200,128700,3496,41004,25841
181.246014,4,80,50,30,-30,128200,128700,-1644,-11956,-19666
181.246014,5,1167,1110,57,-57,128200,128700,2499,-90399,-105048
181.246014,6,0,0,0,0,128200,128700,0,0,0
181.460755,0,455,355,100,-100,128200,128700,20613,170887,145187
181.460755,1,325,232,93,-93,128200,128700,14173,45627,21726
181.460755,2,1737,1680,57,-57,128200,128700,4499,-190599,-205248
181.460755,3,203,142,61,-61,128200,128700,3547,41553,25876
181.460755,4,80,50,30,-30,128200,128700,-1644,-11956,-19666
181.460755,5,1167,1112,55,-55,128200,128700,2473,-91373,-105508
181.460755,6,0,0,0,0,128200,128700,0,0,0
181.749731,0,455,355,100,-100,128400,129000,20613,170887,145087
181.749731,1,325,232,93,-93,128400,129000,14173,45627,21633
181.749731,2,1737,1692,45,-45,128400,129000,4345,-198645,-210255
181.749731,3,205,142,63,-63,128400,129000,3598,42302,26048
181.749731,4,80,50,30,-30,128400,129000,-1644,-11956,-19696
181.749731,5,1167,1122,45,-45,128400,129000,2345,-97245,-108855
181.749731,6,0,0,0,0,128400,129000,0,0,0
182.006539,0,455,355,100,-100,128500,129000,20613,170887,145087
182.006539,1,325,232,93,-93,128500,129000,14173,45627,21633
182.006539,2,1747,1692,55,-55,128500,129000,4602,-194902,-209092
182.006539,3,207,142,65,-65,128500,129000,3649,43051,26281
182.006539,4,80,50,30,-30,128500,129000,-1644,-11956,-19696
182.006539,5,1167,1122,45,-45,128500,129000,2345,-97245,-108855
182.006539,6,0,0,0,0,128500,129000,0,0,0
182.212791,0,455,355,100,-100,128500,129000,20613,170887,145087
182.212791,1,325,232,93,-93,128500,129000,14173,45627,21633
182.212791,2,1747,1692,55,-55,128500,129000,4602,-194902,-209092
182.212791,3,209,142,67,-67,128500,129000,3700,43800,26514
182.212791,4,80,50,30,-30,128500,129000,-1644,-11956,-19696
182.212791,5,1167,1122,45,-45,128500,129000,2345,-97245,-108855
182.212791,6,0,0,0,0,128500,129000,0,0,0
182.532114,0,455,355,100,-100,128500,129000,20613,170887,145087
182.532114,1,325,232,93,-93,128500,129000,14173,45627,21633
182.532114,2,1747,1692,55,-55,128500,129000,4602,-194902,-209092
182.532114,3,213,142,71,-71,128500,129000,3802,45298,26980
182.532114,4,80,50,30,-30,128500,129000,-1644,-11956,-19696
182.532114,5,1167,1122,45,-45,128500,129000,2345,-97245,-108855
182.532114,6,0,0,0,0,128500,129000,0,0,0
182.725915,0,455,355,100,-100,128400,128500,20613,170887,160887
182.725915,1,325,232,93,-93,128400,128500,14173,45627,36327
182.725915,2,1747,1702,45,-45,128400,128500,4859,-199159,-203659
182.725915,3,213,142,71,-71,128400,128500,3802,45298,38198
182.725915,4,80,50,30,-30,128400,128500,-1644,-11956,-14956
182.725915,5,1167,1122,45,-45,128400,128500,2345,-97245,-101745
182.725915,6,0,0,0,0,128400,128500,0,0,0
183.033064,0,455,355,100,-100,128300,128500,20613,170887,150887
183.033064,1,325,232,93,-93,128300,128500,14173,45627,27027
183.033064,2,1747,1704,43,-43,128300,128500,4910,-199810,-208410
183.033064,3,215,142,73,-73,128300,128500,3776,45524,30924
183.033064,4,80,50,30,-30,128300,128500,-1644,-11956,-17956
183.033064,5,1167,1122,45,-45,128300,128500,2345,-97245,-106245
183.033064,6,0,0,0,0,128300,128500,0,0,0
183.203528,0,455,355,100,-100,128400,128500,20613,170887,160887
183.203528,1,325,232,93,-93,128400,128500,14173,45627,36327
183.203528,2,1747,1716,31,-31,128400,128500,4755,-206055,-209155
183.203528,3,219,142,77,-77,128400,128500,3878,46622,38922
183.203528,4,80,50,30,-30,128400,128500,-1644,-11956,-14956
183.203528,5,1175,1122,53,-53,128400,128500,2550,-93450,-98750
183.203528,6,0,0,0,0,128400,128500,0,0,0
183.457838,0,455,355,100,-100,128400,128500,20613,170887,160887
183.457838,1,325,232,93,-93,128400,128500,14173,45627,36327
183.457838,2,1747,1716,31,-31,128400,128500,4755,-206055,-209155
183.457838,3,219,142,77,-77,128400,128500,3878,46622,38922
183.457838,4,80,50,30,-30,128400,128500,-1644,-11956,-14956
183.457838,5,1175,1122,53,-53,128400,128500,2550,-93450,-98750
183.457838,6,0,0,0,0,128400,128500,0,0,0
183.75361,0,455,355,100,-100,128400,128500,20613,170887,160887
183.75361,1,325,232,93,-93,128400,128500,14173,45627,36327
183.75361,2,1747,1716,31,-31,128400,128500,4755,-206055,-209155
183.75361,3,219,142,77,-77,128400,128500,3878,46622,38922
183.75361,4,80,50,30,-30,128400,128500,-1644,-11956,-14956
183.75361,5,1175,1122,53,-53,128400,128500,2550,-93450,-98750
183.75361,6,0,0,0,0,128400,128500,0,0,0
184.005431,0,455,355,100,-100,128400,128500,20613,170887,160887
184.005431,1,325,232,93,-93,128400,128500,14173,45627,36327
184.005431,2,1747,1716,31,-31,128400,128500,4755,-206055,-209155
184.005431,3,219,142,77,-77,128400,128500,3878,46622,38922
184.005431,4,80,50,30,-30,128400,128500,-1644,-11956,-14956
184.005431,5,1175,1122,53,-53,128400,128500,2550,-93450,-98750
184.005431,6,0,0,0,0,128400,128500,0,0,0
184.232714,0,455,355,100,-100,128400,128500,20613,170887,160887
184.232714,1,325,232,93,-93,128400,128500,14173,45627,36327
184.232714,2,1747,1716,31,-31,128400,128500,4755,-206055,-209155
184.232714,3,219,142,77,-77,128400,128500,3878,46622,38922
184.232714,4,80,50,30,-30,128400,128500,-1644,-11956,-14956
184.232714,5,1175,1122,53,-53,128400,128500,2550,-93450,-98750
184.232714,6,0,0,0,0,128400,128500,0,0,0
184.456817,0,455,355,100,-100,127900,128000,20613,170887,160887
184.456817,1,325,232,93,-93,127900,128000,14173,45627,36327
184.456817,2,1747,1718,29,-29,127900,128000,4806,-206306,-209206
184.456817,3,221,142,79,-79,127900,128000,3852,46648,38748
184.456817,4,80,50,30,-30,127900,128000,-1644,-11956,-14956
184.456817,5,1175,1122,53,-53,127900,128000,2550,-93450,-98750
184.456817,6,0,0,0,0,127900,128000,0,0,0
184.713977,0,455,355,100,-100,127800,128000,20613,170887,150887
184.713977,1,325,232,93,-93,127800,128000,14173,45627,27027
184.713977,2,1747,1720,27,-27,127800,128000,4857,-206757,-212157
184.713977,3,223,142,81,-81,127800,128000,3826,46674,30474
184.713977,4,80,50,30,-30,127800,128000,-1644,-11956,-17956
184.713977,5,1175,1122,53,-53,127800,128000,2550,-93450,-104050
184.713977,6,0,0,0,0,127800,128000,0,0,0
184.965772,0,455,355,100,-100,127800,128000,20613,170887,150887
184.965772,1,325,232,93,-93,127800,128000,14173,45627,27027
184.965772,2,1747,1720,27,-27,127800,128000,4857,-206757,-212157
184.965772,3,223,142,81,-81,127800,128000,3826,46674,30474
184.965772,4,80,50,30,-30,127800,128000,-1644,-11956,-17956
184.965772,5,1175,1122,53,-53,127800,128000,2550,-93450,-104050
184.965772,6,0,0,0,0,127800,128000,0,0,0
185.28189,0,455,355,100,-100,127400,128100,20613,170887,145287
185.28189,1,325,232,93,-93,127400,128100,14173,45627,21819
185.28189,2,1767,1720,47,-47,127400,128100,4601,-201501,-213533
185.28189,3,225,142,83,-83,127400,128100,3800,47300,26052
185.28189,4,80,50,30,-30,127400,128100,-1644,-11956,-19636
185.28189,5,1185,1132,53,-53,127400,128100,2678,-93578,-107146
185.28189,6,0,0,0,0,127400,128100,0,0,0
185.453912,0,455,355,100,-100,127500,128100,20613,170887,145287
185.453912,1,325,232,93,-93,127500,128100,14173,45627,21819
185.453912,2,1777,1720,57,-57,127500,128100,4473,-197373,-211965
185.453912,3,227,142,85,-85,127500,128100,3774,47926,26166
185.453912,4,80,50,30,-30,127500,128100,-1644,-11956,-19636
185.453912,5,1185,1132,53,-53,127500,128100,2678,-93578,-107146
185.453912,6,0,0,0,0,127500,128100,0,0,0
185.761853,0,455,355,100,-100,127700,128100,20613,170887,145287
185.761853,1,325,232,93,-93,127700,128100,14173,45627,21819
185.761853,2,1777,1722,55,-55,127700,128100,4447,-198347,-212427
185.761853,3,229,142,87,-87,127700,128100,3825,48475,26203
185.761853,4,80,50,30,-30,127700,128100,-1644,-11956,-19636
185.761853,5,1185,1132,53,-53,127700,128100,2678,-93578,-107146
185.761853,6,0,0,0,0,127700,128100,0,0,0
186.050325,0,455,355,100,-100,127700,128100,20613,170887,145287
186.050325,1,325,232,93,-93,127700,128100,14173,45627,21819
186.050325,2,1777,1724,53,-53,127700,128100,4421,-199321,-212889
186.050325,3,231,142,89,-89,127700,128100,3876,49024,26240
186.050325,4,80,50,30,-30,127700,128100,-1644,-11956,-19636
186.050325,5,1185,1132,53,-53,127700,128100,2678,-93578,-107146
186.050325,6,0,0,0,0,127700,128100,0,0,0
186.263041,0,455,355,100,-100,127600,128100,20613,170887,145287
186.263041,1,325,232,93,-93,127600,128100,14173,45627,21819
186.263041,2,1777,1734,43,-43,127600,128100,4676,-203576,-214584
186.263041,3,231,142,89,-89,127600,128100,3876,49024,26240
186.263041,4,80,50,30,-30,127600,128100,-1644,-11956,-19636
186.263041,5,1195,1132,63,-63,127600,128100,2550,-91450,-107578
186.263041,6,0,0,0,0,127600,128100,0,0,0
186.527401,0,455,355,100,-100,127600,128100,20613,170887,145287
186.527401,1,325,232,93,-93,127600,128100,14173,45627,21819
186.527401,2,1777,1734,43,-43,127600,128100,4676,-203576,-214584
186.527401,3,231,142,89,-89,127600,128100,3876,49024,26240
186.527401,4,80,50,30,-30,127600,128100,-1644,-11956,-19636
186.527401,5,1195,1132,63,-63,127600,128100,2550,-91450,-107578
186.527401,6,0,0,0,0,127600,128100,0,0,0
186.78268,0,455,355,100,-100,128400,128100,20613,170887,196487
186.78268,1,325,232,93,-93,128400,128100,14173,45627,69435
186.78268,2,1777,1744,33,-33,128400,128100,4548,-206448,-198000
186.78268,3,231,144,87,-87,128400,128100,3850,49850,72122
186.78268,4,80,50,30,-30,128400,128100,-1644,-11956,-4276
186.78268,5,1195,1132,63,-63,128400,128100,2550,-91450,-75322
186.78268,6,0,0,0,0,128400,128100,0,0,0
187.014439,0,455,355,100,-100,127600,128100,20613,170887,145287
187.014439,1,325,232,93,-93,127600,128100,14173,45627,21819
187.014439,2,1777,1746,31,-31,127600,128100,4522,-207222,-215158
187.014439,3,233,144,89,-89,127600,128100,3901,50199,27415
187.014439,4,80,50,30,-30,127600,128100,-1644,-11956,-19636
187.014439,5,1195,1132,63,-63,127600,128100,2550,-91450,-107578
187.014439,6,0,0,0,0,127600,128100,0,0,0
187.203677,0,455,355,100,-100,127600,128100,20613,170887,145287
187.203677,1,325,232,93,-93,127600,128100,14173,45627,21819
187.203677,2,1777,1746,31,-31,127600,128100,4522,-207222,-215158
187.203677,3,233,144,89,-89,127600,128100,3901,50199,27415
187.203677,4,80,50,30,-30,127600,128100,-1644,-11956,-19636
187.203677,5,1195,1132,63,-63,127600,128100,2550,-91450,-107578
187.203677,6,0,0,0,0,127600,128100,0,0,0
187.460295,0,455,355,100,-100,127600,128100,20613,170887,145287
187.460295,1,325,232,93,-93,127600,128100,14173,45627,21819
187.460295,2,1777,1746,31,-31,127600,128100,4522,-207222,-215158
187.460295,3,233,144,89,-89,127600,128100,3901,50199,27415
187.460295,4,80,50,30,-30,127600,128100,-1644,-11956,-19636
187.460295,5,1195,1132,63,-63,127600,128100,2550,-91450,-107578
187.460295,6,0,0,0,0,127600,128100,0,0,0
187.783209,0,455,355,100,-100,127700,128200,20613,170887,145287
187.783209,1,325,232,93,-93,127700,128200,14173,45627,21819
187.783209,2,1777,1756,21,-21,127700,128200,4394,-216094,-221470
187.783209,3,233,144,89,-89,127700,128200,3901,50199,27415
187.783209,4,80,50,30,-30,127700,128200,-1644,-11956,-19636
187.783209,5,1195,1132,63,-63,127700,128200,2550,-91450,-107578
187.783209,6,0,0,0,0,127700,128200,0,0,0
188.00575,0,455,355,100,-100,127700,128200,20613,170887,145287
188.00575,1,325,232,93,-93,127700,128200,14173,45627,21819
188.00575,2,1777,1756,21,-21,127700,128200,4394,-216094,-221470
188.00575,3,233,144,89,-89,127700,128200,3901,50199,27415
188.00575,4,80,50,30,-30,127700,128200,-1644,-11956,-19636
188.00575,5,1195,1132,63,-63,127700,128200,2550,-91450,-107578
188.00575,6,0,0,0,0,127700,128200,0,0,0
188.227206,0,455,355,100,-100,127700,128200,20613,170887,145287
188.227206,1,325,232,93,-93,127700,128200,14173,45627,21819
188.227206,2,1777,1756,21,-21,127700,128200,4394,-216094,-221470
188.227206,3,233,144,89,-89,127700,128200,3901,50199,27415
188.227206,4,80,50,30,-30,127700,128200,-1644,-11956,-19636
188.227206,5,1195,1132,63,-63,127700,128200,2550,-91450,-107578
188.227206,6,0,0,0,0,127700,128200,0,0,0
188.485076,0,455,355,100,-100,127500,128200,20613,170887,145287
188.485076,1,325,232,93,-93,127500,128200,14173,45627,21819
188.485076,2,1787,1756,31,-31,127500,128200,4266,-213966,-221902
188.485076,3,233,144,89,-89,127500,128200,3901,50199,27415
188.485076,4,80,50,30,-30,127500,128200,-1644,-11956,-19636
188.485076,5,1195,1132,63,-63,127500,128200,2550,-91450,-107578
188.485076,6,0,0,0,0,127500,128200,0,0,0
188.743278,0,455,355,100,-100,127500,128200,20613,170887,145287
188.743278,1,325,232,93,-93,127500,128200,14173,45627,21819
188.743278,2,1787,1756,31,-31,127500,128200,4266,-213966,-221902
188.743278,3,233,144,89,-89,127500,128200,3901,50199,27415
188.743278,4,80,50,30,-30,127500,128200,-1644,-11956,-19636
188.743278,5,1195,1132,63,-63,127500,128200,2550,-91450,-107578
188.743278,6,0,0,0,0,127500,128200,0,0,0
189.035981,0,455,355,100,-100,127500,128200,20613,170887,145287
189.035981,1,325,232,93,-93,127500,128200,14173,45627,21819
189.035981,2,1787,1756,31,-31,127500,128200,4266,-213966,-221902
189.035981,3,233,144,89,-89,127500,128200,3901,50199,27415
189.035981,4,80,50,30,-30,127500,128200,-1644,-11956,-19636
189.035981,5,1195,1132,63,-63,127500,128200,2550,-91450,-107578
189.035981,6,0,0,0,0,127500,128200,0,0,0
189.24852,0,455,355,100,-100,127500,128200,20613,170887,145287
189.24852,1,325,232,93,-93,127500,128200,14173,45627,21819
189.24852,2,1787,1756,31,-31,127500,128200,4266,-213966,-221902
189.24852,3,233,144,89,-89,127500,128200,3901,50199,27415
189.24852,4,80,50,30,-30,127500,128200,-1644,-11956,-19636
189.24852,5,1195,1132,63,-63,127500,128200,2550,-91450,-107578
189.24852,6,0,0,0,0,127500,128200,0,0,0
189.49776,0,455,355,100,-100,127700,128200,20613,170887,145287
189.49776,1,325,232,93,-93,127700,128200,14173,45627,21819
189.49776,2,1797,1758,39,-39,127700,128200,4112,-210612,-220596
189.49776,3,235,144,91,-91,127700,128200,3952,50548,27252
189.49776,4,80,50,30,-30,127700,128200,-1644,-11956,-19636
189.49776,5,1195,1142,53,-53,127700,128200,2805,-97705,-111273
189.49776,6,0,0,0,0,127700,128200,0,0,0
189.777636,0,455,355,100,-100,127700,128000,20613,170887,145287
189.777636,1,325,232,93,-93,127700,128000,14173,45627,21819
189.777636,2,1797,1758,39,-39,127700,128000,4112,-210612,-220596
189.777636,3,235,144,91,-91,127700,128000,3952,50548,27252
189.777636,4,80,50,30,-30,127700,128000,-1644,-11956,-19636
189.777636,5,1195,1142,53,-53,127700,128000,2805,-97705,-111273
189.777636,6,0,0,0,0,127700,128000,0,0,0
190.013316,0,455,355,100,-100,127700,128000,20613,170887,145287
190.013316,1,325,232,93,-93,127700,128000,14173,45627,21819
190.013316,2,1797,1758,39,-39,127700,128000,4112,-210612,-220596
190.013316,3,235,144,91,-91,127700,128000,3952,50548,27252
190.013316,4,80,50,30,-30,127700,128000,-1644,-11956,-19636
190.013316,5,1195,1142,53,-53,127700,128000,2805,-97705,-111273
190.013316,6,0,0,0,0,127700,128000,0,0,0
190.263631,0,455,355,100,-100,127700,128000,20613,170887,145287
190.263631,1,325,232,93,-93,127700,128000,14173,45627,21819
190.263631,2,1797,1758,39,-39,127700,128000,4112,-210612,-220596
190.263631,3,235,144,91,-91,127700,128000,3952,50548,27252
190.263631,4,80,50,30,-30,127700,128000,-1644,-11956,-19636
190.263631,5,1195,1142,53,-53,127700,128000,2805,-97705,-111273
190.263631,6,0,0,0,0,127700,128000,0,0,0
190.542095,0,455,355,100,-100,127700,128000,20613,170887,145287
190.542095,1,325,232,93,-93,127700,128000,14173,45627,21819
190.542095,2,1797,1758,39,-39,127700,128000,4112,-210612,-220596
190.542095,3,235,144,91,-91,127700,128000,3952,50548,27252
190.542095,4,80,50,30,-30,127700,128000,-1644,-11956,-19636
190.542095,5,1195,1142,53,-53,127700,128000,2805,-97705,-111273
190.542095,6,0,0,0,0,127700,128000,0,0,0
190.767968,0,455,355,100,-100,127800,128000,20613,170887,150887
190.767968,1,325,232,93,-93,127800,128000,14173,45627,27027
190.767968,2,1807,1760,47,-47,127800,128000,3958,-207258,-216658
190.767968,3,237,144,93,-93,127800,128000,4003,50897,32297
190.767968,4,80,50,30,-30,127800,128000,-1644,-11956,-17956
190.767968,5,1195,1152,43,-43,127800,128000,3060,-103960,-112560
190.767968,6,0,0,0,0,127800,128000,0,0,0
191.018536,0,455,355,100,-100,127800,128000,20613,170887,150887
191.018536,1,325,232,93,-93,127800,128000,14173,45627,27027
191.018536,2,1807,1760,47,-47,127800,128000,3958,-207258,-216658
191.018536,3,237,144,93,-93,127800,128000,4003,50897,32297
191.018536,4,80,50,30,-30,127800,128000,-1644,-11956,-17956
191.018536,5,1195,1152,43,-43,127800,128000,3060,-103960,-112560
191.018536,6,0,0,0,0,127800,128000,0,0,0
191.254256,0,455,355,100,-100,127400,128000,20613,170887,145287
191.254256,1,325,232,93,-93,127400,128000,14173,45627,21819
191.254256,2,1807,1760,47,-47,127400,128000,3958,-207258,-219290
191.254256,3,237,144,93,-93,127400,128000,4003,50897,27089
191.254256,4,80,50,30,-30,127400,128000,-1644,-11956,-19636
191.254256,5,1205,1152,53,-53,127400,128000,2932,-99832,-113400
191.254256,6,0,0,0,0,127400,128000,0,0,0
191.504328,0,455,355,100,-100,127600,128000,20613,170887,145287
191.504328,1,325,232,93,-93,127600,128000,14173,45627,21819
191.504328,2,1817,1760,57,-57,127600,128000,4213,-203513,-218105
191.504328,3,237,144,93,-93,127600,128000,4003,50897,27089
191.504328,4,80,50,30,-30,127600,128000,-1644,-11956,-19636
191.504328,5,1205,1162,43,-43,127600,128000,2804,-105704,-116712
191.504328,6,0,0,0,0,127600,128000,0,0,0
191.720494,0,455,355,100,-100,127600,128100,20613,170887,145287
191.720494,1,325,232,93,-93,127600,128100,14173,45627,21819
191.720494,2,1817,1770,47,-47,127600,128100,4468,-209768,-221800
191.720494,3,237,144,93,-93,127600,128100,4003,50897,27089
191.720494,4,80,50,30,-30,127600,128100,-1644,-11956,-19636
191.720494,5,1215,1162,53,-53,127600,128100,2676,-101576,-115144
191.720494,6,0,0,0,0,127600,128100,0,0,0
191.956173,0,455,355,100,-100,127600,128200,20613,170887,145287
191.956173,1,325,232,93,-93,127600,128200,14173,45627,21819
191.956173,2,1817,1770,47,-47,127600,128200,4468,-209768,-221800
191.956173,3,237,144,93,-93,127600,128200,4003,50897,27089
191.956173,4,80,50,30,-30,127600,128200,-1644,-11956,-19636
191.956173,5,1215,1162,53,-53,127600,128200,2676,-101576,-115144
191.956173,6,0,0,0,0,127600,128200,0,0,0
192.294114,0,455,355,100,-100,127800,128200,20613,170887,145287
192.294114,1,325,232,93,-93,127800,128200,14173,45627,21819
192.294114,2,1827,1770,57,-57,127800,128200,4724,-206024,-220616
192.294114,3,237,144,93,-93,127800,128200,4003,50897,27089
192.294114,4,80,50,30,-30,127800,128200,-1644,-11956,-19636
192.294114,5,1215,1172,43,-43,127800,128200,2548,-107448,-118456
192.294114,6,0,0,0,0,127800,128200,0,0,0
192.547362,0,455,355,100,-100,127800,128200,20613,170887,145287
192.547362,1,325,232,93,-93,127800,128200,14173,45627,21819
192.547362,2,1827,1770,57,-57,127800,128200,4724,-206024,-220616
192.547362,3,237,144,93,-93,127800,128200,4003,50897,27089
192.547362,4,80,50,30,-30,127800,128200,-1644,-11956,-19636
192.547362,5,1215,1172,43,-43,127800,128200,2548,-107448,-118456
192.547362,6,0,0,0,0,127800,128200,0,0,0
192.785694,0,455,355,100,-100,127800,128200,20613,170887,145287
192.785694,1,325,232,93,-93,127800,128200,14173,45627,21819
192.785694,2,1827,1770,57,-57,127800,128200,4724,-206024,-220616
192.785694,3,237,144,93,-93,127800,128200,4003,50897,27089
192.785694,4,80,50,30,-30,127800,128200,-1644,-11956,-19636
192.785694,5,1215,1172,43,-43,127800,128200,2548,-107448,-118456
192.785694,6,0,0,0,0,127800,128200,0,0,0
193.01704,0,455,355,100,-100,127800,128200,20613,170887,145287
193.01704,1,325,232,93,-93,127800,128200,14173,45627,21819
193.01704,2,1827,1770,57,-57,127800,128200,4724,-206024,-220616
193.01704,3,237,144,93,-93,127800,128200,4003,50897,27089
193.01704,4,80,50,30,-30,127800,128200,-1644,-11956,-19636
193.01704,5,1215,1172,43,-43,127800,128200,2548,-107448,-118456
193.01704,6,0,0,0,0,127800,128200,0,0,0
193.265191,0,455,355,100,-100,127800,128200,20613,170887,145287
193.265191,1,325,232,93,-93,127800,128200,14173,45627,21819
193.265191,2,1827,1770,57,-57,127800,128200,4724,-206024,-220616
193.265191,3,237,144,93,-93,127800,128200,4003,50897,27089
193.265191,4,80,50,30,-30,127800,128200,-1644,-11956,-19636
193.265191,5,1215,1172,43,-43,127800,128200,2548,-107448,-118456
193.265191,6,0,0,0,0,127800,128200,0,0,0
193.522279,0,455,355,100,-100,127800,128200,20613,170887,145287
193.522279,1,325,232,93,-93,127800,128200,14173,45627,21819
193.522279,2,1827,1770,57,-57,127800,128200,4724,-206024,-220616
193.522279,3,237,144,93,-93,127800,128200,4003,50897,27089
193.522279,4,80,50,30,-30,127800,128200,-1644,-11956,-19636
193.522279,5,1215,1172,43,-43,127800,128200,2548,-107448,-118456
193.522279,6,0,0,0,0,127800,128200,0,0,0
193.703164,0,455,355,100,-100,127700,128200,20613,170887,145287
193.703164,1,325,232,93,-93,127700,128200,14173,45627,21819
193.703164,2,1827,1780,47,-47,127700,128200,4596,-210896,-222928
193.703164,3,237,144,93,-93,127700,128200,4003,50897,27089
193.703164,4,80,50,30,-30,127700,128200,-1644,-11956,-19636
193.703164,5,1225,1172,53,-53,127700,128200,2803,-103703,-117271
193.703164,6,0,0,0,0,127700,128200,0,0,0
194.038989,0,455,355,100,-100,127900,128200,20613,170887,145287
194.038989,1,325,232,93,-93,127900,128200,14173,45627,21819
194.038989,2,1837,1785,52,-52,127900,128200,4787,-209087,-222399
194.038989,3,237,144,93,-93,127900,128200,4003,50897,27089
194.038989,4,80,50,30,-30,127900,128200,-1644,-11956,-19636
194.038989,5,1225,1182,43,-43,127900,128200,2675,-109575,-120583
194.038989,6,0,0,0,0,127900,128200,0,0,0
194.212251,0,455,355,100,-100,127900,128200,20613,170887,145287
194.212251,1,325,232,93,-93,127900,128200,14173,45627,21819
194.212251,2,1837,1785,52,-52,127900,128200,4787,-209087,-222399
194.212251,3,237,144,93,-93,127900,128200,4003,50897,27089
194.212251,4,80,50,30,-30,127900,128200,-1644,-11956,-19636
194.212251,5,1225,1182,43,-43,127900,128200,2675,-109575,-120583
194.212251,6,0,0,0,0,127900,128200,0,0,0
194.525518,0,455,355,100,-100,128100,128200,20613,170887,160887
194.525518,1,325,232,93,-93,128100,128200,14173,45627,36327
194.525518,2,1837,1795,42,-42,128100,128200,4659,-213959,-218159
194.525518,3,237,144,93,-93,128100,128200,4003,50897,41597
194.525518,4,80,50,30,-30,128100,128200,-1644,-11956,-14956
194.525518,5,1225,1182,43,-43,128100,128200,2675,-109575,-113875
194.525518,6,0,0,0,0,128100,128200,0,0,0
194.7673,0,455,355,100,-100,128100,128200,20613,170887,160887
194.7673,1,325,232,93,-93,128100,128200,14173,45627,36327
194.7673,2,1837,1795,42,-42,128100,128200,4659,-213959,-218159
194.7673,3,237,144,93,-93,128100,128200,4003,50897,41597
194.7673,4,80,50,30,-30,128100,128200,-1644,-11956,-14956
194.7673,5,1225,1182,43,-43,128100,128200,2675,-109575,-113875
194.7673,6,0,0,0,0,128100,128200,0,0,0
195.045419,0,455,355,100,-100,128100,128200,20613,170887,160887
195.045419,1,325,232,93,-93,128100,128200,14173,45627,36327
195.045419,2,1837,1795,42,-42,128100,128200,4659,-213959,-218159
195.045419,3,237,144,93,-93,128100,128200,4003,50897,41597
195.045419,4,80,50,30,-30,128100,128200,-1644,-11956,-14956
195.045419,5,1225,1182,43,-43,128100,128200,2675,-109575,-113875
195.045419,6,0,0,0,0,128100,128200,0,0,0
195.275726,0,455,355,100,-100,128100,128100,20613,170887,170887
195.275726,1,325,232,93,-93,128100,128100,14173,45627,45627
195.275726,2,1837,1795,42,-42,128100,128100,4659,-213959,-213959
195.275726,3,237,144,93,-93,128100,128100,4003,50897,50897
195.275726,4,80,50,30,-30,128100,128100,-1644,-11956,-11956
195.275726,5,1225,1182,43,-43,128100,128100,2675,-109575,-109575
195.275726,6,0,0,0,0,128100,128100,0,0,0
195.488577,0,455,355,100,-100,127800,128100,20613,170887,145287
195.488577,1,325,232,93,-93,127800,128100,14173,45627,21819
195.488577,2,1837,1805,32,-32,127800,128100,4915,-217215,-225407
195.488577,3,237,144,93,-93,127800,128100,4003,50897,27089
195.488577,4,80,50,30,-30,127800,128100,-1644,-11956,-19636
195.488577,5,1235,1182,53,-53,127800,128100,2547,-107447,-121015
195.488577,6,0,0,0,0,127800,128100,0,0,0
195.70526,0,455,355,100,-100,127800,128100,20613,170887,145287
195.70526,1,325,232,93,-93,127800,128100,14173,45627,21819
195.70526,2,1837,1805,32,-32,127800,128100,4915,-217215,-225407
195.70526,3,237,144,93,-93,127800,128100,4003,50897,27089
195.70526,4,80,50,30,-30,127800,128100,-1644,-11956,-19636
195.70526,5,1235,1182,53,-53,127800,128100,2547,-107447,-121015
195.70526,6,0,0,0,0,127800,128100,0,0,0
196.048224,0,455,355,100,-100,127800,128100,20613,170887,145287
196.048224,1,325,232,93,-93,127800,128100,14173,45627,21819
196.048224,2,1837,1805,32,-32,127800,128100,4915,-217215,-225407
196.048224,3,237,144,93,-93,127800,128100,4003,50897,27089
196.048224,4,80,50,30,-30,127800,128100,-1644,-11956,-19636
196.048224,5,1235,1182,53,-53,127800,128100,2547,-107447,-121015
196.048224,6,0,0,0,0,127800,128100,0,0,0
196.207469,0,455,355,100,-100,127800,128100,20613,170887,145287
196.207469,1,325,232,93,-93,127800,128100,14173,45627,21819
196.207469,2,1837,1805,32,-32,127800,128100,4915,-217215,-225407
196.207469,3,237,144,93,-93,127800,128100,4003,50897,27089
196.207469,4,80,50,30,-30,127800,128100,-1644,-11956,-19636
196.207469,5,1235,1182,53,-53,127800,128100,2547,-107447,-121015
196.207469,6,0,0,0,0,127800,128100,0,0,0
196.463302,0,455,355,100,-100,127800,128100,20613,170887,145287
196.463302,1,325,232,93,-93,127800,128100,14173,45627,21819
196.463302,2,1837,1805,32,-32,127800,128100,4915,-217215,-225407
196.463302,3,237,144,93,-93,127800,128100,4003,50897,27089
196.463302,4,80,50,30,-30,127800,128100,-1644,-11956,-19636
196.463302,5,1235,1182,53,-53,127800,128100,2547,-107447,-121015
196.463302,6,0,0,0,0,127800,128100,0,0,0
196.784294,0,455,355,100,-100,127800,128000,20613,170887,150887
196.784294,1,325,232,93,-93,127800,128000,14173,45627,27027
196.784294,2,1837,1805,32,-32,127800,128000,4915,-217215,-223615
196.784294,3,237,144,93,-93,127800,128000,4003,50897,32297
196.784294,4,80,50,30,-30,127800,128000,-1644,-11956,-17956
196.784294,5,1235,1182,53,-53,127800,128000,2547,-107447,-118047
196.784294,6,0,0,0,0,127800,128000,0,0,0
196.961872,0,455,355,100,-100,127800,128000,20613,170887,150887
196.961872,1,325,232,93,-93,127800,128000,14173,45627,27027
196.961872,2,1837,1805,32,-32,127800,128000,4915,-217215,-223615
196.961872,3,237,144,93,-93,127800,128000,4003,50897,32297
196.961872,4,80,50,30,-30,127800,128000,-1644,-11956,-17956
196.961872,5,1235,1182,53,-53,127800,128000,2547,-107447,-118047
196.961872,6,0,0,0,0,127800,128000,0,0,0
197.277822,0,455,355,100,-100,127800,128000,20613,170887,150887
197.277822,1,325,232,93,-93,127800,128000,14173,45627,27027
197.277822,2,1837,1805,32,-32,127800,128000,4915,-217215,-223615
197.277822,3,237,144,93,-93,127800,128000,4003,50897,32297
197.277822,4,80,50,30,-30,127800,128000,-1644,-11956,-17956
197.277822,5,1235,1182,53,-53,127800,128000,2547,-107447,-118047
197.277822,6,0,0,0,0,127800,128000,0,0,0
197.524309,0,455,355,100,-100,127600,128000,20613,170887,145287
197.524309,1,325,232,93,-93,127600,128000,14173,45627,21819
197.524309,2,1847,1815,32,-32,127600,128000,5042,-219342,-227534
197.524309,3,237,144,93,-93,127600,128000,4003,50897,27089
197.524309,4,80,50,30,-30,127600,128000,-1644,-11956,-19636
197.524309,5,1245,1192,53,-53,127600,128000,2674,-109574,-123142
197.524309,6,0,0,0,0,127600,128000,0,0,0
197.79124,0,455,355,100,-100,127600,128000,20613,170887,145287
197.79124,1,325,232,93,-93,127600,128000,14173,45627,21819
197.79124,2,1847,1815,32,-32,127600,128000,5042,-219342,-227534
197.79124,3,237,144,93,-93,127600,128000,4003,50897,27089
197.79124,4,80,50,30,-30,127600,128000,-1644,-11956,-19636
197.79124,5,1245,1192,53,-53,127600,128000,2674,-109574,-123142
197.79124,6,0,0,0,0,127600,128000,0,0,0
197.962324,0,455,355,100,-100,127600,128000,20613,170887,145287
197.962324,1,325,232,93,-93,127600,128000,14173,45627,21819
197.962324,2,1847,1815,32,-32,127600,128000,5042,-219342,-227534
197.962324,3,237,144,93,-93,127600,128000,4003,50897,27089
197.962324,4,80,50,30,-30,127600,128000,-1644,-11956,-19636
197.962324,5,1245,1192,53,-53,127600,128000,2674,-109574,-123142
197.962324,6,0,0,0,0,127600,128000,0,0,0
198.292764,0,455,355,100,-100,127600,128000,20613,170887,145287
198.292764,1,325,232,93,-93,127600,128000,14173,45627,21819
198.292764,2,1847,1815,32,-32,127600,128000,5042,-219342,-227534
198.292764,3,237,144,93,-93,127600,128000,4003,50897,27089
198.292764,4,80,50,30,-30,127600,128000,-1644,-11956,-19636
198.292764,5,1245,1192,53,-53,127600,128000,2674,-109574,-123142
198.292764,6,0,0,0,0,127600,128000,0,0,0
198.527297,0,455,355,100,-100,127600,128000,20613,170887,145287
198.527297,1,325,232,93,-93,127600,128000,14173,45627,21819
198.527297,2,1847,1815,32,-32,127600,128000,5042,-219342,-227534
198.527297,3,237,144,93,-93,127600,128000,4003,50897,27089
198.527297,4,80,50,30,-30,127600,128000,-1644,-11956,-19636
198.527297,5,1245,1192,53,-53,127600,128000,2674,-109574,-123142
198.527297,6,0,0,0,0,127600,128000,0,0,0
198.72581,0,455,355,100,-100,127600,127900,20613,170887,145287
198.72581,1,325,232,93,-93,127600,127900,14173,45627,21819
198.72581,2,1847,1815,32,-32,127600,127900,5042,-219342,-227534
198.72581,3,237,144,93,-93,127600,127900,4003,50897,27089
198.72581,4,80,50,30,-30,127600,127900,-1644,-11956,-19636
198.72581,5,1245,1192,53,-53,127600,127900,2674,-109574,-123142
198.72581,6,0,0,0,0,127600,127900,0,0,0
199.029076,0,455,355,100,-100,128100,127900,20613,170887,190887
199.029076,1,325,232,93,-93,128100,127900,14173,45627,64227
199.029076,2,1847,1825,22,-22,128100,127900,4914,-222214,-217814
199.029076,3,237,144,93,-93,128100,127900,4003,50897,69497
199.029076,4,80,50,30,-30,128100,127900,-1644,-11956,-5956
199.029076,5,1245,1192,53,-53,128100,127900,2674,-109574,-98974
199.029076,6,0,0,0,0,128100,127900,0,0,0
199.246137,0,455,355,100,-100,127500,127900,20613,170887,145287
199.246137,1,325,232,93,-93,127500,127900,14173,45627,21819
199.246137,2,1857,1825,32,-32,127500,127900,4786,-221086,-229278
199.246137,3,237,144,93,-93,127500,127900,4003,50897,27089
199.246137,4,80,50,30,-30,127500,127900,-1644,-11956,-19636
199.246137,5,1245,1192,53,-53,127500,127900,2674,-109574,-123142
199.246137,6,0,0,0,0,127500,127900,0,0,0
199.48413,0,455,355,100,-100,127400,127900,20613,170887,145287
199.48413,1,325,232,93,-93,127400,127900,14173,45627,21819
199.48413,2,1859,1825,34,-34,127400,127900,4761,-220461,-229165
199.48413,3,237,144,93,-93,127400,127900,4003,50897,27089
199.48413,4,80,50,30,-30,127400,127900,-1644,-11956,-19636
199.48413,5,1245,1192,53,-53,127400,127900,2674,-109574,-123142
199.48413,6,0,0,0,0,127400,127900,0,0,0
199.785121,0,455,355,100,-100,127400,127900,20613,170887,145287
199.785121,1,325,232,93,-93,127400,127900,14173,45627,21819
199.785121,2,1859,1825,34,-34,127400,127900,4761,-220461,-229165
199.785121,3,237,144,93,-93,127400,127900,4003,50897,27089
199.785121,4,80,50,30,-30,127400,127900,-1644,-11956,-19636
199.785121,5,1245,1192,53,-53,127400,127900,2674,-109574,-123142
199.785121,6,0,0,0,0,127400,127900,0,0,0
199.969996,0,455,355,100,-100,127400,127900,20613,170887,145287
199.969996,1,325,232,93,-93,127400,127900,14173,45627,21819
199.969996,2,1869,1825,44,-44,127400,127900,4710,-216410,-227674
199.969996,3,237,144,93,-93,127400,127900,4003,50897,27089
199.969996,4,80,50,30,-30,127400,127900,-1644,-11956,-19636
199.969996,5,1245,1202,43,-43,127400,127900,2853,-114753,-125761
199.969996,6,0,0,0,0,127400,127900,0,0,0
200.260887,0,455,355,100,-100,127500,127900,20613,170887,145287
200.260887,1,325,232,93,-93,127500,127900,14173,45627,21819
200.260887,2,1869,1835,34,-34,127500,127900,4965,-220665,-229369
200.260887,3,237,144,93,-93,127500,127900,4003,50897,27089
200.260887,4,80,50,30,-30,127500,127900,-1644,-11956,-19636
200.260887,5,1255,1202,53,-53,127500,127900,2725,-111625,-125193
200.260887,6,0,0,0,0,127500,127900,0,0,0
200.524788,0,455,355,100,-100,127500,127500,20613,170887,170887
200.524788,1,325,232,93,-93,127500,127500,14173,45627,45627
200.524788,2,1869,1835,34,-34,127500,127500,4965,-220665,-220665
200.524788,3,237,144,93,-93,127500,127500,4003,50897,50897
200.524788,4,80,50,30,-30,127500,127500,-1644,-11956,-11956
200.524788,5,1255,1202,53,-53,127500,127500,2725,-111625,-111625
200.524788,6,0,0,0,0,127500,127500,0,0,0
200.738863,0,455,355,100,-100,127300,127400,20613,170887,160887
200.738863,1,325,232,93,-93,127300,127400,14173,45627,36327
200.738863,2,1869,1838,31,-31,127300,127400,5041,-221641,-224741
200.738863,3,237,144,93,-93,127300,127400,4003,50897,41597
200.738863,4,80,50,30,-30,127300,127400,-1644,-11956,-14956
200.738863,5,1255,1202,53,-53,127300,127400,2725,-111625,-116925
200.738863,6,0,0,0,0,127300,127400,0,0,0
200.972472,0,455,355,100,-100,127200,127400,20613,170887,150887
200.972472,1,325,232,93,-93,127200,127400,14173,45627,27027
200.972472,2,1869,1855,14,-14,127200,127400,5206,-226206,-229006
200.972472,3,237,144,93,-93,127200,127400,4003,50897,32297
200.972472,4,80,50,30,-30,127200,127400,-1644,-11956,-17956
200.972472,5,1255,1202,53,-53,127200,127400,2725,-111625,-122225
200.972472,6,0,0,0,0,127200,127400,0,0,0
201.238656,0,455,355,100,-100,127200,127400,20613,170887,150887
201.238656,1,325,232,93,-93,127200,127400,14173,45627,27027
201.238656,2,1869,1855,14,-14,127200,127400,5206,-226206,-229006
201.238656,3,237,144,93,-93,127200,127400,4003,50897,32297
201.238656,4,80,50,30,-30,127200,127400,-1644,-11956,-17956
201.238656,5,1255,1212,43,-43,127200,127400,2979,-114879,-123479
201.238656,6,0,0,0,0,127200,127400,0,0,0
201.535099,0,455,355,100,-100,127200,127400,20613,170887,150887
201.535099,1,325,232,93,-93,127200,127400,14173,45627,27027
201.535099,2,1869,1855,14,-14,127200,127400,5206,-226206,-229006
201.535099,3,237,144,93,-93,127200,127400,4003,50897,32297
201.535099,4,80,50,30,-30,127200,127400,-1644,-11956,-17956
201.535099,5,1255,1212,43,-43,127200,127400,2979,-114879,-123479
201.535099,6,0,0,0,0,127200,127400,0,0,0
201.701745,0,455,355,100,-100,127100,127400,20613,170887,145387
201.701745,1,325,232,93,-93,127100,127400,14173,45627,21912
201.701745,2,1879,1855,24,-24,127100,127400,5078,-225078,-231198
201.701745,3,237,144,93,-93,127100,127400,4003,50897,27182
201.701745,4,80,50,30,-30,127100,127400,-1644,-11956,-19606
201.701745,5,1255,1222,33,-33,127100,127400,3234,-118134,-126549
201.701745,6,0,0,0,0,127100,127400,0,0,0
202.008451,0,455,355,100,-100,127100,127400,20613,170887,145387
202.008451,1,325,232,93,-93,127100,127400,14173,45627,21912
202.008451,2,1879,1855,24,-24,127100,127400,5078,-225078,-231198
202.008451,3,237,144,93,-93,127100,127400,4003,50897,27182
202.008451,4,80,50,30,-30,127100,127400,-1644,-11956,-19606
202.008451,5,1255,1222,33,-33,127100,127400,3234,-118134,-126549
202.008451,6,0,0,0,0,127100,127400,0,0,0
202.244876,0,455,355,100,-100,128100,127400,20613,170887,196387
202.244876,1,325,232,93,-93,128100,127400,14173,45627,69342
202.244876,2,1879,1865,14,-14,128100,127400,4950,-225950,-222380
202.244876,3,237,144,93,-93,128100,127400,4003,50897,74612
202.244876,4,80,50,30,-30,128100,127400,-1644,-11956,-4306
202.244876,5,1255,1232,23,-23,128100,127400,3106,-120006,-114141
202.244876,6,0,0,0,0,128100,127400,0,0,0
202.494031,0,455,355,100,-100,128100,127400,20613,170887,196387
202.494031,1,325,232,93,-93,128100,127400,14173,45627,69342
202.494031,2,1879,1865,14,-14,128100,127400,4950,-225950,-222380
202.494031,3,237,144,93,-93,128100,127400,4003,50897,74612
202.494031,4,80,50,30,-30,128100,127400,-1644,-11956,-4306
202.494031,5,1255,1232,23,-23,128100,127400,3106,-120006,-114141
202.494031,6,0,0,0,0,128100,127400,0,0,0
202.775109,0,455,355,100,-100,128100,127400,20613,170887,196387
202.775109,1,325,232,93,-93,128100,127400,14173,45627,69342
202.775109,2,1879,1865,14,-14,128100,127400,4950,-225950,-222380
202.775109,3,237,144,93,-93,128100,127400,4003,50897,74612
202.775109,4,80,50,30,-30,128100,127400,-1644,-11956,-4306
202.775109,5,1255,1232,23,-23,128100,127400,3106,-120006,-114141
202.775109,6,0,0,0,0,128100,127400,0,0,0
202.960292,0,455,355,100,-100,128100,127400,20613,170887,196387
202.960292,1,325,232,93,-93,128100,127400,14173,45627,69342
202.960292,2,1879,1865,14,-14,128100,127400,4950,-225950,-222380
202.960292,3,237,144,93,-93,128100,127400,4003,50897,74612
202.960292,4,80,50,30,-30,128100,127400,-1644,-11956,-4306
202.960292,5,1255,1232,23,-23,128100,127400,3106,-120006,-114141
202.960292,6,0,0,0,0,128100,127400,0,0,0
203.298157,0,455,355,100,-100,128100,127400,20613,170887,196387
203.298157,1,325,232,93,-93,128100,127400,14173,45627,69342
203.298157,2,1879,1865,14,-14,128100,127400,4950,-225950,-222380
203.298157,3,237,144,93,-93,128100,127400,4003,50897,74612
203.298157,4,80,50,30,-30,128100,127400,-1644,-11956,-4306
203.298157,5,1255,1232,23,-23,128100,127400,3106,-120006,-114141
203.298157,6,0,0,0,0,128100,127400,0,0,0
203.501434,0,455,355,100,-100,128100,127400,20613,170887,196387
203.501434,1,325,232,93,-93,128100,127400,14173,45627,69342
203.501434,2,1879,1865,14,-14,128100,127400,4950,-225950,-222380
203.501434,3,237,144,93,-93,128100,127400,4003,50897,74612
203.501434,4,80,50,30,-30,128100,127400,-1644,-11956,-4306
203.501434,5,1255,1232,23,-23,128100,127400,3106,-120006,-114141
203.501434,6,0,0,0,0,128100,127400,0,0,0
203.767753,0,455,355,100,-100,128100,127400,20613,170887,196387
203.767753,1,325,232,93,-93,128100,127400,14173,45627,69342
203.767753,2,1879,1865,14,-14,128100,127400,4950,-225950,-222380
203.767753,3,237,144,93,-93,128100,127400,4003,50897,74612
203.767753,4,80,50,30,-30,128100,127400,-1644,-11956,-4306
203.767753,5,1255,1232,23,-23,128100,127400,3106,-120006,-114141
203.767753,6,0,0,0,0,128100,127400,0,0,0
204.003412,0,455,355,100,-100,128100,127500,20613,170887,196387
204.003412,1,325,232,93,-93,128100,127500,14173,45627,69342
204.003412,2,1879,1865,14,-14,128100,127500,4950,-225950,-222380
204.003412,3,237,144,93,-93,128100,127500,4003,50897,74612
204.003412,4,80,50,30,-30,128100,127500,-1644,-11956,-4306
204.003412,5,1255,1232,23,-23,128100,127500,3106,-120006,-114141
204.003412,6,0,0,0,0,128100,127500,0,0,0
204.23988,0,455,355,100,-100,128000,127400,20613,170887,196387
204.23988,1,325,232,93,-93,128000,127400,14173,45627,69342
204.23988,2,1879,1875,4,-4,128000,127400,4823,-226823,-225803
204.23988,3,237,153,84,-84,128000,127400,4155,49945,71365
204.23988,4,80,50,30,-30,128000,127400,-1644,-11956,-4306
204.23988,5,1255,1232,23,-23,128000,127400,3106,-120006,-114141
204.23988,6,0,0,0,0,128000,127400,0,0,0
204.536483,0,455,355,100,-100,128000,127400,20613,170887,196387
204.536483,1,325,232,93,-93,128000,127400,14173,45627,69342
204.536483,2,1879,1875,4,-4,128000,127400,4823,-226823,-225803
204.536483,3,237,153,84,-84,128000,127400,4155,49945,71365
204.536483,4,80,50,30,-30,128000,127400,-1644,-11956,-4306
204.536483,5,1255,1232,23,-23,128000,127400,3106,-120006,-114141
204.536483,6,0,0,0,0,128000,127400,0,0,0
204.735132,0,455,355,100,-100,128000,127400,20613,170887,196387
204.735132,1,325,232,93,-93,128000,127400,14173,45627,69342
204.735132,2,1879,1885,-6,6,128000,127400,4695,-226695,-228225
204.735132,3,237,155,82,-82,128000,127400,4129,50571,71481
204.735132,4,80,50,30,-30,128000,127400,-1644,-11956,-4306
204.735132,5,1255,1232,23,-23,128000,127400,3106,-120006,-114141
204.735132,6,0,0,0,0,128000,127400,0,0,0
205.029888,0,455,355,100,-100,128000,127400,20613,170887,196387
205.029888,1,325,232,93,-93,128000,127400,14173,45627,69342
205.029888,2,1879,1885,-6,6,128000,127400,4695,-226695,-228225
205.029888,3,237,155,82,-82,128000,127400,4129,50571,71481
205.029888,4,80,50,30,-30,128000,127400,-1644,-11956,-4306
205.029888,5,1255,1232,23,-23,128000,127400,3106,-120006,-114141
205.029888,6,0,0,0,0,128000,127400,0,0,0
205.298462,0,455,355,100,-100,128000,127400,20613,170887,196387
205.298462,1,325,232,93,-93,128000,127400,14173,45627,69342
205.298462,2,1879,1885,-6,6,128000,127400,4695,-226695,-228225
205.298462,3,237,155,82,-82,128000,127400,4129,50571,71481
205.298462,4,80,50,30,-30,128000,127400,-1644,-11956,-4306
205.298462,5,1255,1232,23,-23,128000,127400,3106,-120006,-114141
205.298462,6,0,0,0,0,128000,127400,0,0,0
205.489866,0,455,355,100,-100,128000,127400,20613,170887,196387
205.489866,1,325,232,93,-93,128000,127400,14173,45627,69342
205.489866,2,1879,1885,-6,6,128000,127400,4695,-226695,-228225
205.489866,3,237,155,82,-82,128000,127400,4129,50571,71481
205.489866,4,80,50,30,-30,128000,127400,-1644,-11956,-4306
205.489866,5,1255,1232,23,-23,128000,127400,3106,-120006,-114141
205.489866,6,0,0,0,0,128000,127400,0,0,0
205.799246,0,455,355,100,-100,128000,127400,20613,170887,196387
205.799246,1,325,232,93,-93,128000,127400,14173,45627,69342
205.799246,2,1879,1885,-6,6,128000,127400,4695,-226695,-228225
205.799246,3,237,155,82,-82,128000,127400,4129,50571,71481
205.799246,4,80,50,30,-30,128000,127400,-1644,-11956,-4306
205.799246,5,1255,1232,23,-23,128000,127400,3106,-120006,-114141
205.799246,6,0,0,0,0,128000,127400,0,0,0
206.021793,0,455,355,100,-100,127400,127300,20613,170887,180887
206.021793,1,325,232,93,-93,127400,127300,14173,45627,54927
206.021793,2,1885,1885,0,0,127400,127300,4619,-227219,-227219
206.021793,3,237,161,76,-76,127400,127300,4282,50418,58018
206.021793,4,80,50,30,-30,127400,127300,-1644,-11956,-8956
206.021793,5,1255,1232,23,-23,127400,127300,3106,-120006,-117706
206.021793,6,0,0,0,0,127400,127300,0,0,0
206.273365,0,455,355,100,-100,127300,127300,20613,170887,170887
206.273365,1,325,232,93,-93,127300,127300,14173,45627,45627
206.273365,2,1885,1895,-10,10,127300,127300,4874,-227474,-227474
206.273365,3,237,173,64,-64,127300,127300,4588,50112,50112
206.273365,4,80,50,30,-30,127300,127300,-1644,-11956,-11956
206.273365,5,1255,1232,23,-23,127300,127300,3106,-120006,-120006
206.273365,6,0,0,0,0,127300,127300,0,0,0
206.526908,0,455,355,100,-100,127300,127300,20613,170887,170887
206.526908,1,325,232,93,-93,127300,127300,14173,45627,45627
206.526908,2,1885,1895,-10,10,127300,127300,4874,-227474,-227474
206.526908,3,237,173,64,-64,127300,127300,4588,50112,50112
206.526908,4,80,50,30,-30,127300,127300,-1644,-11956,-11956
206.526908,5,1255,1232,23,-23,127300,127300,3106,-120006,-120006
206.526908,6,0,0,0,0,127300,127300,0,0,0
206.752705,0,455,355,100,-100,127300,127200,20613,170887,180887
206.752705,1,325,232,93,-93,127300,127200,14173,45627,54927
206.752705,2,1885,1895,-10,10,127300,127200,4874,-227474,-228474
206.752705,3,237,173,64,-64,127300,127200,4588,50112,56512
206.752705,4,80,50,30,-30,127300,127200,-1644,-11956,-8956
206.752705,5,1255,1232,23,-23,127300,127200,3106,-120006,-117706
206.752705,6,0,0,0,0,127300,127200,0,0,0
207.041796,0,455,355,100,-100,127300,127200,20613,170887,180887
207.041796,1,325,261,64,-64,127300,127200,14912,47788,54188
207.041796,2,1885,1905,-20,20,127300,127200,5129,-226729,-228729
207.041796,3,237,178,59,-59,127300,127200,4715,50485,56385
207.041796,4,80,50,30,-30,127300,127200,-1644,-11956,-8956
207.041796,5,1255,1232,23,-23,127300,127200,3106,-120006,-117706
207.041796,6,0,0,0,0,127300,127200,0,0,0
207.240594,0,455,355,100,-100,127100,127200,20613,170887,160887
207.240594,1,325,261,64,-64,127100,127200,14912,47788,41388
207.240594,2,1895,1905,-10,10,127100,127200,5002,-229202,-228202
207.240594,3,237,182,55,-55,127100,127200,4817,50783,45283
207.240594,4,80,50,30,-30,127100,127200,-1644,-11956,-14956
207.240594,5,1255,1232,23,-23,127100,127200,3106,-120006,-122306
207.240594,6,0,0,0,0,127100,127200,0,0,0
207.487817,0,455,355,100,-100,127200,127200,20613,170887,170887
207.487817,1,325,261,64,-64,127200,127200,14912,47788,47788
207.487817,2,1899,1905,-6,6,127200,127200,4951,-229551,-229551
207.487817,3,237,186,51,-51,127200,127200,4919,50681,50681
207.487817,4,80,50,30,-30,127200,127200,-1644,-11956,-11956
207.487817,5,1255,1232,23,-23,127200,127200,3106,-120006,-120006
207.487817,6,0,0,0,0,127200,127200,0,0,0
207.732237,0,455,355,100,-100,127200,127200,20613,170887,170887
207.732237,1,325,261,64,-64,127200,127200,14912,47788,47788
207.732237,2,1899,1905,-6,6,127200,127200,4951,-229551,-229551
207.732237,3,237,186,51,-51,127200,127200,4919,50681,50681
207.732237,4,80,50,30,-30,127200,127200,-1644,-11956,-11956
207.732237,5,1255,1232,23,-23,127200,127200,3106,-120006,-120006
207.732237,6,0,0,0,0,127200,127200,0,0,0
208.042384,0,455,355,100,-100,127300,127300,20613,170887,170887
208.042384,1,325,261,64,-64,127300,127300,14912,47788,47788
208.042384,2,1909,1905,4,-4,127300,127300,5206,-229806,-229806
208.042384,3,237,186,51,-51,127300,127300,4919,50681,50681
208.042384,4,80,50,30,-30,127300,127300,-1644,-11956,-11956
208.042384,5,1255,1242,13,-13,127300,127300,2979,-121879,-121879
208.042384,6,0,0,0,0,127300,127300,0,0,0
208.259704,0,455,355,100,-100,127300,127300,20613,170887,170887
208.259704,1,325,261,64,-64,127300,127300,14912,47788,47788
208.259704,2,1909,1905,4,-4,127300,127300,5206,-229806,-229806
208.259704,3,237,186,51,-51,127300,127300,4919,50681,50681
208.259704,4,80,50,30,-30,127300,127300,-1644,-11956,-11956
208.259704,5,1255,1242,13,-13,127300,127300,2979,-121879,-121879
208.259704,6,0,0,0,0,127300,127300,0,0,0
208.45716,0,455,355,100,-100,127300,127200,20613,170887,180887
208.45716,1,325,261,64,-64,127300,127200,14912,47788,54188
208.45716,2,1909,1905,4,-4,127300,127200,5206,-229806,-229406
208.45716,3,237,186,51,-51,127300,127200,4919,50681,55781
208.45716,4,80,50,30,-30,127300,127200,-1644,-11956,-8956
208.45716,5,1255,1242,13,-13,127300,127200,2979,-121879,-120579
208.45716,6,0,0,0,0,127300,127200,0,0,0
208.768385,0,455,355,100,-100,127100,127000,20613,170887,180887
208.768385,1,325,261,64,-64,127100,127000,14912,47788,54188
208.768385,2,1917,1905,12,-12,127100,127000,5104,-229704,-228504
208.768385,3,237,194,43,-43,127100,127000,5123,49677,53977
208.768385,4,80,50,30,-30,127100,127000,-1644,-11956,-8956
208.768385,5,1255,1242,13,-13,127100,127000,2979,-121879,-120579
208.768385,6,0,0,0,0,127100,127000,0,0,0
209.027862,0,455,355,100,-100,126900,127000,20613,170887,160887
209.027862,1,325,261,64,-64,126900,127000,14912,47788,41388
209.027862,2,1923,1915,8,-8,126900,127000,5282,-230282,-231082
209.027862,3,237,200,37,-37,126900,127000,5275,48325,44625
209.027862,4,80,50,30,-30,126900,127000,-1644,-11956,-14956
209.027862,5,1265,1242,23,-23,126900,127000,2852,-121752,-124052
209.027862,6,0,0,0,0,126900,127000,0,0,0
209.255732,0,455,355,100,-100,126600,127000,20613,170887,145487
209.255732,1,325,261,64,-64,126600,127000,14912,47788,31532
209.255732,2,1933,1915,18,-18,126600,127000,5155,-231155,-235727
209.255732,3,239,200,39,-39,126600,127000,5250,48750,38844
209.255732,4,80,50,30,-30,126600,127000,-1644,-11956,-19576
209.255732,5,1275,1242,33,-33,126600,127000,2725,-121625,-130007
209.255732,6,0,0,0,0,126600,127000,0,0,0
209.548928,0,455,355,100,-100,126600,126900,20613,170887,145487
209.548928,1,325,261,64,-64,126600,126900,14912,47788,31532
209.548928,2,1943,1915,28,-28,126600,126900,5028,-230028,-237140
209.548928,3,239,200,39,-39,126600,126900,5250,48750,38844
209.548928,4,80,50,30,-30,126600,126900,-1644,-11956,-19576
209.548928,5,1285,1242,43,-43,126600,126900,2598,-119498,-130420
209.548928,6,0,0,0,0,126600,126900,0,0,0
209.752759,0,455,355,100,-100,126600,126900,20613,170887,145487
209.752759,1,325,261,64,-64,126600,126900,14912,47788,31532
209.752759,2,1943,1915,28,-28,126600,126900,5028,-230028,-237140
209.752759,3,239,200,39,-39,126600,126900,5250,48750,38844
209.752759,4,80,50,30,-30,126600,126900,-1644,-11956,-19576
209.752759,5,1285,1242,43,-43,126600,126900,2598,-119498,-130420
209.752759,6,0,0,0,0,126600,126900,0,0,0
209.970607,0,455,355,100,-100,126700,126900,20613,170887,150887
209.970607,1,335,261,74,-74,126700,126900,15165,48535,33735
209.970607,2,1943,1925,18,-18,126700,126900,4901,-231901,-235501
209.970607,3,239,200,39,-39,126700,126900,5250,48750,40950
209.970607,4,80,50,30,-30,126700,126900,-1644,-11956,-17956
209.970607,5,1285,1242,43,-43,126700,126900,2598,-119498,-128098
209.970607,6,0,0,0,0,126700,126900,0,0,0
210.27199,0,455,355,100,-100,126700,126900,20613,170887,150887
210.27199,1,335,261,74,-74,126700,126900,15165,48535,33735
210.27199,2,1943,1925,18,-18,126700,126900,4901,-231901,-235501
210.27199,3,239,200,39,-39,126700,126900,5250,48750,40950
210.27199,4,80,50,30,-30,126700,126900,-1644,-11956,-17956
210.27199,5,1285,1242,43,-43,126700,126900,2598,-119498,-128098
210.27199,6,0,0,0,0,126700,126900,0,0,0
210.454507,0,455,355,100,-100,126700,126900,20613,170887,150887
210.454507,1,335,261,74,-74,126700,126900,15165,48535,33735
210.454507,2,1943,1925,18,-18,126700,126900,4901,-231901,-235501
210.454507,3,239,200,39,-39,126700,126900,5250,48750,40950
210.454507,4,80,50,30,-30,126700,126900,-1644,-11956,-17956
210.454507,5,1285,1242,43,-43,126700,126900,2598,-119498,-128098
210.454507,6,0,0,0,0,126700,126900,0,0,0
210.747099,0,455,355,100,-100,127000,127000,20613,170887,170887
210.747099,1,335,261,74,-74,127000,127000,15165,48535,48535
210.747099,2,1953,1935,18,-18,127000,127000,4647,-232647,-232647
210.747099,3,239,200,39,-39,127000,127000,5250,48750,48750
210.747099,4,80,50,30,-30,127000,127000,-1644,-11956,-11956
210.747099,5,1285,1252,33,-33,127000,127000,2852,-122752,-122752
210.747099,6,0,0,0,0,127000,127000,0,0,0
211.006239,0,455,355,100,-100,126600,127000,20613,170887,145487
211.006239,1,335,261,74,-74,126600,127000,15165,48535,29739
211.006239,2,1963,1945,18,-18,126600,127000,4774,-230774,-235346
211.006239,3,239,205,34,-34,126600,127000,5301,49299,40663
211.006239,4,80,50,30,-30,126600,127000,-1644,-11956,-19576
211.006239,5,1295,1252,43,-43,126600,127000,2725,-119625,-130547
211.006239,6,0,0,0,0,126600,127000,0,0,0
211.271131,0,455,355,100,-100,126900,127000,20613,170887,160887
211.271131,1,335,261,74,-74,126900,127000,15165,48535,41135
211.271131,2,1968,1945,23,-23,126900,127000,4711,-230211,-232511
211.271131,3,239,207,32,-32,126900,127000,5352,48848,45648
211.271131,4,80,50,30,-30,126900,127000,-1644,-11956,-14956
211.271131,5,1295,1252,43,-43,126900,127000,2725,-119625,-123925
211.271131,6,0,0,0,0,126900,127000,0,0,0
211.504786,0,455,355,100,-100,126900,127000,20613,170887,160887
211.504786,1,335,261,74,-74,126900,127000,15165,48535,41135
211.504786,2,1968,1945,23,-23,126900,127000,4711,-230211,-232511
211.504786,3,239,207,32,-32,126900,127000,5352,48848,45648
211.504786,4,80,50,30,-30,126900,127000,-1644,-11956,-14956
211.504786,5,1295,1252,43,-43,126900,127000,2725,-119625,-123925
211.504786,6,0,0,0,0,126900,127000,0,0,0
211.74985,0,455,355,100,-100,126900,127000,20613,170887,160887
211.74985,1,335,261,74,-74,126900,127000,15165,48535,41135
211.74985,2,1976,1945,31,-31,126900,127000,4914,-228014,-231114
211.74985,3,241,207,34,-34,126900,127000,5403,49397,45997
211.74985,4,80,50,30,-30,126900,127000,-1644,-11956,-14956
211.74985,5,1295,1262,33,-33,126900,127000,2598,-123498,-126798
211.74985,6,0,0,0,0,126900,127000,0,0,0
212.02649,0,455,355,100,-100,126900,127000,20613,170887,160887
212.02649,1,335,261,74,-74,126900,127000,15165,48535,41135
212.02649,2,1976,1945,31,-31,126900,127000,4914,-228014,-231114
212.02649,3,241,207,34,-34,126900,127000,5403,49397,45997
212.02649,4,80,50,30,-30,126900,127000,-1644,-11956,-14956
212.02649,5,1295,1262,33,-33,126900,127000,2598,-123498,-126798
212.02649,6,0,0,0,0,126900,127000,0,0,0
212.214495,0,455,355,100,-100,126900,127000,20613,170887,160887
212.214495,1,335,261,74,-74,126900,127000,15165,48535,41135
212.214495,2,1976,1945,31,-31,126900,127000,4914,-228014,-231114
212.214495,3,241,207,34,-34,126900,127000,5403,49397,45997
212.214495,4,80,50,30,-30,126900,127000,-1644,-11956,-14956
212.214495,5,1295,1262,33,-33,126900,127000,2598,-123498,-126798
212.214495,6,0,0,0,0,126900,127000,0,0,0
212.534273,0,455,355,100,-100,126900,127000,20613,170887,160887
212.534273,1,335,261,74,-74,126900,127000,15165,48535,41135
212.534273,2,1976,1945,31,-31,126900,127000,4914,-228014,-231114
212.534273,3,241,207,34,-34,126900,127000,5403,49397,45997
212.534273,4,80,50,30,-30,126900,127000,-1644,-11956,-14956
212.534273,5,1295,1262,33,-33,126900,127000,2598,-123498,-126798
212.534273,6,0,0,0,0,126900,127000,0,0,0
212.76126,0,455,355,100,-100,127200,127000,20613,170887,190887
212.76126,1,355,261,94,-94,127200,127000,15673,50027,68827
212.76126,2,1976,1955,21,-21,127200,127000,4787,-230887,-226687
212.76126,3,241,207,34,-34,127200,127000,5403,49397,56197
212.76126,4,80,50,30,-30,127200,127000,-1644,-11956,-5956
212.76126,5,1295,1272,23,-23,127200,127000,2471,-126371,-121771
212.76126,6,0,0,0,0,127200,127000,0,0,0
213.015549,0,455,355,100,-100,127200,127000,20613,170887,190887
213.015549,1,355,261,94,-94,127200,127000,15673,50027,68827
213.015549,2,1976,1955,21,-21,127200,127000,4787,-230887,-226687
213.015549,3,241,207,34,-34,127200,127000,5403,49397,56197
213.015549,4,80,50,30,-30,127200,127000,-1644,-11956,-5956
213.015549,5,1295,1272,23,-23,127200,127000,2471,-126371,-121771
213.015549,6,0,0,0,0,127200,127000,0,0,0
213.288151,0,455,355,100,-100,127200,127000,20613,170887,190887
213.288151,1,355,261,94,-94,127200,127000,15673,50027,68827
213.288151,2,1976,1955,21,-21,127200,127000,4787,-230887,-226687
213.288151,3,241,207,34,-34,127200,127000,5403,49397,56197
213.288151,4,80,50,30,-30,127200,127000,-1644,-11956,-5956
213.288151,5,1295,1272,23,-23,127200,127000,2471,-126371,-121771
213.288151,6,0,0,0,0,127200,127000,0,0,0
213.461296,0,455,355,100,-100,127200,127000,20613,170887,190887
213.461296,1,355,261,94,-94,127200,127000,15673,50027,68827
213.461296,2,1976,1955,21,-21,127200,127000,4787,-230887,-226687
213.461296,3,241,207,34,-34,127200,127000,5403,49397,56197
213.461296,4,80,50,30,-30,127200,127000,-1644,-11956,-5956
213.461296,5,1295,1272,23,-23,127200,127000,2471,-126371,-121771
213.461296,6,0,0,0,0,127200,127000,0,0,0
213.721579,0,455,355,100,-100,127200,127000,20613,170887,190887
213.721579,1,355,261,94,-94,127200,127000,15673,50027,68827
213.721579,2,1976,1955,21,-21,127200,127000,4787,-230887,-226687
213.721579,3,241,207,34,-34,127200,127000,5403,49397,56197
213.721579,4,80,50,30,-30,127200,127000,-1644,-11956,-5956
213.721579,5,1295,1272,23,-23,127200,127000,2471,-126371,-121771
213.721579,6,0,0,0,0,127200,127000,0,0,0
214.024716,0,455,355,100,-100,127000,127000,20613,170887,170887
214.024716,1,355,261,94,-94,127000,127000,15673,50027,50027
214.024716,2,1986,1955,31,-31,127000,127000,4660,-228760,-228760
214.024716,3,241,207,34,-34,127000,127000,5403,49397,49397
214.024716,4,80,50,30,-30,127000,127000,-1644,-11956,-11956
214.024716,5,1305,1272,33,-33,127000,127000,2344,-124244,-124244
214.024716,6,0,0,0,0,127000,127000,0,0,0
214.200657,0,455,355,100,-100,127200,127000,20613,170887,190887
214.200657,1,355,261,94,-94,127200,127000,15673,50027,68827
214.200657,2,1996,1956,40,-40,127200,127000,4901,-226301,-218301
214.200657,3,243,207,36,-36,127200,127000,5454,49946,57146
214.200657,4,80,50,30,-30,127200,127000,-1644,-11956,-5956
214.200657,5,1305,1272,33,-33,127200,127000,2344,-124244,-117644
214.200657,6,0,0,0,0,127200,127000,0,0,0
214.479078,0,455,355,100,-100,127200,127000,20613,170887,190887
214.479078,1,355,261,94,-94,127200,127000,15673,50027,68827
214.479078,2,1996,1956,40,-40,127200,127000,4901,-226301,-218301
214.479078,3,243,207,36,-36,127200,127000,5454,49946,57146
214.479078,4,80,50,30,-30,127200,127000,-1644,-11956,-5956
214.479078,5,1305,1272,33,-33,127200,127000,2344,-124244,-117644
214.479078,6,0,0,0,0,127200,127000,0,0,0
214.787677,0,455,355,100,-100,127200,127000,20613,170887,190887
214.787677,1,355,261,94,-94,127200,127000,15673,50027,68827
214.787677,2,1996,1956,40,-40,127200,127000,4901,-226301,-218301
214.787677,3,243,207,36,-36,127200,127000,5454,49946,57146
214.787677,4,80,50,30,-30,127200,127000,-1644,-11956,-5956
214.787677,5,1305,1272,33,-33,127200,127000,2344,-124244,-117644
214.787677,6,0,0,0,0,127200,127000,0,0,0
215.005016,0,455,355,100,-100,127200,127000,20613,170887,190887
215.005016,1,355,261,94,-94,127200,127000,15673,50027,68827
215.005016,2,1996,1956,40,-40,127200,127000,4901,-226301,-218301
215.005016,3,243,207,36,-36,127200,127000,5454,49946,57146
215.005016,4,80,50,30,-30,127200,127000,-1644,-11956,-5956
215.005016,5,1305,1272,33,-33,127200,127000,2344,-124244,-117644
215.005016,6,0,0,0,0,127200,127000,0,0,0
215.247935,0,455,355,100,-100,127200,127000,20613,170887,190887
215.247935,1,355,261,94,-94,127200,127000,15673,50027,68827
215.247935,2,1996,1956,40,-40,127200,127000,4901,-226301,-218301
215.247935,3,243,207,36,-36,127200,127000,5454,49946,57146
215.247935,4,80,50,30,-30,127200,127000,-1644,-11956,-5956
215.247935,5,1305,1272,33,-33,127200,127000,2344,-124244,-117644
215.247935,6,0,0,0,0,127200,127000,0,0,0
215.485862,0,455,355,100,-100,127200,127000,20613,170887,190887
215.485862,1,355,261,94,-94,127200,127000,15673,50027,68827
215.485862,2,1996,1956,40,-40,127200,127000,4901,-226301,-218301
215.485862,3,243,207,36,-36,127200,127000,5454,49946,57146
215.485862,4,80,50,30,-30,127200,127000,-1644,-11956,-5956
215.485862,5,1305,1272,33,-33,127200,127000,2344,-124244,-117644
215.485862,6,0,0,0,0,127200,127000,0,0,0
215.720916,0,455,355,100,-100,127000,127000,20613,170887,170887
215.720916,1,355,261,94,-94,127000,127000,15673,50027,50027
215.720916,2,1996,1966,30,-30,127000,127000,5155,-230555,-230555
215.720916,3,243,207,36,-36,127000,127000,5454,49946,49946
215.720916,4,80,50,30,-30,127000,127000,-1644,-11956,-11956
215.720916,5,1315,1272,43,-43,127000,127000,2217,-121117,-121117
215.720916,6,0,0,0,0,127000,127000,0,0,0
215.981058,0,455,355,100,-100,127000,127000,20613,170887,170887
215.981058,1,355,261,94,-94,127000,127000,15673,50027,50027
215.981058,2,1996,1966,30,-30,127000,127000,5155,-230555,-230555
215.981058,3,243,207,36,-36,127000,127000,5454,49946,49946
215.981058,4,80,50,30,-30,127000,127000,-1644,-11956,-11956
215.981058,5,1315,1272,43,-43,127000,127000,2217,-121117,-121117
215.981058,6,0,0,0,0,127000,127000,0,0,0
216.287945,0,455,355,100,-100,127000,127000,20613,170887,170887
216.287945,1,355,261,94,-94,127000,127000,15673,50027,50027
216.287945,2,2004,1966,38,-38,127000,127000,5053,-228853,-228853
216.287945,3,245,207,38,-38,127000,127000,5429,50371,50371
216.287945,4,80,50,30,-30,127000,127000,-1644,-11956,-11956
216.287945,5,1315,1282,33,-33,127000,127000,2471,-125371,-125371
216.287945,6,0,0,0,0,127000,127000,0,0,0
216.503993,0,455,355,100,-100,127000,127200,20613,170887,150887
216.503993,1,355,261,94,-94,127000,127200,15673,50027,31227
216.503993,2,2004,1976,28,-28,127000,127200,5307,-231107,-236707
216.503993,3,245,207,38,-38,127000,127200,5429,50371,42771
216.503993,4,80,50,30,-30,127000,127200,-1644,-11956,-17956
216.503993,5,1325,1282,43,-43,127000,127200,2344,-124244,-132844
216.503993,6,0,0,0,0,127000,127200,0,0,0
216.7938,0,455,355,100,-100,127000,127200,20613,170887,150887
216.7938,1,355,261,94,-94,127000,127200,15673,50027,31227
216.7938,2,2004,1976,28,-28,127000,127200,5307,-231107,-236707
216.7938,3,245,207,38,-38,127000,127200,5429,50371,42771
216.7938,4,80,50,30,-30,127000,127200,-1644,-11956,-17956
216.7938,5,1325,1282,43,-43,127000,127200,2344,-124244,-132844
216.7938,6,0,0,0,0,127000,127200,0,0,0
217.01623,0,455,355,100,-100,127000,127200,20613,170887,150887
217.01623,1,355,261,94,-94,127000,127200,15673,50027,31227
217.01623,2,2004,1976,28,-28,127000,127200,5307,-231107,-236707
217.01623,3,245,207,38,-38,127000,127200,5429,50371,42771
217.01623,4,80,50,30,-30,127000,127200,-1644,-11956,-17956
217.01623,5,1325,1282,43,-43,127000,127200,2344,-124244,-132844
217.01623,6,0,0,0,0,127000,127200,0,0,0
217.214108,0,455,355,100,-100,127000,127100,20613,170887,160887
217.214108,1,355,261,94,-94,127000,127100,15673,50027,40627
217.214108,2,2004,1976,28,-28,127000,127100,5307,-231107,-233907
217.214108,3,245,207,38,-38,127000,127100,5429,50371,46571
217.214108,4,80,50,30,-30,127000,127100,-1644,-11956,-14956
217.214108,5,1325,1282,43,-43,127000,127100,2344,-124244,-128544
217.214108,6,0,0,0,0,127000,127100,0,0,0
217.499165,0,455,355,100,-100,126600,127100,20613,170887,145487
217.499165,1,355,261,94,-94,126600,127100,15673,50027,26151
217.499165,2,2014,1976,38,-38,126600,127100,5180,-228980,-238632
217.499165,3,247,207,40,-40,126600,127100,5404,50996,40836
217.499165,4,80,50,30,-30,126600,127100,-1644,-11956,-19576
217.499165,5,1335,1282,53,-53,126600,127100,2217,-121117,-134579
217.499165,6,0,0,0,0,126600,127100,0,0,0
217.769255,0,455,355,100,-100,126900,127100,20613,170887,150887
217.769255,1,355,261,94,-94,126900,127100,15673,50027,31227
217.769255,2,2014,1986,28,-28,126900,127100,5434,-231234,-236834
217.769255,3,247,207,40,-40,126900,127100,5404,50996,42996
217.769255,4,80,50,30,-30,126900,127100,-1644,-11956,-17956
217.769255,5,1335,1282,53,-53,126900,127100,2217,-121117,-131717
217.769255,6,0,0,0,0,126900,127100,0,0,0
218.026429,0,455,355,100,-100,126900,126800,20613,170887,180887
218.026429,1,355,261,94,-94,126900,126800,15673,50027,59427
218.026429,2,2014,1989,25,-25,126900,126800,5510,-231610,-229110
218.026429,3,247,207,40,-40,126900,126800,5404,50996,54996
218.026429,4,80,50,30,-30,126900,126800,-1644,-11956,-8956
218.026429,5,1335,1282,53,-53,126900,126800,2217,-121117,-115817
218.026429,6,0,0,0,0,126900,126800,0,0,0
218.264293,0,455,355,100,-100,127100,126600,20613,170887,196187
218.264293,1,355,261,94,-94,127100,126600,15673,50027,73809
218.264293,2,2034,1999,35,-35,127100,126600,5509,-230609,-221754
218.264293,3,249,212,37,-37,127100,126600,5430,50270,59631
218.264293,4,80,50,30,-30,127100,126600,-1644,-11956,-4366
218.264293,5,1355,1292,63,-63,127100,126600,2596,-122496,-106557
218.264293,6,0,0,0,0,127100,126600,0,0,0
218.519589,0,455,385,70,-70,127200,126600,21374,171626,189336
218.519589,1,355,261,94,-94,127200,126600,15673,50027,73809
218.519589,2,2034,2009,25,-25,127200,126600,5764,-224864,-218539
218.519589,3,249,220,29,-29,127200,126600,5633,54867,62204
218.519589,4,80,50,30,-30,127200,126600,-1644,-11956,-4366
218.519589,5,1355,1292,63,-63,127200,126600,2596,-122496,-106557
218.519589,6,0,0,0,0,127200,126600,0,0,0
218.793425,0,455,385,70,-70,127200,126600,21374,171626,189336
218.793425,1,355,261,94,-94,127200,126600,15673,50027,73809
218.793425,2,2034,2009,25,-25,127200,126600,5764,-224864,-218539
218.793425,3,249,220,29,-29,127200,126600,5633,54867,62204
218.793425,4,80,50,30,-30,127200,126600,-1644,-11956,-4366
218.793425,5,1355,1292,63,-63,127200,126600,2596,-122496,-106557
218.793425,6,0,0,0,0,127200,126600,0,0,0
218.979723,0,455,385,70,-70,126000,126600,21374,171626,153916
218.979723,1,355,261,94,-94,126000,126600,15673,50027,26245
218.979723,2,2044,2009,35,-35,126000,126600,5638,-222738,-231593
218.979723,3,251,220,31,-31,126000,126600,5608,55492,47649
218.979723,4,80,50,30,-30,126000,126600,-1644,-11956,-19546
218.979723,5,1355,1292,63,-63,126000,126600,2596,-122496,-138435
218.979723,6,0,0,0,0,126000,126600,0,0,0
219.25239,0,455,385,70,-70,126000,126600,21374,171626,153916
219.25239,1,355,261,94,-94,126000,126600,15673,50027,26245
219.25239,2,2044,2009,35,-35,126000,126600,5638,-222738,-231593
219.25239,3,251,220,31,-31,126000,126600,5608,55492,47649
219.25239,4,80,50,30,-30,126000,126600,-1644,-11956,-19546
219.25239,5,1355,1292,63,-63,126000,126600,2596,-122496,-138435
219.25239,6,0,0,0,0,126000,126600,0,0,0
219.466934,0,455,385,70,-70,126000,126600,21374,171626,153916
219.466934,1,355,261,94,-94,126000,126600,15673,50027,26245
219.466934,2,2044,2009,35,-35,126000,126600,5638,-222738,-231593
219.466934,3,251,220,31,-31,126000,126600,5608,55492,47649
219.466934,4,80,50,30,-30,126000,126600,-1644,-11956,-19546
219.466934,5,1355,1292,63,-63,126000,126600,2596,-122496,-138435
219.466934,6,0,0,0,0,126000,126600,0,0,0
219.726875,0,465,385,80,-80,126400,126700,21627,173373,153133
219.726875,1,355,261,94,-94,126400,126700,15673,50027,26245
219.726875,2,2044,2019,25,-25,126400,126700,5512,-225612,-231937
219.726875,3,251,220,31,-31,126400,126700,5608,55492,47649
219.726875,4,80,50,30,-30,126400,126700,-1644,-11956,-19546
219.726875,5,1355,1292,63,-63,126400,126700,2596,-122496,-138435
219.726875,6,0,0,0,0,126400,126700,0,0,0
219.997662,0,465,385,80,-80,126400,126700,21627,173373,153133
219.997662,1,355,261,94,-94,126400,126700,15673,50027,26245
219.997662,2,2044,2019,25,-25,126400,126700,5512,-225612,-231937
219.997662,3,251,220,31,-31,126400,126700,5608,55492,47649
219.997662,4,80,50,30,-30,126400,126700,-1644,-11956,-19546
219.997662,5,1355,1292,63,-63,126400,126700,2596,-122496,-138435
219.997662,6,0,0,0,0,126400,126700,0,0,0
220.272357,0,465,385,80,-80,126400,126700,21627,173373,153133
220.272357,1,355,261,94,-94,126400,126700,15673,50027,26245
220.272357,2,2044,2019,25,-25,126400,126700,5512,-225612,-231937
220.272357,3,251,220,31,-31,126400,126700,5608,55492,47649
220.272357,4,80,50,30,-30,126400,126700,-1644,-11956,-19546
220.272357,5,1355,1292,63,-63,126400,126700,2596,-122496,-138435
220.272357,6,0,0,0,0,126400,126700,0,0,0
220.533187,0,465,385,80,-80,126400,126700,21627,173373,153133
220.533187,1,355,261,94,-94,126400,126700,15673,50027,26245
220.533187,2,2044,2019,25,-25,126400,126700,5512,-225612,-231937
220.533187,3,251,220,31,-31,126400,126700,5608,55492,47649
220.533187,4,80,50,30,-30,126400,126700,-1644,-11956,-19546
220.533187,5,1355,1292,63,-63,126400,126700,2596,-122496,-138435
220.533187,6,0,0,0,0,126400,126700,0,0,0
220.70718,0,465,385,80,-80,126400,126700,21627,173373,153133
220.70718,1,355,261,94,-94,126400,126700,15673,50027,26245
220.70718,2,2044,2019,25,-25,126400,126700,5512,-225612,-231937
220.70718,3,251,220,31,-31,126400,126700,5608,55492,47649
220.70718,4,80,50,30,-30,126400,126700,-1644,-11956,-19546
220.70718,5,1355,1292,63,-63,126400,126700,2596,-122496,-138435
220.70718,6,0,0,0,0,126400,126700,0,0,0
221.01826,0,465,385,80,-80,126400,126700,21627,173373,153133
221.01826,1,355,261,94,-94,126400,126700,15673,50027,26245
221.01826,2,2044,2019,25,-25,126400,126700,5512,-225612,-231937
221.01826,3,251,220,31,-31,126400,126700,5608,55492,47649
221.01826,4,80,50,30,-30,126400,126700,-1644,-11956,-19546
221.01826,5,1355,1292,63,-63,126400,126700,2596,-122496,-138435
221.01826,6,0,0,0,0,126400,126700,0,0,0
221.282522,0,475,385,90,-90,126400,126700,21880,175120,152350
221.282522,1,355,261,94,-94,126400,126700,15673,50027,26245
221.282522,2,2044,2029,15,-15,126400,126700,5386,-228486,-232281
221.282522,3,251,220,31,-31,126400,126700,5608,55492,47649
221.282522,4,80,50,30,-30,126400,126700,-1644,-11956,-19546
221.282522,5,1355,1292,63,-63,126400,126700,2596,-122496,-138435
221.282522,6,0,0,0,0,126400,126700,0,0,0
221.451265,0,475,385,90,-90,126400,126700,21880,175120,152350
221.451265,1,355,261,94,-94,126400,126700,15673,50027,26245
221.451265,2,2050,2029,21,-21,126400,126700,5310,-228410,-233723
221.451265,3,251,220,31,-31,126400,126700,5608,55492,47649
221.451265,4,80,50,30,-30,126400,126700,-1644,-11956,-19546
221.451265,5,1355,1292,63,-63,126400,126700,2596,-122496,-138435
221.451265,6,0,0,0,0,126400,126700,0,0,0
221.709014,0,475,385,90,-90,126400,126700,21880,175120,152350
221.709014,1,355,261,94,-94,126400,126700,15673,50027,26245
221.709014,2,2050,2029,21,-21,126400,126700,5310,-228410,-233723
221.709014,3,251,220,31,-31,126400,126700,5608,55492,47649
221.709014,4,80,50,30,-30,126400,126700,-1644,-11956,-19546
221.709014,5,1355,1292,63,-63,126400,126700,2596,-122496,-138435
221.709014,6,0,0,0,0,126400,126700,0,0,0
221.958157,0,475,385,90,-90,126400,126700,21880,175120,152350
221.958157,1,355,261,94,-94,126400,126700,15673,50027,26245
221.958157,2,2050,2029,21,-21,126400,126700,5310,-228410,-233723
221.958157,3,251,220,31,-31,126400,126700,5608,55492,47649
221.958157,4,80,50,30,-30,126400,126700,-1644,-11956,-19546
221.958157,5,1355,1292,63,-63,126400,126700,2596,-122496,-138435
221.958157,6,0,0,0,0,126400,126700,0,0,0
222.297522,0,475,385,90,-90,126400,126700,21880,175120,152350
222.297522,1,355,261,94,-94,126400,126700,15673,50027,26245
222.297522,2,2050,2029,21,-21,126400,126700,5310,-228410,-233723
222.297522,3,251,220,31,-31,126400,126700,5608,55492,47649
222.297522,4,80,50,30,-30,126400,126700,-1644,-11956,-19546
222.297522,5,1355,1292,63,-63,126400,126700,2596,-122496,-138435
222.297522,6,0,0,0,0,126400,126700,0,0,0
222.465181,0,485,385,100,-100,126600,126700,22133,174867,164867
222.465181,1,355,261,94,-94,126600,126700,15673,50027,40627
222.465181,2,2060,2039,21,-21,126600,126700,5436,-227536,-229636
222.465181,3,251,220,31,-31,126600,126700,5608,55492,52392
222.465181,4,80,50,30,-30,126600,126700,-1644,-11956,-14956
222.465181,5,1355,1302,53,-53,126600,126700,2470,-127370,-132670
222.465181,6,0,0,0,0,126600,126700,0,0,0
222.703255,0,485,385,100,-100,126500,126700,22133,174867,154867
222.703255,1,355,261,94,-94,126500,126700,15673,50027,31227
222.703255,2,2070,2039,31,-31,126500,126700,5689,-225789,-231989
222.703255,3,251,220,31,-31,126500,126700,5608,55492,49292
222.703255,4,80,50,30,-30,126500,126700,-1644,-11956,-17956
222.703255,5,1355,1312,43,-43,126500,126700,2344,-131244,-139844
222.703255,6,0,0,0,0,126500,126700,0,0,0
223.037774,0,485,385,100,-100,126500,126700,22133,174867,154867
223.037774,1,355,261,94,-94,126500,126700,15673,50027,31227
223.037774,2,2070,2039,31,-31,126500,126700,5689,-225789,-231989
223.037774,3,251,220,31,-31,126500,126700,5608,55492,49292
223.037774,4,80,50,30,-30,126500,126700,-1644,-11956,-17956
223.037774,5,1355,1312,43,-43,126500,126700,2344,-131244,-139844
223.037774,6,0,0,0,0,126500,126700,0,0,0
223.265916,0,485,385,100,-100,126500,126700,22133,174867,154867
223.265916,1,355,261,94,-94,126500,126700,15673,50027,31227
223.265916,2,2070,2039,31,-31,126500,126700,5689,-225789,-231989
223.265916,3,251,220,31,-31,126500,126700,5608,55492,49292
223.265916,4,80,50,30,-30,126500,126700,-1644,-11956,-17956
223.265916,5,1355,1312,43,-43,126500,126700,2344,-131244,-139844
223.265916,6,0,0,0,0,126500,126700,0,0,0
223.476413,0,485,385,100,-100,126400,126700,22133,174867,149567
223.476413,1,355,261,94,-94,126400,126700,15673,50027,26245
223.476413,2,2070,2049,21,-21,126400,126700,5942,-229042,-234355
223.476413,3,251,220,31,-31,126400,126700,5608,55492,47649
223.476413,4,80,50,30,-30,126400,126700,-1644,-11956,-19546
223.476413,5,1365,1312,53,-53,126400,126700,2218,-130118,-143527
223.476413,6,0,0,0,0,126400,126700,0,0,0
223.745318,0,485,385,100,-100,126400,126700,22133,174867,149567
223.745318,1,355,261,94,-94,126400,126700,15673,50027,26245
223.745318,2,2070,2049,21,-21,126400,126700,5942,-229042,-234355
223.745318,3,251,220,31,-31,126400,126700,5608,55492,47649
223.745318,4,80,50,30,-30,126400,126700,-1644,-11956,-19546
223.745318,5,1365,1312,53,-53,126400,126700,2218,-130118,-143527
223.745318,6,0,0,0,0,126400,126700,0,0,0
223.95042,0,485,385,100,-100,126400,126700,22133,174867,149567
223.95042,1,355,261,94,-94,126400,126700,15673,50027,26245
223.95042,2,2070,2049,21,-21,126400,126700,5942,-229042,-234355
223.95042,3,251,220,31,-31,126400,126700,5608,55492,47649
223.95042,4,80,50,30,-30,126400,126700,-1644,-11956,-19546
223.95042,5,1365,1312,53,-53,126400,126700,2218,-130118,-143527
223.95042,6,0,0,0,0,126400,126700,0,0,0
224.249692,0,485,385,100,-100,126100,126700,22133,174867,149567
224.249692,1,355,261,94,-94,126100,126700,15673,50027,26245
224.249692,2,2073,2049,24,-24,126100,126700,5904,-228104,-234176
224.249692,3,251,220,31,-31,126100,126700,5608,55492,47649
224.249692,4,80,50,30,-30,126100,126700,-1644,-11956,-19546
224.249692,5,1365,1312,53,-53,126100,126700,2218,-130118,-143527
224.249692,6,0,0,0,0,126100,126700,0,0,0
224.501472,0,485,385,100,-100,126000,126700,22133,174867,149567
224.501472,1,355,261,94,-94,126000,126700,15673,50027,26245
224.501472,2,2080,2049,31,-31,126000,126700,5816,-225916,-233759
224.501472,3,251,220,31,-31,126000,126700,5608,55492,47649
224.501472,4,80,50,30,-30,126000,126700,-1644,-11956,-19546
224.501472,5,1365,1322,43,-43,126000,126700,2471,-135671,-146550
224.501472,6,0,0,0,0,126000,126700,0,0,0
224.719544,0,485,385,100,-100,126000,126500,22133,174867,149567
224.719544,1,355,261,94,-94,126000,126500,15673,50027,26245
224.719544,2,2080,2049,31,-31,126000,126500,5816,-225916,-233759
224.719544,3,251,220,31,-31,126000,126500,5608,55492,47649
224.719544,4,80,50,30,-30,126000,126500,-1644,-11956,-19546
224.719544,5,1365,1322,43,-43,126000,126500,2471,-135671,-146550
224.719544,6,0,0,0,0,126000,126500,0,0,0
224.984204,0,485,385,100,-100,126000,126600,22133,174867,149567
224.984204,1,355,261,94,-94,126000,126600,15673,50027,26245
224.984204,2,2080,2049,31,-31,126000,126600,5816,-225916,-233759
224.984204,3,251,220,31,-31,126000,126600,5608,55492,47649
224.984204,4,80,50,30,-30,126000,126600,-1644,-11956,-19546
224.984204,5,1365,1322,43,-43,126000,126600,2471,-135671,-146550
224.984204,6,0,0,0,0,126000,126600,0,0,0
225.253714,0,485,385,100,-100,126000,126600,22133,174867,149567
225.253714,1,355,261,94,-94,126000,126600,15673,50027,26245
225.253714,2,2080,2049,31,-31,126000,126600,5816,-225916,-233759
225.253714,3,251,220,31,-31,126000,126600,5608,55492,47649
225.253714,4,80,50,30,-30,126000,126600,-1644,-11956,-19546
225.253714,5,1365,1322,43,-43,126000,126600,2471,-135671,-146550
225.253714,6,0,0,0,0,126000,126600,0,0,0
225.477808,0,485,385,100,-100,126000,126600,22133,174867,149567
225.477808,1,355,261,94,-94,126000,126600,15673,50027,26245
225.477808,2,2080,2049,31,-31,126000,126600,5816,-225916,-233759
225.477808,3,251,220,31,-31,126000,126600,5608,55492,47649
225.477808,4,80,50,30,-30,126000,126600,-1644,-11956,-19546
225.477808,5,1365,1322,43,-43,126000,126600,2471,-135671,-146550
225.477808,6,0,0,0,0,126000,126600,0,0,0
225.714203,0,485,385,100,-100,126500,126600,22133,174867,164867
225.714203,1,355,261,94,-94,126500,126600,15673,50027,40627
225.714203,2,2080,2049,31,-31,126500,126600,5816,-225916,-229016
225.714203,3,253,220,33,-33,126500,126600,5659,55841,52541
225.714203,4,80,50,30,-30,126500,126600,-1644,-11956,-14956
225.714203,5,1365,1324,41,-41,126500,126600,2446,-136446,-140546
225.714203,6,0,0,0,0,126500,126600,0,0,0
225.994352,0,485,385,100,-100,126500,126600,22133,174867,164867
225.994352,1,355,261,94,-94,126500,126600,15673,50027,40627
225.994352,2,2080,2049,31,-31,126500,126600,5816,-225916,-229016
225.994352,3,253,220,33,-33,126500,126600,5659,55841,52541
225.994352,4,80,50,30,-30,126500,126600,-1644,-11956,-14956
225.994352,5,1365,1324,41,-41,126500,126600,2446,-136446,-140546
225.994352,6,0,0,0,0,126500,126600,0,0,0
226.202608,0,485,385,100,-100,126900,126600,22133,174867,200167
226.202608,1,355,261,94,-94,126900,126600,15673,50027,73809
226.202608,2,2080,2059,21,-21,126900,126600,5689,-228789,-223476
226.202608,3,253,220,33,-33,126900,126600,5659,55841,64190
226.202608,4,80,50,30,-30,126900,126600,-1644,-11956,-4366
226.202608,5,1365,1332,33,-33,126900,126600,2345,-139545,-131196
226.202608,6,0,0,0,0,126900,126600,0,0,0
226.48088,0,485,385,100,-100,126900,126600,22133,174867,200167
226.48088,1,355,261,94,-94,126900,126600,15673,50027,73809
226.48088,2,2080,2059,21,-21,126900,126600,5689,-228789,-223476
226.48088,3,253,220,33,-33,126900,126600,5659,55841,64190
226.48088,4,80,50,30,-30,126900,126600,-1644,-11956,-4366
226.48088,5,1365,1332,33,-33,126900,126600,2345,-139545,-131196
226.48088,6,0,0,0,0,126900,126600,0,0,0
226.775493,0,485,385,100,-100,126200,126600,22133,174867,149567
226.775493,1,355,261,94,-94,126200,126600,15673,50027,26245
226.775493,2,2090,2059,31,-31,126200,126600,5563,-226663,-234506
226.775493,3,255,220,35,-35,126200,126600,5634,56466,47611
226.775493,4,80,50,30,-30,126200,126600,-1644,-11956,-19546
226.775493,5,1375,1332,43,-43,126200,126600,2219,-135419,-146298
226.775493,6,0,0,0,0,126200,126600,0,0,0
226.954873,0,485,385,100,-100,126200,126600,22133,174867,149567
226.954873,1,355,261,94,-94,126200,126600,15673,50027,26245
226.954873,2,2090,2059,31,-31,126200,126600,5563,-226663,-234506
226.954873,3,255,220,35,-35,126200,126600,5634,56466,47611
226.954873,4,80,50,30,-30,126200,126600,-1644,-11956,-19546
226.954873,5,1375,1332,43,-43,126200,126600,2219,-135419,-146298
226.954873,6,0,0,0,0,126200,126600,0,0,0
227.266331,0,485,385,100,-100,126200,126600,22133,174867,149567
227.266331,1,355,261,94,-94,126200,126600,15673,50027,26245
227.266331,2,2090,2059,31,-31,126200,126600,5563,-226663,-234506
227.266331,3,255,220,35,-35,126200,126600,5634,56466,47611
227.266331,4,80,50,30,-30,126200,126600,-1644,-11956,-19546
227.266331,5,1375,1332,43,-43,126200,126600,2219,-135419,-146298
227.266331,6,0,0,0,0,126200,126600,0,0,0
227.47447,0,485,385,100,-100,126200,126600,22133,174867,149567
227.47447,1,355,261,94,-94,126200,126600,15673,50027,26245
227.47447,2,2100,2059,41,-41,126200,126600,5436,-223536,-233909
227.47447,3,257,220,37,-37,126200,126600,5609,57091,47730
227.47447,4,80,50,30,-30,126200,126600,-1644,-11956,-19546
227.47447,5,1385,1332,53,-53,126200,126600,2093,-130293,-143702
227.47447,6,0,0,0,0,126200,126600,0,0,0
227.7151,0,485,385,100,-100,126700,126600,22133,174867,184867
227.7151,1,355,261,94,-94,126700,126600,15673,50027,59427
227.7151,2,2100,2059,41,-41,126700,126600,5436,-223536,-219436
227.7151,3,259,220,39,-39,126700,126600,5584,57716,61616
227.7151,4,80,50,30,-30,126700,126600,-1644,-11956,-8956
227.7151,5,1385,1332,53,-53,126700,126600,2093,-130293,-124993
227.7151,6,0,0,0,0,126700,126600,0,0,0
228.039551,0,485,385,100,-100,126700,126600,22133,174867,184867
228.039551,1,355,261,94,-94,126700,126600,15673,50027,59427
228.039551,2,2100,2059,41,-41,126700,126600,5436,-223536,-219436
228.039551,3,261,220,41,-41,126700,126600,5635,58265,62365
228.039551,4,80,50,30,-30,126700,126600,-1644,-11956,-8956
228.039551,5,1385,1332,53,-53,126700,126600,2093,-130293,-124993
228.039551,6,0,0,0,0,126700,126600,0,0,0
228.290021,0,485,385,100,-100,126700,126600,22133,174867,184867
228.290021,1,355,261,94,-94,126700,126600,15673,50027,59427
228.290021,2,2100,2059,41,-41,126700,126600,5436,-223536,-219436
228.290021,3,261,220,41,-41,126700,126600,5635,58265,62365
228.290021,4,80,50,30,-30,126700,126600,-1644,-11956,-8956
228.290021,5,1385,1332,53,-53,126700,126600,2093,-130293,-124993
228.290021,6,0,0,0,0,126700,126600,0,0,0
228.525314,0,485,385,100,-100,126700,126600,22133,174867,184867
228.525314,1,355,261,94,-94,126700,126600,15673,50027,59427
228.525314,2,2100,2059,41,-41,126700,126600,5436,-223536,-219436
228.525314,3,261,220,41,-41,126700,126600,5635,58265,62365
228.525314,4,80,50,30,-30,126700,126600,-1644,-11956,-8956
228.525314,5,1385,1332,53,-53,126700,126600,2093,-130293,-124993
228.525314,6,0,0,0,0,126700,126600,0,0,0
228.74861,0,485,385,100,-100,126700,127100,22133,174867,149467
228.74861,1,355,261,94,-94,126700,127100,15673,50027,26151
228.74861,2,2100,2059,41,-41,126700,127100,5436,-223536,-233950
228.74861,3,261,220,41,-41,126700,127100,5635,58265,47851
228.74861,4,80,50,30,-30,126700,127100,-1644,-11956,-19576
228.74861,5,1385,1332,53,-53,126700,127100,2093,-130293,-143755
228.74861,6,0,0,0,0,126700,127100,0,0,0
228.987918,0,485,385,100,-100,126700,127400,22133,174867,149367
228.987918,1,355,261,94,-94,126700,127400,15673,50027,26057
228.987918,2,2110,2059,51,-51,126700,127400,5689,-219789,-232794
228.987918,3,263,220,43,-43,126700,127400,5686,59014,48049
228.987918,4,80,50,30,-30,126700,127400,-1644,-11956,-19606
228.987918,5,1385,1332,53,-53,126700,127400,2093,-130293,-143808
228.987918,6,0,0,0,0,126700,127400,0,0,0
229.264636,0,485,385,100,-100,126700,127400,22133,174867,149367
229.264636,1,355,261,94,-94,126700,127400,15673,50027,26057
229.264636,2,2120,2059,61,-61,126700,127400,5942,-215042,-230597
229.264636,3,265,220,45,-45,126700,127400,5737,59963,48488
229.264636,4,80,50,30,-30,126700,127400,-1644,-11956,-19606
229.264636,5,1385,1332,53,-53,126700,127400,2093,-130293,-143808
229.264636,6,0,0,0,0,126700,127400,0,0,0
229.506153,0,485,385,100,-100,127200,127400,22133,174867,154867
229.506153,1,355,261,94,-94,127200,127400,15673,50027,31227
229.506153,2,2120,2069,51,-51,127200,127400,5815,-219915,-230115
229.506153,3,267,220,47,-47,127200,127400,5788,60912,51512
229.506153,4,80,50,30,-30,127200,127400,-1644,-11956,-17956
229.506153,5,1385,1342,43,-43,127200,127400,1966,-134166,-142766
229.506153,6,0,0,0,0,127200,127400,0,0,0
229.765575,0,485,385,100,-100,126800,127400,22133,174867,149367
229.765575,1,355,261,94,-94,126800,127400,15673,50027,26057
229.765575,2,2120,2071,49,-49,126800,127400,5790,-220890,-233385
229.765575,3,269,220,49,-49,126800,127400,5839,61461,48966
229.765575,4,80,50,30,-30,126800,127400,-1644,-11956,-19606
229.765575,5,1385,1342,43,-43,126800,127400,1966,-134166,-145131
229.765575,6,0,0,0,0,126800,127400,0,0,0
229.96962,0,485,385,100,-100,126800,127400,22133,174867,149367
229.96962,1,355,261,94,-94,126800,127400,15673,50027,26057
229.96962,2,2120,2071,49,-49,126800,127400,5790,-220890,-233385
229.96962,3,269,220,49,-49,126800,127400,5839,61461,48966
229.96962,4,80,50,30,-30,126800,127400,-1644,-11956,-19606
229.96962,5,1385,1342,43,-43,126800,127400,1966,-134166,-145131
229.96962,6,0,0,0,0,126800,127400,0,0,0
230.272854,0,485,385,100,-100,126700,127400,22133,174867,149367
230.272854,1,355,261,94,-94,126700,127400,15673,50027,26057
230.272854,2,2120,2071,49,-49,126700,127400,5790,-220890,-233385
230.272854,3,271,220,51,-51,126700,127400,5814,61886,48881
230.272854,4,80,50,30,-30,126700,127400,-1644,-11956,-19606
230.272854,5,1385,1352,33,-33,126700,127400,2220,-139220,-147635
230.272854,6,0,0,0,0,126700,127400,0,0,0
230.538431,0,485,385,100,-100,126700,127400,22133,174867,149367
230.538431,1,355,261,94,-94,126700,127400,15673,50027,26057
230.538431,2,2120,2071,49,-49,126700,127400,5790,-220890,-233385
230.538431,3,271,220,51,-51,126700,127400,5814,61886,48881
230.538431,4,80,50,30,-30,126700,127400,-1644,-11956,-19606
230.538431,5,1385,1352,33,-33,126700,127400,2220,-139220,-147635
230.538431,6,0,0,0,0,126700,127400,0,0,0
230.746331,0,485,385,100,-100,126800,127100,22133,174867,149467
230.746331,1,355,261,94,-94,126800,127100,15673,50027,26151
230.746331,2,2120,2081,39,-39,126800,127100,5663,-223763,-233669
230.746331,3,271,220,51,-51,126800,127100,5814,61886,48932
230.746331,4,80,50,30,-30,126800,127100,-1644,-11956,-19576
230.746331,5,1395,1352,43,-43,126800,127100,2474,-138474,-149396
230.746331,6,0,0,0,0,126800,127100,0,0,0
230.991672,0,485,385,100,-100,126800,127100,22133,174867,149467
230.991672,1,355,261,94,-94,126800,127100,15673,50027,26151
230.991672,2,2130,2081,49,-49,126800,127100,5917,-221017,-233463
230.991672,3,271,220,51,-51,126800,127100,5814,61886,48932
230.991672,4,80,50,30,-30,126800,127100,-1644,-11956,-19576
230.991672,5,1395,1362,33,-33,126800,127100,2347,-143347,-151729
230.991672,6,0,0,0,0,126800,127100,0,0,0
231.259076,0,485,385,100,-100,126900,127100,22133,174867,154867
231.259076,1,355,261,94,-94,126900,127100,15673,50027,31227
231.259076,2,2130,2081,49,-49,126900,127100,5917,-221017,-230817
231.259076,3,275,220,55,-55,126900,127100,5916,62984,51984
231.259076,4,80,50,30,-30,126900,127100,-1644,-11956,-17956
231.259076,5,1405,1362,43,-43,126900,127100,2601,-140601,-149201
231.259076,6,0,0,0,0,126900,127100,0,0,0
231.513416,0,485,385,100,-100,126900,127100,22133,174867,154867
231.513416,1,355,261,94,-94,126900,127100,15673,50027,31227
231.513416,2,2130,2081,49,-49,126900,127100,5917,-221017,-230817
231.513416,3,277,220,57,-57,126900,127100,5967,63533,52133
231.513416,4,80,50,30,-30,126900,127100,-1644,-11956,-17956
231.513416,5,1405,1362,43,-43,126900,127100,2601,-140601,-149201
231.513416,6,0,0,0,0,126900,127100,0,0,0
231.762574,0,485,385,100,-100,126900,127100,22133,174867,154867
231.762574,1,355,261,94,-94,126900,127100,15673,50027,31227
231.762574,2,2130,2081,49,-49,126900,127100,5917,-221017,-230817
231.762574,3,277,220,57,-57,126900,127100,5967,63533,52133
231.762574,4,80,50,30,-30,126900,127100,-1644,-11956,-17956
231.762574,5,1405,1362,43,-43,126900,127100,2601,-140601,-149201
231.762574,6,0,0,0,0,126900,127100,0,0,0
232.037879,0,485,385,100,-100,126900,127200,22133,174867,149467
232.037879,1,355,261,94,-94,126900,127200,15673,50027,26151
232.037879,2,2130,2081,49,-49,126900,127200,5917,-221017,-233463
232.037879,3,279,220,59,-59,126900,127200,6018,63882,48896
232.037879,4,80,50,30,-30,126900,127200,-1644,-11956,-19576
232.037879,5,1405,1362,43,-43,126900,127200,2601,-140601,-151523
232.037879,6,0,0,0,0,126900,127200,0,0,0
232.26377,0,485,385,100,-100,126900,127200,22133,174867,149467
232.26377,1,355,261,94,-94,126900,127200,15673,50027,26151
232.26377,2,2130,2081,49,-49,126900,127200,5917,-221017,-233463
232.26377,3,279,220,59,-59,126900,127200,6018,63882,48896
232.26377,4,80,50,30,-30,126900,127200,-1644,-11956,-19576
232.26377,5,1405,1362,43,-43,126900,127200,2601,-140601,-151523
232.26377,6,0,0,0,0,126900,127200,0,0,0
232.54246,0,485,385,100,-100,126900,127200,22133,174867,149467
232.54246,1,355,261,94,-94,126900,127200,15673,50027,26151
232.54246,2,2130,2081,49,-49,126900,127200,5917,-221017,-233463
232.54246,3,283,220,63,-63,126900,127200,6120,64980,48978
232.54246,4,80,50,30,-30,126900,127200,-1644,-11956,-19576
232.54246,5,1405,1362,43,-43,126900,127200,2601,-140601,-151523
232.54246,6,0,0,0,0,126900,127200,0,0,0
232.701381,0,485,385,100,-100,126900,127200,22133,174867,149467
232.701381,1,355,261,94,-94,126900,127200,15673,50027,26151
232.701381,2,2130,2081,49,-49,126900,127200,5917,-221017,-233463
232.701381,3,285,220,65,-65,126900,127200,6171,65529,49019
232.701381,4,80,50,30,-30,126900,127200,-1644,-11956,-19576
232.701381,5,1405,1362,43,-43,126900,127200,2601,-140601,-151523
232.701381,6,0,0,0,0,126900,127200,0,0,0
232.955523,0,485,385,100,-100,127200,127200,22133,174867,174867
232.955523,1,355,261,94,-94,127200,127200,15673,50027,50027
232.955523,2,2130,2091,39,-39,127200,127200,5790,-223890,-223890
232.955523,3,287,220,67,-67,127200,127200,6222,66078,66078
232.955523,4,80,50,30,-30,127200,127200,-1644,-11956,-11956
232.955523,5,1405,1372,33,-33,127200,127200,2474,-143474,-143474
232.955523,6,0,0,0,0,127200,127200,0,0,0
233.282924,0,485,385,100,-100,127200,127200,22133,174867,174867
233.282924,1,355,261,94,-94,127200,127200,15673,50027,50027
233.282924,2,2130,2091,39,-39,127200,127200,5790,-223890,-223890
233.282924,3,287,220,67,-67,127200,127200,6222,66078,66078
233.282924,4,80,50,30,-30,127200,127200,-1644,-11956,-11956
233.282924,5,1405,1372,33,-33,127200,127200,2474,-143474,-143474
233.282924,6,0,0,0,0,127200,127200,0,0,0
233.549543,0,485,385,100,-100,127200,127200,22133,174867,174867
233.549543,1,355,261,94,-94,127200,127200,15673,50027,50027
233.549543,2,2130,2091,39,-39,127200,127200,5790,-223890,-223890
233.549543,3,287,220,67,-67,127200,127200,6222,66078,66078
233.549543,4,80,50,30,-30,127200,127200,-1644,-11956,-11956
233.549543,5,1405,1372,33,-33,127200,127200,2474,-143474,-143474
233.549543,6,0,0,0,0,127200,127200,0,0,0
233.771549,0,485,385,100,-100,127200,127200,22133,174867,174867
233.771549,1,355,261,94,-94,127200,127200,15673,50027,50027
233.771549,2,2130,2091,39,-39,127200,127200,5790,-223890,-223890
233.771549,3,287,220,67,-67,127200,127200,6222,66078,66078
233.771549,4,80,50,30,-30,127200,127200,-1644,-11956,-11956
233.771549,5,1405,1372,33,-33,127200,127200,2474,-143474,-143474
233.771549,6,0,0,0,0,127200,127200,0,0,0
233.98369,0,485,385,100,-100,127200,127300,22133,174867,164867
233.98369,1,355,261,94,-94,127200,127300,15673,50027,40627
233.98369,2,2130,2091,39,-39,127200,127300,5790,-223890,-227790
233.98369,3,287,220,67,-67,127200,127300,6222,66078,59378
233.98369,4,80,50,30,-30,127200,127300,-1644,-11956,-14956
233.98369,5,1405,1372,33,-33,127200,127300,2474,-143474,-146774
233.98369,6,0,0,0,0,127200,127300,0,0,0
234.221941,0,485,385,100,-100,127200,127300,22133,174867,164867
234.221941,1,355,261,94,-94,127200,127300,15673,50027,40627
234.221941,2,2130,2091,39,-39,127200,127300,5790,-223890,-227790
234.221941,3,287,220,67,-67,127200,127300,6222,66078,59378
234.221941,4,80,50,30,-30,127200,127300,-1644,-11956,-14956
234.221941,5,1405,1372,33,-33,127200,127300,2474,-143474,-146774
234.221941,6,0,0,0,0,127200,127300,0,0,0
234.533614,0,485,385,100,-100,127700,127300,22133,174867,200367
234.533614,1,355,261,94,-94,127700,127300,15673,50027,73997
234.533614,2,2130,2101,29,-29,127700,127300,6044,-228144,-220749
234.533614,3,287,222,65,-65,127700,127300,6196,66504,83079
234.533614,4,80,50,30,-30,127700,127300,-1644,-11956,-4306
234.533614,5,1415,1382,33,-33,127700,127300,2220,-144220,-135805
234.533614,6,0,0,0,0,127700,127300,0,0,0
234.716688,0,485,385,100,-100,127700,127300,22133,174867,200367
234.716688,1,355,261,94,-94,127700,127300,15673,50027,73997
234.716688,2,2130,2101,29,-29,127700,127300,6044,-228144,-220749
234.716688,3,287,222,65,-65,127700,127300,6196,66504,83079
234.716688,4,80,50,30,-30,127700,127300,-1644,-11956,-4306
234.716688,5,1415,1382,33,-33,127700,127300,2220,-144220,-135805
234.716688,6,0,0,0,0,127700,127300,0,0,0
234.956002,0,485,385,100,-100,127700,127300,22133,174867,200367
234.956002,1,355,261,94,-94,127700,127300,15673,50027,73997
234.956002,2,2130,2101,29,-29,127700,127300,6044,-228144,-220749
234.956002,3,287,222,65,-65,127700,127300,6196,66504,83079
234.956002,4,80,50,30,-30,127700,127300,-1644,-11956,-4306
234.956002,5,1415,1382,33,-33,127700,127300,2220,-144220,-135805
234.956002,6,0,0,0,0,127700,127300,0,0,0
235.23127,0,485,385,100,-100,127700,127300,22133,174867,200367
235.23127,1,355,261,94,-94,127700,127300,15673,50027,73997
235.23127,2,2130,2101,29,-29,127700,127300,6044,-228144,-220749
235.23127,3,287,222,65,-65,127700,127300,6196,66504,83079
235.23127,4,80,50,30,-30,127700,127300,-1644,-11956,-4306
235.23127,5,1415,1382,33,-33,127700,127300,2220,-144220,-135805
235.23127,6,0,0,0,0,127700,127300,0,0,0
235.468776,0,485,385,100,-100,127100,127300,22133,174867,154867
235.468776,1,355,261,94,-94,127100,127300,15673,50027,31227
235.468776,2,2130,2111,19,-19,127100,127300,5917,-230017,-233817
235.468776,3,287,222,65,-65,127100,127300,6196,66504,53504
235.468776,4,80,50,30,-30,127100,127300,-1644,-11956,-17956
235.468776,5,1415,1392,23,-23,127100,127300,2093,-146093,-150693
235.468776,6,0,0,0,0,127100,127300,0,0,0
235.787938,0,485,385,100,-100,127400,127300,22133,174867,184867
235.787938,1,355,298,57,-57,127400,127300,16616,52784,58484
235.787938,2,2130,2121,9,-9,127400,127300,6172,-229272,-228372
235.787938,3,287,227,60,-60,127400,127300,6323,66877,72877
235.787938,4,80,50,30,-30,127400,127300,-1644,-11956,-8956
235.787938,5,1415,1402,13,-13,127400,127300,2348,-145348,-144048
235.787938,6,0,0,0,0,127400,127300,0,0,0
235.950987,0,485,385,100,-100,127400,127300,22133,174867,184867
235.950987,1,355,298,57,-57,127400,127300,16616,52784,58484
235.950987,2,2130,2121,9,-9,127400,127300,6172,-229272,-228372
235.950987,3,287,227,60,-60,127400,127300,6323,66877,72877
235.950987,4,80,50,30,-30,127400,127300,-1644,-11956,-8956
235.950987,5,1415,1402,13,-13,127400,127300,2348,-145348,-144048
235.950987,6,0,0,0,0,127400,127300,0,0,0
236.230578,0,485,385,100,-100,127100,127300,22133,174867,154867
236.230578,1,355,298,57,-57,127100,127300,16616,52784,41384
236.230578,2,2130,2121,9,-9,127100,127300,6172,-229272,-231072
236.230578,3,287,232,55,-55,127100,127300,6450,65750,54750
236.230578,4,80,50,30,-30,127100,127300,-1644,-11956,-17956
236.230578,5,1415,1402,13,-13,127100,127300,2348,-145348,-147948
236.230578,6,0,0,0,0,127100,127300,0,0,0
236.495642,0,485,385,100,-100,127100,127300,22133,174867,154867
236.495642,1,355,298,57,-57,127100,127300,16616,52784,41384
236.495642,2,2130,2121,9,-9,127100,127300,6172,-229272,-231072
236.495642,3,287,232,55,-55,127100,127300,6450,65750,54750
236.495642,4,80,50,30,-30,127100,127300,-1644,-11956,-17956
236.495642,5,1415,1402,13,-13,127100,127300,2348,-145348,-147948
236.495642,6,0,0,0,0,127100,127300,0,0,0
236.762822,0,485,385,100,-100,127100,127300,22133,174867,154867
236.762822,1,355,298,57,-57,127100,127300,16616,52784,41384
236.762822,2,2130,2121,9,-9,127100,127300,6172,-229272,-231072
236.762822,3,287,232,55,-55,127100,127300,6450,65750,54750
236.762822,4,80,50,30,-30,127100,127300,-1644,-11956,-17956
236.762822,5,1415,1402,13,-13,127100,127300,2348,-145348,-147948
236.762822,6,0,0,0,0,127100,127300,0,0,0
236.972234,0,485,385,100,-100,126900,127300,22133,174867,149367
236.972234,1,355,298,57,-57,126900,127300,16616,52784,38249
236.972234,2,2140,2121,19,-19,126900,127300,6045,-228145,-232990
236.972234,3,287,232,55,-55,126900,127300,6450,65750,51725
236.972234,4,80,50,30,-30,126900,127300,-1644,-11956,-19606
236.972234,5,1425,1402,23,-23,126900,127300,2221,-142221,-148086
236.972234,6,0,0,0,0,126900,127300,0,0,0
237.29835,0,485,385,100,-100,127100,127300,22133,174867,154867
237.29835,1,355,298,57,-57,127100,127300,16616,52784,41384
237.29835,2,2150,2121,29,-29,127100,127300,6299,-227399,-233199
237.29835,3,287,232,55,-55,127100,127300,6450,65750,54750
237.29835,4,80,50,30,-30,127100,127300,-1644,-11956,-17956
237.29835,5,1435,1412,23,-23,127100,127300,2348,-141348,-145948
237.29835,6,0,0,0,0,127100,127300,0,0,0
237.522301,0,485,385,100,-100,126900,127300,22133,174867,149367
237.522301,1,355,298,57,-57,126900,127300,16616,52784,38249
237.522301,2,2160,2131,29,-29,126900,127300,6045,-227145,-234540
237.522301,3,289,232,57,-57,126900,127300,6425,66375,51840
237.522301,4,80,50,30,-30,126900,127300,-1644,-11956,-19606
237.522301,5,1445,1422,23,-23,126900,127300,2856,-143856,-149721
237.522301,6,0,0,0,0,126900,127300,0,0,0
237.735929,0,485,385,100,-100,126800,127300,22133,174867,149367
237.735929,1,368,298,70,-70,126800,127300,16946,56354,38504
237.735929,2,2170,2131,39,-39,126800,127300,6299,-224399,-234344
237.735929,3,291,232,59,-59,126800,127300,6476,66924,51879
237.735929,4,80,50,30,-30,126800,127300,-1644,-11956,-19606
237.735929,5,1455,1422,33,-33,126800,127300,3110,-141110,-149525
237.735929,6,0,0,0,0,126800,127300,0,0,0
237.976262,0,485,385,100,-100,127000,127300,22133,174867,149367
237.976262,1,378,298,80,-80,127000,127300,17200,57100,36700
237.976262,2,2170,2151,19,-19,127000,127300,6045,-229145,-233990
237.976262,3,291,234,57,-57,127000,127300,6450,67550,53015
237.976262,4,80,50,30,-30,127000,127300,-1644,-11956,-19606
237.976262,5,1455,1432,23,-23,127000,127300,2983,-143983,-149848
237.976262,6,0,0,0,0,127000,127300,0,0,0
238.236186,0,485,385,100,-100,127200,127300,22133,174867,164867
238.236186,1,378,298,80,-80,127200,127300,17200,57100,49100
238.236186,2,2170,2157,13,-13,127200,127300,5969,-229669,-230969
238.236186,3,291,234,57,-57,127200,127300,6450,67550,61850
238.236186,4,80,50,30,-30,127200,127300,-1644,-11956,-14956
238.236186,5,1455,1432,23,-23,127200,127300,2983,-143983,-146283
238.236186,6,0,0,0,0,127200,127300,0,0,0
238.492346,0,485,385,100,-100,127200,127300,22133,174867,164867
238.492346,1,378,298,80,-80,127200,127300,17200,57100,49100
238.492346,2,2170,2157,13,-13,127200,127300,5969,-229669,-230969
238.492346,3,291,234,57,-57,127200,127300,6450,67550,61850
238.492346,4,80,50,30,-30,127200,127300,-1644,-11956,-14956
238.492346,5,1455,1432,23,-23,127200,127300,2983,-143983,-146283
238.492346,6,0,0,0,0,127200,127300,0,0,0
238.71366,0,485,385,100,-100,126700,127300,22133,174867,149367
238.71366,1,378,298,80,-80,126700,127300,17200,57100,36700
238.71366,2,2174,2167,7,-7,126700,127300,6172,-229472,-231257
238.71366,3,291,238,53,-53,126700,127300,6551,66249,52734
238.71366,4,80,50,30,-30,126700,127300,-1644,-11956,-19606
238.71366,5,1465,1432,33,-33,126700,127300,2856,-145856,-154271
238.71366,6,0,0,0,0,126700,127300,0,0,0
238.97394,0,485,385,100,-100,126700,127300,22133,174867,149367
238.97394,1,378,298,80,-80,126700,127300,17200,57100,36700
238.97394,2,2174,2167,7,-7,126700,127300,6172,-229472,-231257
238.97394,3,291,238,53,-53,126700,127300,6551,66249,52734
238.97394,4,80,50,30,-30,126700,127300,-1644,-11956,-19606
238.97394,5,1465,1432,33,-33,126700,127300,2856,-145856,-154271
238.97394,6,0,0,0,0,126700,127300,0,0,0
239.246071,0,485,385,100,-100,126400,127300,22133,174867,149367
239.246071,1,378,298,80,-80,126400,127300,17200,57100,36700
239.246071,2,2184,2167,17,-17,126400,127300,6045,-229345,-233680
239.246071,3,293,238,55,-55,126400,127300,6526,66874,52849
239.246071,4,80,50,30,-30,126400,127300,-1644,-11956,-19606
239.246071,5,1475,1432,43,-43,126400,127300,2729,-143729,-154694
239.246071,6,0,0,0,0,126400,127300,0,0,0
239.482084,0,485,385,100,-100,126900,127300,22133,174867,149367
239.482084,1,378,298,80,-80,126900,127300,17200,57100,36700
239.482084,2,2194,2167,27,-27,126900,127300,5918,-227218,-234103
239.482084,3,293,238,55,-55,126900,127300,6526,66874,52849
239.482084,4,80,50,30,-30,126900,127300,-1644,-11956,-19606
239.482084,5,1475,1432,43,-43,126900,127300,2729,-143729,-154694
239.482084,6,0,0,0,0,126900,127300,0,0,0
239.714353,0,485,385,100,-100,126900,127300,22133,174867,149367
239.714353,1,398,298,100,-100,126900,127300,17708,60592,35092
239.714353,2,2204,2167,37,-37,126900,127300,6172,-225472,-234907
239.714353,3,293,238,55,-55,126900,127300,6526,66874,52849
239.714353,4,80,50,30,-30,126900,127300,-1644,-11956,-19606
239.714353,5,1475,1432,43,-43,126900,127300,2729,-143729,-154694
239.714353,6,0,0,0,0,126900,127300,0,0,0
239.965815,0,485,385,100,-100,126900,127100,22133,174867,154867
239.965815,1,398,298,100,-100,126900,127100,17708,60592,40592
239.965815,2,2214,2167,47,-47,126900,127100,6045,-224345,-233745
239.965815,3,297,238,59,-59,126900,127100,6552,67048,55248
239.965815,4,80,50,30,-30,126900,127100,-1644,-11956,-17956
239.965815,5,1485,1442,43,-43,126900,127100,2856,-144856,-153456
239.965815,6,0,0,0,0,126900,127100,0,0,0
240.221279,0,485,385,100,-100,127600,127100,22133,174867,200267
240.221279,1,398,298,100,-100,127600,127100,17708,60592,85992
240.221279,2,2214,2177,37,-37,127600,127100,6298,-228598,-219200
240.221279,3,297,240,57,-57,127600,127100,6527,67473,81951
240.221279,4,80,50,30,-30,127600,127100,-1644,-11956,-4336
240.221279,5,1495,1442,53,-53,127600,127100,2729,-141729,-128267
240.221279,6,0,0,0,0,127600,127100,0,0,0
240.511854,0,485,385,100,-100,127600,127100,22133,174867,200267
240.511854,1,398,298,100,-100,127600,127100,17708,60592,85992
240.511854,2,2214,2177,37,-37,127600,127100,6298,-228598,-219200
240.511854,3,297,240,57,-57,127600,127100,6527,67473,81951
240.511854,4,80,50,30,-30,127600,127100,-1644,-11956,-4336
240.511854,5,1495,1442,53,-53,127600,127100,2729,-141729,-128267
240.511854,6,0,0,0,0,127600,127100,0,0,0
240.799598,0,485,385,100,-100,127600,126900,22133,174867,200267
240.799598,1,398,298,100,-100,127600,126900,17708,60592,85992
240.799598,2,2214,2177,37,-37,127600,126900,6298,-228598,-219200
240.799598,3,297,240,57,-57,127600,126900,6527,67473,81951
240.799598,4,80,50,30,-30,127600,126900,-1644,-11956,-4336
240.799598,5,1495,1442,53,-53,127600,126900,2729,-141729,-128267
240.799598,6,0,0,0,0,127600,126900,0,0,0
240.953504,0,485,385,100,-100,127600,126900,22133,174867,200267
240.953504,1,398,298,100,-100,127600,126900,17708,60592,85992
240.953504,2,2214,2177,37,-37,127600,126900,6298,-228598,-219200
240.953504,3,297,240,57,-57,127600,126900,6527,67473,81951
240.953504,4,80,50,30,-30,127600,126900,-1644,-11956,-4336
240.953504,5,1495,1442,53,-53,127600,126900,2729,-141729,-128267
240.953504,6,0,0,0,0,127600,126900,0,0,0
241.292716,0,485,385,100,-100,126500,126900,22133,174867,149467
241.292716,1,398,298,100,-100,126500,126900,17708,60592,35192
241.292716,2,2214,2187,27,-27,126500,126900,6172,-233472,-240330
241.292716,3,297,240,57,-57,126500,126900,6527,67473,52995
241.292716,4,80,50,30,-30,126500,126900,-1644,-11956,-19576
241.292716,5,1495,1442,53,-53,126500,126900,2729,-141729,-155191
241.292716,6,0,0,0,0,126500,126900,0,0,0
241.454172,0,485,385,100,-100,127000,126900,22133,174867,184867
241.454172,1,398,298,100,-100,127000,126900,17708,60592,70592
241.454172,2,2214,2197,17,-17,127000,126900,6426,-233726,-232026
241.454172,3,297,244,53,-53,127000,126900,6629,67371,72671
241.454172,4,80,50,30,-30,127000,126900,-1644,-11956,-8956
241.454172,5,1495,1442,53,-53,127000,126900,2729,-141729,-136429
241.454172,6,0,0,0,0,127000,126900,0,0,0
241.74735,0,485,385,100,-100,127000,126900,22133,174867,184867
241.74735,1,398,405,-7,7,127000,126900,20426,62574,61874
241.74735,2,2214,2207,7,-7,127000,126900,6680,-233980,-233280
241.74735,3,297,252,45,-45,127000,126900,6833,67167,71667
241.74735,4,80,50,30,-30,127000,126900,-1644,-11956,-8956
241.74735,5,1495,1442,53,-53,127000,126900,2729,-141729,-136429
241.74735,6,0,0,0,0,127000,126900,0,0,0
241.977568,0,485,385,100,-100,126400,126900,22133,174867,149467
241.977568,1,398,405,-7,7,126400,126900,20426,62574,64352
241.977568,2,2224,2207,17,-17,126400,126900,6553,-231853,-236171
241.977568,3,297,255,42,-42,126400,126900,6909,65291,54623
241.977568,4,80,50,30,-30,126400,126900,-1644,-11956,-19576
241.977568,5,1495,1452,43,-43,126400,126900,2982,-145982,-156904
241.977568,6,0,0,0,0,126400,126900,0,0,0
242.220638,0,485,385,100,-100,126700,126900,22133,174867,154867
242.220638,1,398,405,-7,7,126700,126900,20426,62574,63974
242.220638,2,2234,2207,27,-27,126700,126900,6426,-230726,-236126
242.220638,3,297,255,42,-42,126700,126900,6909,65291,56891
242.220638,4,80,50,30,-30,126700,126900,-1644,-11956,-17956
242.220638,5,1495,1462,33,-33,126700,126900,3235,-149235,-155835
242.220638,6,0,0,0,0,126700,126900,0,0,0
242.523849,0,485,385,100,-100,126700,126900,22133,174867,154867
242.523849,1,398,405,-7,7,126700,126900,20426,62574,63974
242.523849,2,2234,2207,27,-27,126700,126900,6426,-230726,-236126
242.523849,3,297,255,42,-42,126700,126900,6909,65291,56891
242.523849,4,80,50,30,-30,126700,126900,-1644,-11956,-17956
242.523849,5,1495,1462,33,-33,126700,126900,3235,-149235,-155835
242.523849,6,0,0,0,0,126700,126900,0,0,0
242.736499,0,485,385,100,-100,126700,126900,22133,174867,154867
242.736499,1,398,405,-7,7,126700,126900,20426,62574,63974
242.736499,2,2234,2207,27,-27,126700,126900,6426,-230726,-236126
242.736499,3,297,255,42,-42,126700,126900,6909,65291,56891
242.736499,4,80,50,30,-30,126700,126900,-1644,-11956,-17956
242.736499,5,1495,1462,33,-33,126700,126900,3235,-149235,-155835
242.736499,6,0,0,0,0,126700,126900,0,0,0
242.953341,0,485,385,100,-100,126700,126900,22133,174867,154867
242.953341,1,398,405,-7,7,126700,126900,20426,62574,63974
242.953341,2,2234,2207,27,-27,126700,126900,6426,-230726,-236126
242.953341,3,297,255,42,-42,126700,126900,6909,65291,56891
242.953341,4,80,50,30,-30,126700,126900,-1644,-11956,-17956
242.953341,5,1495,1462,33,-33,126700,126900,3235,-149235,-155835
242.953341,6,0,0,0,0,126700,126900,0,0,0
243.294274,0,485,385,100,-100,126700,126900,22133,174867,154867
243.294274,1,398,405,-7,7,126700,126900,20426,62574,63974
243.294274,2,2234,2207,27,-27,126700,126900,6426,-230726,-236126
243.294274,3,297,255,42,-42,126700,126900,6909,65291,56891
243.294274,4,80,50,30,-30,126700,126900,-1644,-11956,-17956
243.294274,5,1495,1462,33,-33,126700,126900,3235,-149235,-155835
243.294274,6,0,0,0,0,126700,126900,0,0,0
243.466194,0,485,385,100,-100,126700,127000,22133,174867,149467
243.466194,1,398,405,-7,7,126700,127000,20426,62574,64352
243.466194,2,2234,2207,27,-27,126700,127000,6426,-230726,-237584
243.466194,3,297,255,42,-42,126700,127000,6909,65291,54623
243.466194,4,80,50,30,-30,126700,127000,-1644,-11956,-19576
243.466194,5,1495,1462,33,-33,126700,127000,3235,-149235,-157617
243.466194,6,0,0,0,0,126700,127000,0,0,0
243.798683,0,485,385,100,-100,126700,127000,22133,174867,149467
243.798683,1,398,405,-7,7,126700,127000,20426,62574,64352
243.798683,2,2234,2207,27,-27,126700,127000,6426,-230726,-237584
243.798683,3,297,255,42,-42,126700,127000,6909,65291,54623
243.798683,4,80,50,30,-30,126700,127000,-1644,-11956,-19576
243.798683,5,1495,1462,33,-33,126700,127000,3235,-149235,-157617
243.798683,6,0,0,0,0,126700,127000,0,0,0
243.998927,0,485,385,100,-100,126700,127000,22133,174867,149467
243.998927,1,398,405,-7,7,126700,127000,20426,62574,64352
243.998927,2,2234,2207,27,-27,126700,127000,6426,-230726,-237584
243.998927,3,297,255,42,-42,126700,127000,6909,65291,54623
243.998927,4,80,50,30,-30,126700,127000,-1644,-11956,-19576
243.998927,5,1495,1462,33,-33,126700,127000,3235,-149235,-157617
243.998927,6,0,0,0,0,126700,127000,0,0,0
244.261431,0,485,385,100,-100,126600,126800,22133,174867,154867
244.261431,1,398,405,-7,7,126600,126800,20426,62574,63974
244.261431,2,2244,2207,37,-37,126600,126800,6679,-228979,-236379
244.261431,3,297,255,42,-42,126600,126800,6909,65291,56891
244.261431,4,80,50,30,-30,126600,126800,-1644,-11956,-17956
244.261431,5,1495,1472,23,-23,126600,126800,3108,-153108,-157708
244.261431,6,0,0,0,0,126600,126800,0,0,0
244.463465,0,485,385,100,-100,126600,126800,22133,174867,154867
244.463465,1,398,405,-7,7,126600,126800,20426,62574,63974
244.463465,2,2244,2207,37,-37,126600,126800,6679,-228979,-236379
244.463465,3,297,255,42,-42,126600,126800,6909,65291,56891
244.463465,4,80,50,30,-30,126600,126800,-1644,-11956,-17956
244.463465,5,1495,1472,23,-23,126600,126800,3108,-153108,-157708
244.463465,6,0,0,0,0,126600,126800,0,0,0
244.747642,0,485,385,100,-100,126600,126800,22133,174867,154867
244.747642,1,408,405,3,-3,126600,126800,20679,63321,62721
244.747642,2,2244,2217,27,-27,126600,126800,6932,-232232,-237632
244.747642,3,297,255,42,-42,126600,126800,6909,65291,56891
244.747642,4,80,50,30,-30,126600,126800,-1644,-11956,-17956
244.747642,5,1505,1482,23,-23,126600,126800,2855,-152855,-157455
244.747642,6,0,0,0,0,126600,126800,0,0,0
244.960531,0,485,385,100,-100,126600,126800,22133,174867,154867
244.960531,1,408,405,3,-3,126600,126800,20679,63321,62721
244.960531,2,2244,2217,27,-27,126600,126800,6932,-232232,-237632
244.960531,3,297,255,42,-42,126600,126800,6909,65291,56891
244.960531,4,80,50,30,-30,126600,126800,-1644,-11956,-17956
244.960531,5,1505,1482,23,-23,126600,126800,2855,-152855,-157455
244.960531,6,0,0,0,0,126600,126800,0,0,0
245.202619,0,485,385,100,-100,126400,126800,22133,174867,149467
245.202619,1,408,405,3,-3,126400,126800,20679,63321,62559
245.202619,2,2254,2227,27,-27,126400,126800,7059,-233359,-240217
245.202619,3,299,255,44,-44,126400,126800,6884,65916,54740
245.202619,4,80,50,30,-30,126400,126800,-1644,-11956,-19576
245.202619,5,1515,1482,33,-33,126400,126800,2728,-150728,-159110
245.202619,6,0,0,0,0,126400,126800,0,0,0
245.495937,0,485,385,100,-100,126400,126800,22133,174867,149467
245.495937,1,412,405,7,-7,126400,126800,20780,64420,62642
245.495937,2,2264,2227,37,-37,126400,126800,7312,-230612,-240010
245.495937,3,301,255,46,-46,126400,126800,6935,66465,54781
245.495937,4,80,50,30,-30,126400,126800,-1644,-11956,-19576
245.495937,5,1525,1482,43,-43,126400,126800,2981,-147981,-158903
245.495937,6,0,0,0,0,126400,126800,0,0,0
245.782504,0,485,385,100,-100,126500,126800,22133,174867,149467
245.782504,1,412,405,7,-7,126500,126800,20780,64420,62642
245.782504,2,2272,2227,45,-45,126500,126800,7211,-228111,-239541
245.782504,3,301,255,46,-46,126500,126800,6935,66465,54781
245.782504,4,80,50,30,-30,126500,126800,-1644,-11956,-19576
245.782504,5,1525,1482,43,-43,126500,126800,2981,-147981,-158903
245.782504,6,0,0,0,0,126500,126800,0,0,0
246.02085,0,485,385,100,-100,126700,126800,22133,174867,164867
246.02085,1,463,405,58,-58,126700,126800,22070,64130,58330
246.02085,2,2272,2237,35,-35,126700,126800,7084,-231984,-235484
246.02085,3,301,255,46,-46,126700,126800,6935,66465,61865
246.02085,4,80,50,30,-30,126700,126800,-1644,-11956,-14956
246.02085,5,1525,1492,33,-33,126700,126800,2854,-150854,-154154
246.02085,6,0,0,0,0,126700,126800,0,0,0
246.291306,0,485,385,100,-100,126700,126800,22133,174867,164867
246.291306,1,463,405,58,-58,126700,126800,22070,64130,58330
246.291306,2,2272,2237,35,-35,126700,126800,7084,-231984,-235484
246.291306,3,301,255,46,-46,126700,126800,6935,66465,61865
246.291306,4,80,50,30,-30,126700,126800,-1644,-11956,-14956
246.291306,5,1525,1492,33,-33,126700,126800,2854,-150854,-154154
246.291306,6,0,0,0,0,126700,126800,0,0,0
246.471848,0,485,385,100,-100,126700,127000,22133,174867,149467
246.471848,1,463,405,58,-58,126700,127000,22070,64130,49398
246.471848,2,2272,2237,35,-35,126700,127000,7084,-231984,-240874
246.471848,3,301,255,46,-46,126700,127000,6935,66465,54781
246.471848,4,80,50,30,-30,126700,127000,-1644,-11956,-19576
246.471848,5,1525,1492,33,-33,126700,127000,2854,-150854,-159236
246.471848,6,0,0,0,0,126700,127000,0,0,0
246.725263,0,485,385,100,-100,127300,127000,22133,174867,200267
246.725263,1,463,405,58,-58,127300,127000,22070,64130,78862
246.725263,2,2272,2247,25,-25,127300,127000,6957,-235857,-229507
246.725263,3,301,255,46,-46,127300,127000,6935,66465,78149
246.725263,4,80,50,30,-30,127300,127000,-1644,-11956,-4336
246.725263,5,1525,1502,23,-23,127300,127000,2727,-154727,-148885
246.725263,6,0,0,0,0,127300,127000,0,0,0
247.009336,0,485,385,100,-100,126700,127100,22133,174867,149467
247.009336,1,463,405,58,-58,126700,127100,22070,64130,49398
247.009336,2,2282,2247,35,-35,126700,127100,6830,-233730,-242620
247.009336,3,303,255,48,-48,126700,127100,6910,67090,54898
247.009336,4,80,50,30,-30,126700,127100,-1644,-11956,-19576
247.009336,5,1535,1502,33,-33,126700,127100,2600,-151600,-159982
247.009336,6,0,0,0,0,126700,127100,0,0,0
247.20745,0,485,385,100,-100,126700,127100,22133,174867,149467
247.20745,1,463,405,58,-58,126700,127100,22070,64130,49398
247.20745,2,2282,2247,35,-35,126700,127100,6830,-233730,-242620
247.20745,3,303,255,48,-48,126700,127100,6910,67090,54898
247.20745,4,80,50,30,-30,126700,127100,-1644,-11956,-19576
247.20745,5,1535,1502,33,-33,126700,127100,2600,-151600,-159982
247.20745,6,0,0,0,0,126700,127100,0,0,0
247.53245,0,485,385,100,-100,126700,127100,22133,174867,149467
247.53245,1,463,405,58,-58,126700,127100,22070,64130,49398
247.53245,2,2282,2247,35,-35,126700,127100,6830,-233730,-242620
247.53245,3,303,255,48,-48,126700,127100,6910,67090,54898
247.53245,4,80,50,30,-30,126700,127100,-1644,-11956,-19576
247.53245,5,1535,1502,33,-33,126700,127100,2600,-151600,-159982
247.53245,6,0,0,0,0,126700,127100,0,0,0
247.739745,0,485,385,100,-100,126700,127100,22133,174867,149467
247.739745,1,463,405,58,-58,126700,127100,22070,64130,49398
247.739745,2,2282,2247,35,-35,126700,127100,6830,-233730,-242620
247.739745,3,303,255,48,-48,126700,127100,6910,67090,54898
247.739745,4,80,50,30,-30,126700,127100,-1644,-11956,-19576
247.739745,5,1535,1502,33,-33,126700,127100,2600,-151600,-159982
247.739745,6,0,0,0,0,126700,127100,0,0,0
248.032445,0,485,385,100,-100,126700,127000,22133,174867,149467
248.032445,1,463,405,58,-58,126700,127000,22070,64130,49398
248.032445,2,2292,2257,35,-35,126700,127000,6576,-233476,-242366
248.032445,3,303,255,48,-48,126700,127000,6910,67090,54898
248.032445,4,80,50,30,-30,126700,127000,-1644,-11956,-19576
248.032445,5,1545,1512,33,-33,126700,127000,3107,-154107,-162489
248.032445,6,0,0,0,0,126700,127000,0,0,0
248.287842,0,485,385,100,-100,126700,127000,22133,174867,149467
248.287842,1,463,405,58,-58,126700,127000,22070,64130,49398
248.287842,2,2292,2257,35,-35,126700,127000,6576,-233476,-242366
248.287842,3,303,255,48,-48,126700,127000,6910,67090,54898
248.287842,4,80,50,30,-30,126700,127000,-1644,-11956,-19576
248.287842,5,1545,1512,33,-33,126700,127000,3107,-154107,-162489
248.287842,6,0,0,0,0,126700,127000,0,0,0
248.548572,0,485,385,100,-100,126800,127000,22133,174867,154867
248.548572,1,473,405,68,-68,126800,127000,22324,64876,51276
248.548572,2,2292,2267,25,-25,126800,127000,6449,-236349,-241349
248.548572,3,303,255,48,-48,126800,127000,6910,67090,57490
248.548572,4,80,50,30,-30,126800,127000,-1644,-11956,-17956
248.548572,5,1545,1512,33,-33,126800,127000,3107,-154107,-160707
248.548572,6,0,0,0,0,126800,127000,0,0,0
248.761932,0,485,385,100,-100,126800,127000,22133,174867,154867
248.761932,1,473,405,68,-68,126800,127000,22324,64876,51276
248.761932,2,2292,2267,25,-25,126800,127000,6449,-236349,-241349
248.761932,3,303,255,48,-48,126800,127000,6910,67090,57490
248.761932,4,80,50,30,-30,126800,127000,-1644,-11956,-17956
248.761932,5,1545,1512,33,-33,126800,127000,3107,-154107,-160707
248.761932,6,0,0,0,0,126800,127000,0,0,0
249.010515,0,485,385,100,-100,126800,127000,22133,174867,154867
249.010515,1,473,405,68,-68,126800,127000,22324,64876,51276
249.010515,2,2292,2267,25,-25,126800,127000,6449,-236349,-241349
249.010515,3,303,255,48,-48,126800,127000,6910,67090,57490
249.010515,4,80,50,30,-30,126800,127000,-1644,-11956,-17956
249.010515,5,1545,1512,33,-33,126800,127000,3107,-154107,-160707
249.010515,6,0,0,0,0,126800,127000,0,0,0
249.216611,0,485,385,100,-100,126900,127000,22133,174867,164867
249.216611,1,493,405,88,-88,126900,127000,22832,66368,57568
249.216611,2,2292,2277,15,-15,126900,127000,6322,-238222,-239722
249.216611,3,303,255,48,-48,126900,127000,6910,67090,62290
249.216611,4,80,50,30,-30,126900,127000,-1644,-11956,-14956
249.216611,5,1545,1522,23,-23,126900,127000,2980,-155980,-158280
249.216611,6,0,0,0,0,126900,127000,0,0,0
249.536126,0,485,385,100,-100,126800,127000,22133,174867,154867
249.536126,1,493,405,88,-88,126800,127000,22832,66368,48768
249.536126,2,2302,2277,25,-25,126800,127000,6195,-237095,-242095
249.536126,3,303,255,48,-48,126800,127000,6910,67090,57490
249.536126,4,80,50,30,-30,126800,127000,-1644,-11956,-17956
249.536126,5,1545,1532,13,-13,126800,127000,3234,-159234,-161834
249.536126,6,0,0,0,0,126800,127000,0,0,0
249.708901,0,485,385,100,-100,126900,127000,22133,174867,164867
249.708901,1,493,405,88,-88,126900,127000,22832,66368,57568
249.708901,2,2302,2287,15,-15,126900,127000,6449,-239349,-240849
249.708901,3,303,255,48,-48,126900,127000,6910,67090,62290
249.708901,4,80,50,30,-30,126900,127000,-1644,-11956,-14956
249.708901,5,1555,1532,23,-23,126900,127000,3107,-159107,-161407
249.708901,6,0,0,0,0,126900,127000,0,0,0
249.972469,0,485,385,100,-100,126900,127000,22133,174867,164867
249.972469,1,493,405,88,-88,126900,127000,22832,66368,57568
249.972469,2,2302,2287,15,-15,126900,127000,6449,-239349,-240849
249.972469,3,303,255,48,-48,126900,127000,6910,67090,62290
249.972469,4,80,50,30,-30,126900,127000,-1644,-11956,-14956
249.972469,5,1555,1532,23,-23,126900,127000,3107,-159107,-161407
249.972469,6,0,0,0,0,126900,127000,0,0,0
250.284321,0,485,385,100,-100,126900,127000,22133,174867,164867
250.284321,1,493,405,88,-88,126900,127000,22832,66368,57568
250.284321,2,2302,2287,15,-15,126900,127000,6449,-239349,-240849
250.284321,3,303,255,48,-48,126900,127000,6910,67090,62290
250.284321,4,80,50,30,-30,126900,127000,-1644,-11956,-14956
250.284321,5,1555,1532,23,-23,126900,127000,3107,-159107,-161407
250.284321,6,0,0,0,0,126900,127000,0,0,0
250.547755,0,485,385,100,-100,126800,127000,22133,174867,154867
250.547755,1,493,405,88,-88,126800,127000,22832,66368,48768
250.547755,2,2302,2297,5,-5,126800,127000,6703,-240603,-241603
250.547755,3,303,255,48,-48,126800,127000,6910,67090,57490
250.547755,4,80,50,30,-30,126800,127000,-1644,-11956,-17956
250.547755,5,1565,1532,33,-33,126800,127000,2980,-158980,-165580
250.547755,6,0,0,0,0,126800,127000,0,0,0
250.794695,0,485,385,100,-100,126700,126500,22133,174867,194867
250.794695,1,493,405,88,-88,126700,126500,22832,66368,83968
250.794695,2,2310,2297,13,-13,126700,126500,6601,-241301,-238701
250.794695,3,303,263,40,-40,126700,126500,7112,66888,74888
250.794695,4,80,50,30,-30,126700,126500,-1644,-11956,-5956
250.794695,5,1565,1532,33,-33,126700,126500,2980,-158980,-152380
250.794695,6,0,0,0,0,126700,126500,0,0,0
251.012547,0,485,385,100,-100,126600,126500,22133,174867,184867
251.012547,1,493,405,88,-88,126600,126500,22832,66368,75168
251.012547,2,2310,2307,3,-3,126600,126500,6854,-242554,-242254
251.012547,3,303,266,37,-37,126600,126500,7188,66512,70212
251.012547,4,80,50,30,-30,126600,126500,-1644,-11956,-8956
251.012547,5,1565,1532,33,-33,126600,126500,2980,-158980,-155680
251.012547,6,0,0,0,0,126600,126500,0,0,0
251.212125,0,485,385,100,-100,126700,126500,22133,174867,194867
251.212125,1,493,405,88,-88,126700,126500,22832,66368,83968
251.212125,2,2320,2307,13,-13,126700,126500,7107,-242807,-240207
251.212125,3,303,266,37,-37,126700,126500,7188,66512,73912
251.212125,4,80,50,30,-30,126700,126500,-1644,-11956,-5956
251.212125,5,1565,1542,23,-23,126700,126500,2853,-160853,-156253
251.212125,6,0,0,0,0,126700,126500,0,0,0
251.459385,0,485,385,100,-100,126700,126500,22133,174867,194867
251.459385,1,493,405,88,-88,126700,126500,22832,66368,83968
251.459385,2,2320,2307,13,-13,126700,126500,7107,-242807,-240207
251.459385,3,303,266,37,-37,126700,126500,7188,66512,73912
251.459385,4,80,50,30,-30,126700,126500,-1644,-11956,-5956
251.459385,5,1565,1542,23,-23,126700,126500,2853,-160853,-156253
251.459385,6,0,0,0,0,126700,126500,0,0,0
251.746514,0,485,385,100,-100,126700,126500,22133,174867,194867
251.746514,1,493,405,88,-88,126700,126500,22832,66368,83968
251.746514,2,2320,2307,13,-13,126700,126500,7107,-242807,-240207
251.746514,3,303,266,37,-37,126700,126500,7188,66512,73912
251.746514,4,80,50,30,-30,126700,126500,-1644,-11956,-5956
251.746514,5,1565,1542,23,-23,126700,126500,2853,-160853,-156253
251.746514,6,0,0,0,0,126700,126500,0,0,0
251.992544,0,485,385,100,-100,127300,126500,22133,174867,200167
251.992544,1,493,405,88,-88,127300,126500,22832,66368,88632
251.992544,2,2320,2317,3,-3,127300,126500,6980,-248680,-247921
251.992544,3,303,266,37,-37,127300,126500,7188,66512,75873
251.992544,4,80,50,30,-30,127300,126500,-1644,-11956,-4366
251.992544,5,1575,1542,33,-33,127300,126500,3107,-157107,-148758
251.992544,6,0,0,0,0,127300,126500,0,0,0
252.265733,0,485,385,100,-100,127300,126500,22133,174867,200167
252.265733,1,493,405,88,-88,127300,126500,22832,66368,88632
252.265733,2,2320,2317,3,-3,127300,126500,6980,-248680,-247921
252.265733,3,303,266,37,-37,127300,126500,7188,66512,75873
252.265733,4,80,50,30,-30,127300,126500,-1644,-11956,-4366
252.265733,5,1575,1542,33,-33,127300,126500,3107,-157107,-148758
252.265733,6,0,0,0,0,127300,126500,0,0,0
252.545444,0,485,385,100,-100,127200,126500,22133,174867,200167
252.545444,1,493,405,88,-88,127200,126500,22832,66368,88632
252.545444,2,2330,2317,13,-13,127200,126500,6853,-248553,-245264
252.545444,3,303,266,37,-37,127200,126500,7188,66512,75873
252.545444,4,80,50,30,-30,127200,126500,-1644,-11956,-4366
252.545444,5,1575,1552,23,-23,127200,126500,3361,-159361,-153542
252.545444,6,0,0,0,0,127200,126500,0,0,0
252.785528,0,485,385,100,-100,127200,126500,22133,174867,200167
252.785528,1,493,405,88,-88,127200,126500,22832,66368,88632
252.785528,2,2330,2317,13,-13,127200,126500,6853,-248553,-245264
252.785528,3,303,266,37,-37,127200,126500,7188,66512,75873
252.785528,4,80,50,30,-30,127200,126500,-1644,-11956,-4366
252.785528,5,1575,1552,23,-23,127200,126500,3361,-159361,-153542
252.785528,6,0,0,0,0,127200,126500,0,0,0
252.980126,0,485,385,100,-100,127200,127300,22133,174867,164867
252.980126,1,493,405,88,-88,127200,127300,22832,66368,57568
252.980126,2,2330,2317,13,-13,127200,127300,6853,-248553,-249853
252.980126,3,303,266,37,-37,127200,127300,7188,66512,62812
252.980126,4,80,50,30,-30,127200,127300,-1644,-11956,-14956
252.980126,5,1575,1552,23,-23,127200,127300,3361,-159361,-161661
252.980126,6,0,0,0,0,127200,127300,0,0,0
253.210515,0,485,385,100,-100,127200,127300,22133,174867,164867
253.210515,1,493,405,88,-88,127200,127300,22832,66368,57568
253.210515,2,2330,2317,13,-13,127200,127300,6853,-248553,-249853
253.210515,3,303,266,37,-37,127200,127300,7188,66512,62812
253.210515,4,80,50,30,-30,127200,127300,-1644,-11956,-14956
253.210515,5,1575,1552,23,-23,127200,127300,3361,-159361,-161661
253.210515,6,0,0,0,0,127200,127300,0,0,0
253.546111,0,485,385,100,-100,127200,127400,22133,174867,154867
253.546111,1,493,405,88,-88,127200,127400,22832,66368,48768
253.546111,2,2330,2317,13,-13,127200,127400,6853,-248553,-251153
253.546111,3,303,266,37,-37,127200,127400,7188,66512,59112
253.546111,4,80,50,30,-30,127200,127400,-1644,-11956,-17956
253.546111,5,1575,1552,23,-23,127200,127400,3361,-159361,-163961
253.546111,6,0,0,0,0,127200,127400,0,0,0
253.709628,0,485,385,100,-100,127300,127400,22133,174867,164867
253.709628,1,503,405,98,-98,127300,127400,23087,67113,57313
253.709628,2,2340,2317,23,-23,127300,127400,7108,-247808,-250108
253.709628,3,303,266,37,-37,127300,127400,7188,66512,62812
253.709628,4,80,50,30,-30,127300,127400,-1644,-11956,-14956
253.709628,5,1575,1552,23,-23,127300,127400,3361,-159361,-161661
253.709628,6,0,0,0,0,127300,127400,0,0,0
254.000319,0,485,385,100,-100,127300,127400,22133,174867,164867
254.000319,1,503,405,98,-98,127300,127400,23087,67113,57313
254.000319,2,2340,2317,23,-23,127300,127400,7108,-247808,-250108
254.000319,3,303,266,37,-37,127300,127400,7188,66512,62812
254.000319,4,80,50,30,-30,127300,127400,-1644,-11956,-14956
254.000319,5,1575,1552,23,-23,127300,127400,3361,-159361,-161661
254.000319,6,0,0,0,0,127300,127400,0,0,0
254.226538,0,485,385,100,-100,127300,127400,22133,174867,164867
254.226538,1,503,405,98,-98,127300,127400,23087,67113,57313
254.226538,2,2340,2317,23,-23,127300,127400,7108,-247808,-250108
254.226538,3,303,266,37,-37,127300,127400,7188,66512,62812
254.226538,4,80,50,30,-30,127300,127400,-1644,-11956,-14956
254.226538,5,1575,1552,23,-23,127300,127400,3361,-159361,-161661
254.226538,6,0,0,0,0,127300,127400,0,0,0
254.545725,0,485,385,100,-100,127300,127400,22133,174867,164867
254.545725,1,503,405,98,-98,127300,127400,23087,67113,57313
254.545725,2,2340,2317,23,-23,127300,127400,7108,-247808,-250108
254.545725,3,303,266,37,-37,127300,127400,7188,66512,62812
254.545725,4,80,50,30,-30,127300,127400,-1644,-11956,-14956
254.545725,5,1575,1552,23,-23,127300,127400,3361,-159361,-161661
254.545725,6,0,0,0,0,127300,127400,0,0,0
254.745544,0,485,385,100,-100,127300,127400,22133,174867,164867
254.745544,1,503,405,98,-98,127300,127400,23087,67113,57313
254.745544,2,2340,2317,23,-23,127300,127400,7108,-247808,-250108
254.745544,3,303,266,37,-37,127300,127400,7188,66512,62812
254.745544,4,80,50,30,-30,127300,127400,-1644,-11956,-14956
254.745544,5,1575,1552,23,-23,127300,127400,3361,-159361,-161661
254.745544,6,0,0,0,0,127300,127400,0,0,0
254.989037,0,485,385,100,-100,127100,127400,22133,174867,149367
254.989037,1,503,405,98,-98,127100,127400,23087,67113,42123
254.989037,2,2350,2317,33,-33,127100,127400,6981,-245681,-254096
254.989037,3,303,266,37,-37,127100,127400,7188,66512,57077
254.989037,4,80,50,30,-30,127100,127400,-1644,-11956,-19606
254.989037,5,1585,1552,33,-33,127100,127400,3234,-157234,-165649
254.989037,6,0,0,0,0,127100,127400,0,0,0
255.227275,0,485,385,100,-100,127100,127400,22133,174867,149367
255.227275,1,503,405,98,-98,127100,127400,23087,67113,42123
255.227275,2,2350,2317,33,-33,127100,127400,6981,-245681,-254096
255.227275,3,303,266,37,-37,127100,127400,7188,66512,57077
255.227275,4,80,50,30,-30,127100,127400,-1644,-11956,-19606
255.227275,5,1585,1552,33,-33,127100,127400,3234,-157234,-165649
255.227275,6,0,0,0,0,127100,127400,0,0,0
255.461497,0,485,385,100,-100,127100,127400,22133,174867,149367
255.461497,1,503,405,98,-98,127100,127400,23087,67113,42123
255.461497,2,2350,2317,33,-33,127100,127400,6981,-245681,-254096
255.461497,3,303,266,37,-37,127100,127400,7188,66512,57077
255.461497,4,80,50,30,-30,127100,127400,-1644,-11956,-19606
255.461497,5,1585,1552,33,-33,127100,127400,3234,-157234,-165649
255.461497,6,0,0,0,0,127100,127400,0,0,0
255.724289,0,485,385,100,-100,127100,127700,22133,174867,149367
255.724289,1,503,405,98,-98,127100,127700,23087,67113,42123
255.724289,2,2351,2317,34,-34,127100,127700,7006,-245406,-254076
255.724289,3,303,266,37,-37,127100,127700,7188,66512,57077
255.724289,4,80,50,30,-30,127100,127700,-1644,-11956,-19606
255.724289,5,1585,1552,33,-33,127100,127700,3234,-157234,-165649
255.724289,6,0,0,0,0,127100,127700,0,0,0
255.957408,0,485,385,100,-100,127300,127700,22133,174867,149367
255.957408,1,503,405,98,-98,127300,127700,23087,67113,42123
255.957408,2,2361,2327,34,-34,127300,127700,7134,-248534,-257204
255.957408,3,305,266,39,-39,127300,127700,7239,67061,57116
255.957408,4,80,50,30,-30,127300,127700,-1644,-11956,-19606
255.957408,5,1595,1552,43,-43,127300,127700,3488,-153488,-164453
255.957408,6,0,0,0,0,127300,127700,0,0,0
256.266025,0,485,385,100,-100,127300,127700,22133,174867,149367
256.266025,1,503,405,98,-98,127300,127700,23087,67113,42123
256.266025,2,2371,2327,44,-44,127300,127700,7389,-245789,-257009
256.266025,3,307,266,41,-41,127300,127700,7290,67610,57155
256.266025,4,80,50,30,-30,127300,127700,-1644,-11956,-19606
256.266025,5,1595,1552,43,-43,127300,127700,3488,-153488,-164453
256.266025,6,0,0,0,0,127300,127700,0,0,0
256.462882,0,485,385,100,-100,127300,127700,22133,174867,149367
256.462882,1,503,405,98,-98,127300,127700,23087,67113,42123
256.462882,2,2371,2327,44,-44,127300,127700,7389,-245789,-257009
256.462882,3,309,266,43,-43,127300,127700,7341,68159,57194
256.462882,4,80,50,30,-30,127300,127700,-1644,-11956,-19606
256.462882,5,1595,1552,43,-43,127300,127700,3488,-153488,-164453
256.462882,6,0,0,0,0,127300,127700,0,0,0
256.74241,0,485,385,100,-100,127300,127800,22133,174867,149267
256.74241,1,503,405,98,-98,127300,127800,23087,67113,42025
256.74241,2,2381,2327,54,-54,127300,127800,7644,-241044,-254868
256.74241,3,311,266,45,-45,127300,127800,7392,69108,57588
256.74241,4,80,50,30,-30,127300,127800,-1644,-11956,-19636
256.74241,5,1595,1552,43,-43,127300,127800,3488,-153488,-164496
256.74241,6,0,0,0,0,127300,127800,0,0,0
257.022528,0,485,385,100,-100,127500,127800,22133,174867,149267
257.022528,1,503,405,98,-98,127500,127800,23087,67113,42025
257.022528,2,2381,2327,54,-54,127500,127800,7644,-241044,-254868
257.022528,3,313,266,47,-47,127500,127800,7443,69857,57825
257.022528,4,80,50,30,-30,127500,127800,-1644,-11956,-19636
257.022528,5,1595,1552,43,-43,127500,127800,3488,-153488,-164496
257.022528,6,0,0,0,0,127500,127800,0,0,0
257.28961,0,485,385,100,-100,127300,127800,22133,174867,149267
257.28961,1,503,405,98,-98,127300,127800,23087,67113,42025
257.28961,2,2381,2337,44,-44,127300,127800,7899,-245299,-256563
257.28961,3,315,266,49,-49,127300,127800,7418,70482,57938
257.28961,4,80,50,30,-30,127300,127800,-1644,-11956,-19636
257.28961,5,1605,1554,51,-51,127300,127800,3412,-151212,-164268
257.28961,6,0,0,0,0,127300,127800,0,0,0
257.477434,0,485,385,100,-100,127300,127800,22133,174867,149267
257.477434,1,503,405,98,-98,127300,127800,23087,67113,42025
257.477434,2,2381,2337,44,-44,127300,127800,7899,-245299,-256563
257.477434,3,315,266,49,-49,127300,127800,7418,70482,57938
257.477434,4,80,50,30,-30,127300,127800,-1644,-11956,-19636
257.477434,5,1605,1554,51,-51,127300,127800,3412,-151212,-164268
257.477434,6,0,0,0,0,127300,127800,0,0,0
257.713221,0,485,385,100,-100,127100,127800,22133,174867,149267
257.713221,1,503,405,98,-98,127100,127800,23087,67113,42025
257.713221,2,2388,2339,49,-49,127100,127800,7861,-242561,-255105
257.713221,3,319,266,53,-53,127100,127800,7368,71732,58164
257.713221,4,80,50,30,-30,127100,127800,-1644,-11956,-19636
257.713221,5,1615,1554,61,-61,127100,127800,3285,-146085,-161701
257.713221,6,0,0,0,0,127100,127800,0,0,0
258.00422,0,485,385,100,-100,127300,127800,22133,174867,149267
258.00422,1,503,405,98,-98,127300,127800,23087,67113,42025
258.00422,2,2388,2341,47,-47,127300,127800,7836,-243536,-255568
258.00422,3,321,266,55,-55,127300,127800,7419,72281,58201
258.00422,4,80,50,30,-30,127300,127800,-1644,-11956,-19636
258.00422,5,1615,1554,61,-61,127300,127800,3285,-146085,-161701
258.00422,6,0,0,0,0,127300,127800,0,0,0
258.256148,0,485,385,100,-100,127300,127800,22133,174867,149267
258.256148,1,503,405,98,-98,127300,127800,23087,67113,42025
258.256148,2,2388,2341,47,-47,127300,127800,7836,-243536,-255568
258.256148,3,323,266,57,-57,127300,127800,7394,72706,58114
258.256148,4,80,50,30,-30,127300,127800,-1644,-11956,-19636
258.256148,5,1615,1556,59,-59,127300,127800,3336,-146936,-162040
258.256148,6,0,0,0,0,127300,127800,0,0,0
258.456196,0,485,385,100,-100,127300,127800,22133,174867,149267
258.456196,1,503,405,98,-98,127300,127800,23087,67113,42025
258.456196,2,2388,2341,47,-47,127300,127800,7836,-243536,-255568
258.456196,3,323,266,57,-57,127300,127800,7394,72706,58114
258.456196,4,80,50,30,-30,127300,127800,-1644,-11956,-19636
258.456196,5,1615,1556,59,-59,127300,127800,3336,-146936,-162040
258.456196,6,0,0,0,0,127300,127800,0,0,0
258.778186,0,485,385,100,-100,127200,127600,22133,174867,149367
258.778186,1,503,405,98,-98,127200,127600,23087,67113,42123
258.778186,2,2388,2345,43,-43,127200,127600,7862,-245562,-256527
258.778186,3,327,266,61,-61,127200,127600,7420,73880,58325
258.778186,4,80,50,30,-30,127200,127600,-1644,-11956,-19606
258.778186,5,1615,1556,59,-59,127200,127600,3336,-146936,-161981
258.778186,6,0,0,0,0,127200,127600,0,0,0
259.048674,0,485,385,100,-100,127200,127600,22133,174867,149367
259.048674,1,503,405,98,-98,127200,127600,23087,67113,42123
259.048674,2,2388,2347,41,-41,127200,127600,7837,-246537,-256992
259.048674,3,329,266,63,-63,127200,127600,7471,74429,58364
259.048674,4,80,50,30,-30,127200,127600,-1644,-11956,-19606
259.048674,5,1615,1556,59,-59,127200,127600,3336,-146936,-161981
259.048674,6,0,0,0,0,127200,127600,0,0,0
259.274972,0,485,385,100,-100,127200,127600,22133,174867,149367
259.274972,1,503,405,98,-98,127200,127600,23087,67113,42123
259.274972,2,2388,2349,39,-39,127200,127600,7812,-247512,-257457
259.274972,3,331,266,65,-65,127200,127600,7522,74978,58403
259.274972,4,80,50,30,-30,127200,127600,-1644,-11956,-19606
259.274972,5,1615,1556,59,-59,127200,127600,3336,-146936,-161981
259.274972,6,0,0,0,0,127200,127600,0,0,0
259.520451,0,485,385,100,-100,127200,127600,22133,174867,149367
259.520451,1,503,405,98,-98,127200,127600,23087,67113,42123
259.520451,2,2388,2349,39,-39,127200,127600,7812,-247512,-257457
259.520451,3,331,266,65,-65,127200,127600,7522,74978,58403
259.520451,4,80,50,30,-30,127200,127600,-1644,-11956,-19606
259.520451,5,1615,1556,59,-59,127200,127600,3336,-146936,-161981
259.520451,6,0,0,0,0,127200,127600,0,0,0
259.795256,0,485,385,100,-100,127200,127700,22133,174867,149367
259.795256,1,503,405,98,-98,127200,127700,23087,67113,42123
259.795256,2,2388,2349,39,-39,127200,127700,7812,-247512,-257457
259.795256,3,331,266,65,-65,127200,127700,7522,74978,58403
259.795256,4,80,50,30,-30,127200,127700,-1644,-11956,-19606
259.795256,5,1615,1556,59,-59,127200,127700,3336,-146936,-161981
259.795256,6,0,0,0,0,127200,127700,0,0,0
260.046789,0,485,385,100,-100,127500,127700,22133,174867,154867
260.046789,1,503,405,98,-98,127500,127700,23087,67113,47513
260.046789,2,2398,2353,45,-45,127500,127700,8017,-246517,-255517
260.046789,3,335,266,69,-69,127500,127700,7624,76876,63076
260.046789,4,80,50,30,-30,127500,127700,-1644,-11956,-17956
260.046789,5,1615,1556,59,-59,127500,127700,3336,-146936,-158736
260.046789,6,0,0,0,0,127500,127700,0,0,0
260.209257,0,485,385,100,-100,127500,127700,22133,174867,154867
260.209257,1,503,405,98,-98,127500,127700,23087,67113,47513
260.209257,2,2399,2353,46,-46,127500,127700,8043,-246143,-255343
260.209257,3,335,266,69,-69,127500,127700,7624,76876,63076
260.209257,4,80,50,30,-30,127500,127700,-1644,-11956,-17956
260.209257,5,1615,1556,59,-59,127500,127700,3336,-146936,-158736
260.209257,6,0,0,0,0,127500,127700,0,0,0
260.549839,0,485,385,100,-100,127500,127700,22133,174867,154867
260.549839,1,503,405,98,-98,127500,127700,23087,67113,47513
260.549839,2,2399,2353,46,-46,127500,127700,8043,-246143,-255343
260.549839,3,335,266,69,-69,127500,127700,7624,76876,63076
260.549839,4,80,50,30,-30,127500,127700,-1644,-11956,-17956
260.549839,5,1615,1556,59,-59,127500,127700,3336,-146936,-158736
260.549839,6,0,0,0,0,127500,127700,0,0,0
260.798661,0,485,385,100,-100,127700,127700,22133,174867,174867
260.798661,1,503,405,98,-98,127700,127700,23087,67113,67113
260.798661,2,2399,2353,46,-46,127700,127700,8043,-246143,-246143
260.798661,3,339,266,73,-73,127700,127700,7726,77974,77974
260.798661,4,80,50,30,-30,127700,127700,-1644,-11956,-11956
260.798661,5,1615,1556,59,-59,127700,127700,3336,-146936,-146936
260.798661,6,0,0,0,0,127700,127700,0,0,0
260.994905,0,485,385,100,-100,127900,127700,22133,174867,194867
260.994905,1,503,405,98,-98,127900,127700,23087,67113,86713
260.994905,2,2399,2363,36,-36,127900,127700,7915,-250015,-242815
260.994905,3,341,266,75,-75,127900,127700,7777,78523,93523
260.994905,4,80,50,30,-30,127900,127700,-1644,-11956,-5956
260.994905,5,1615,1566,49,-49,127900,127700,3208,-151808,-142008
260.994905,6,0,0,0,0,127900,127700,0,0,0
261.293313,0,485,385,100,-100,127800,128300,22133,174867,149167
261.293313,1,503,405,98,-98,127800,128300,23087,67113,41927
261.293313,2,2407,2363,44,-44,127800,128300,7813,-246713,-258021
261.293313,3,343,266,77,-77,127800,128300,7828,79072,59283
261.293313,4,80,50,30,-30,127800,128300,-1644,-11956,-19666
261.293313,5,1615,1566,49,-49,127800,128300,3208,-151808,-164401
261.293313,6,0,0,0,0,127800,128300,0,0,0
261.517928,0,485,385,100,-100,127900,128300,22133,174867,149167
261.517928,1,503,405,98,-98,127900,128300,23087,67113,41927
261.517928,2,2407,2363,44,-44,127900,128300,7813,-246713,-258021
261.517928,3,345,266,79,-79,127900,128300,7879,79621,59318
261.517928,4,80,50,30,-30,127900,128300,-1644,-11956,-19666
261.517928,5,1615,1566,49,-49,127900,128300,3208,-151808,-164401
261.517928,6,0,0,0,0,127900,128300,0,0,0
261.706114,0,485,385,100,-100,127900,128300,22133,174867,149167
261.706114,1,503,405,98,-98,127900,128300,23087,67113,41927
261.706114,2,2407,2363,44,-44,127900,128300,7813,-246713,-258021
261.706114,3,347,266,81,-81,127900,128300,7930,80170,59353
261.706114,4,80,50,30,-30,127900,128300,-1644,-11956,-19666
261.706114,5,1615,1566,49,-49,127900,128300,3208,-151808,-164401
261.706114,6,0,0,0,0,127900,128300,0,0,0
262.034981,0,485,385,100,-100,127900,128300,22133,174867,149167
262.034981,1,503,405,98,-98,127900,128300,23087,67113,41927
262.034981,2,2407,2363,44,-44,127900,128300,7813,-246713,-258021
262.034981,3,349,266,83,-83,127900,128300,7981,80719,59388
262.034981,4,80,50,30,-30,127900,128300,-1644,-11956,-19666
262.034981,5,1615,1566,49,-49,127900,128300,3208,-151808,-164401
262.034981,6,0,0,0,0,127900,128300,0,0,0
262.274609,0,485,385,100,-100,127900,128300,22133,174867,149167
262.274609,1,503,405,98,-98,127900,128300,23087,67113,41927
262.274609,2,2417,2363,54,-54,127900,128300,8069,-242969,-256847
262.274609,3,351,266,85,-85,127900,128300,8032,81468,59623
262.274609,4,80,50,30,-30,127900,128300,-1644,-11956,-19666
262.274609,5,1615,1566,49,-49,127900,128300,3208,-151808,-164401
262.274609,6,0,0,0,0,127900,128300,0,0,0
262.462517,0,485,385,100,-100,127900,128300,22133,174867,149167
262.462517,1,503,405,98,-98,127900,128300,23087,67113,41927
262.462517,2,2417,2363,54,-54,127900,128300,8069,-242969,-256847
262.462517,3,355,266,89,-89,127900,128300,8134,82566,59693
262.462517,4,80,50,30,-30,127900,128300,-1644,-11956,-19666
262.462517,5,1615,1566,49,-49,127900,128300,3208,-151808,-164401
262.462517,6,0,0,0,0,127900,128300,0,0,0
262.720646,0,485,385,100,-100,127900,128300,22133,174867,149167
262.720646,1,503,405,98,-98,127900,128300,23087,67113,41927
262.720646,2,2417,2363,54,-54,127900,128300,8069,-242969,-256847
262.720646,3,355,266,89,-89,127900,128300,8134,82566,59693
262.720646,4,80,50,30,-30,127900,128300,-1644,-11956,-19666
262.720646,5,1615,1566,49,-49,127900,128300,3208,-151808,-164401
262.720646,6,0,0,0,0,127900,128300,0,0,0
262.971932,0,485,385,100,-100,127900,128200,22133,174867,149267
262.971932,1,503,405,98,-98,127900,128200,23087,67113,42025
262.971932,2,2417,2363,54,-54,127900,128200,8069,-242969,-256793
262.971932,3,355,266,89,-89,127900,128200,8134,82566,59782
262.971932,4,80,50,30,-30,127900,128200,-1644,-11956,-19636
262.971932,5,1615,1566,49,-49,127900,128200,3208,-151808,-164352
262.971932,6,0,0,0,0,127900,128200,0,0,0
263.262094,0,485,385,100,-100,127900,128200,22133,174867,149267
263.262094,1,503,405,98,-98,127900,128200,23087,67113,42025
263.262094,2,2417,2363,54,-54,127900,128200,8069,-242969,-256793
263.262094,3,355,266,89,-89,127900,128200,8134,82566,59782
263.262094,4,80,50,30,-30,127900,128200,-1644,-11956,-19636
263.262094,5,1615,1566,49,-49,127900,128200,3208,-151808,-164352
263.262094,6,0,0,0,0,127900,128200,0,0,0
263.523195,0,485,385,100,-100,127900,128200,22133,174867,149267
263.523195,1,503,405,98,-98,127900,128200,23087,67113,42025
263.523195,2,2417,2363,54,-54,127900,128200,8069,-242969,-256793
263.523195,3,355,266,89,-89,127900,128200,8134,82566,59782
263.523195,4,80,50,30,-30,127900,128200,-1644,-11956,-19636
263.523195,5,1615,1566,49,-49,127900,128200,3208,-151808,-164352
263.523195,6,0,0,0,0,127900,128200,0,0,0
263.798773,0,485,385,100,-100,127900,128200,22133,174867,149267
263.798773,1,503,405,98,-98,127900,128200,23087,67113,42025
263.798773,2,2417,2363,54,-54,127900,128200,8069,-242969,-256793
263.798773,3,355,266,89,-89,127900,128200,8134,82566,59782
263.798773,4,80,50,30,-30,127900,128200,-1644,-11956,-19636
263.798773,5,1615,1566,49,-49,127900,128200,3208,-151808,-164352
263.798773,6,0,0,0,0,127900,128200,0,0,0
264.028442,0,485,385,100,-100,127900,128200,22133,174867,149267
264.028442,1,503,405,98,-98,127900,128200,23087,67113,42025
264.028442,2,2417,2363,54,-54,127900,128200,8069,-242969,-256793
264.028442,3,355,266,89,-89,127900,128200,8134,82566,59782
264.028442,4,80,50,30,-30,127900,128200,-1644,-11956,-19636
264.028442,5,1615,1566,49,-49,127900,128200,3208,-151808,-164352
264.028442,6,0,0,0,0,127900,128200,0,0,0
264.215774,0,485,385,100,-100,127900,128200,22133,174867,149267
264.215774,1,503,405,98,-98,127900,128200,23087,67113,42025
264.215774,2,2417,2363,54,-54,127900,128200,8069,-242969,-256793
264.215774,3,355,266,89,-89,127900,128200,8134,82566,59782
264.215774,4,80,50,30,-30,127900,128200,-1644,-11956,-19636
264.215774,5,1615,1566,49,-49,127900,128200,3208,-151808,-164352
264.215774,6,0,0,0,0,127900,128200,0,0,0
264.485153,0,485,385,100,-100,128000,128200,22133,174867,154867
264.485153,1,503,405,98,-98,128000,128200,23087,67113,47513
264.485153,2,2417,2363,54,-54,128000,128200,8069,-242969,-253769
264.485153,3,357,266,91,-91,128000,128200,8185,83115,64915
264.485153,4,80,50,30,-30,128000,128200,-1644,-11956,-17956
264.485153,5,1615,1566,49,-49,128000,128200,3208,-151808,-161608
264.485153,6,0,0,0,0,128000,128200,0,0,0
264.734739,0,485,385,100,-100,128000,128200,22133,174867,154867
264.734739,1,503,405,98,-98,128000,128200,23087,67113,47513
264.734739,2,2417,2363,54,-54,128000,128200,8069,-242969,-253769
264.734739,3,357,266,91,-91,128000,128200,8185,83115,64915
264.734739,4,80,50,30,-30,128000,128200,-1644,-11956,-17956
264.734739,5,1615,1566,49,-49,128000,128200,3208,-151808,-161608
264.734739,6,0,0,0,0,128000,128200,0,0,0
265.001414,0,485,385,100,-100,128000,128200,22133,174867,154867
265.001414,1,503,405,98,-98,128000,128200,23087,67113,47513
265.001414,2,2417,2363,54,-54,128000,128200,8069,-242969,-253769
265.001414,3,359,266,93,-93,128000,128200,8236,83864,65264
265.001414,4,80,50,30,-30,128000,128200,-1644,-11956,-17956
265.001414,5,1615,1566,49,-49,128000,128200,3208,-151808,-161608
265.001414,6,0,0,0,0,128000,128200,0,0,0
265.207607,0,485,385,100,-100,127900,128200,22133,174867,149267
265.207607,1,503,405,98,-98,127900,128200,23087,67113,42025
265.207607,2,2417,2373,44,-44,127900,128200,8325,-248225,-259489
265.207607,3,359,266,93,-93,127900,128200,8236,83864,60056
265.207607,4,80,50,30,-30,127900,128200,-1644,-11956,-19636
265.207607,5,1615,1566,49,-49,127900,128200,3208,-151808,-164352
265.207607,6,0,0,0,0,127900,128200,0,0,0
265.537104,0,485,385,100,-100,128100,128200,22133,174867,164867
265.537104,1,503,405,98,-98,128100,128200,23087,67113,57313
265.537104,2,2417,2373,44,-44,128100,128200,8325,-248225,-252625
265.537104,3,359,266,93,-93,128100,128200,8236,83864,74564
265.537104,4,80,50,30,-30,128100,128200,-1644,-11956,-14956
265.537104,5,1620,1566,54,-54,128100,128200,3336,-150936,-156336
265.537104,6,0,0,0,0,128100,128200,0,0,0
265.779898,0,485,385,100,-100,128100,128200,22133,174867,164867
265.779898,1,503,405,98,-98,128100,128200,23087,67113,57313
265.779898,2,2417,2373,44,-44,128100,128200,8325,-248225,-252625
265.779898,3,359,266,93,-93,128100,128200,8236,83864,74564
265.779898,4,80,50,30,-30,128100,128200,-1644,-11956,-14956
265.779898,5,1620,1566,54,-54,128100,128200,3336,-150936,-156336
265.779898,6,0,0,0,0,128100,128200,0,0,0
265.97105,0,485,385,100,-100,128100,128200,22133,174867,164867
265.97105,1,503,405,98,-98,128100,128200,23087,67113,57313
265.97105,2,2417,2373,44,-44,128100,128200,8325,-248225,-252625
265.97105,3,359,266,93,-93,128100,128200,8236,83864,74564
265.97105,4,80,50,30,-30,128100,128200,-1644,-11956,-14956
265.97105,5,1620,1566,54,-54,128100,128200,3336,-150936,-156336
265.97105,6,0,0,0,0,128100,128200,0,0,0
266.228933,0,485,385,100,-100,128100,128200,22133,174867,164867
266.228933,1,503,405,98,-98,128100,128200,23087,67113,57313
266.228933,2,2417,2373,44,-44,128100,128200,8325,-248225,-252625
266.228933,3,359,266,93,-93,128100,128200,8236,83864,74564
266.228933,4,80,50,30,-30,128100,128200,-1644,-11956,-14956
266.228933,5,1620,1566,54,-54,128100,128200,3336,-150936,-156336
266.228933,6,0,0,0,0,128100,128200,0,0,0
266.485562,0,485,385,100,-100,128100,128200,22133,174867,164867
266.485562,1,503,405,98,-98,128100,128200,23087,67113,57313
266.485562,2,2417,2373,44,-44,128100,128200,8325,-248225,-252625
266.485562,3,359,266,93,-93,128100,128200,8236,83864,74564
266.485562,4,80,50,30,-30,128100,128200,-1644,-11956,-14956
266.485562,5,1620,1566,54,-54,128100,128200,3336,-150936,-156336
266.485562,6,0,0,0,0,128100,128200,0,0,0
266.713289,0,485,385,100,-100,127900,128200,22133,174867,149267
266.713289,1,503,405,98,-98,127900,128200,23087,67113,42025
266.713289,2,2427,2373,54,-54,127900,128200,8197,-246097,-259921
266.713289,3,359,266,93,-93,127900,128200,8236,83864,60056
266.713289,4,80,50,30,-30,127900,128200,-1644,-11956,-19636
266.713289,5,1620,1576,44,-44,127900,128200,3592,-156192,-167456
266.713289,6,0,0,0,0,127900,128200,0,0,0
266.975529,0,485,385,100,-100,127600,128200,22133,174867,149267
266.975529,1,503,405,98,-98,127600,128200,23087,67113,42025
266.975529,2,2427,2383,44,-44,127600,128200,8452,-251352,-262616
266.975529,3,359,266,93,-93,127600,128200,8236,83864,60056
266.975529,4,80,50,30,-30,127600,128200,-1644,-11956,-19636
266.975529,5,1630,1576,54,-54,127600,128200,3464,-153064,-166888
266.975529,6,0,0,0,0,127600,128200,0,0,0
267.204455,0,485,385,100,-100,127600,128000,22133,174867,149267
267.204455,1,503,405,98,-98,127600,128000,23087,67113,42025
267.204455,2,2427,2383,44,-44,127600,128000,8452,-251352,-262616
267.204455,3,359,266,93,-93,127600,128000,8236,83864,60056
267.204455,4,80,50,30,-30,127600,128000,-1644,-11956,-19636
267.204455,5,1630,1576,54,-54,127600,128000,3464,-153064,-166888
267.204455,6,0,0,0,0,127600,128000,0,0,0
267.462081,0,485,385,100,-100,127600,128000,22133,174867,149267
267.462081,1,503,405,98,-98,127600,128000,23087,67113,42025
267.462081,2,2437,2383,54,-54,127600,128000,8324,-247224,-261048
267.462081,3,359,266,93,-93,127600,128000,8236,83864,60056
267.462081,4,80,50,30,-30,127600,128000,-1644,-11956,-19636
267.462081,5,1630,1586,44,-44,127600,128000,3719,-159319,-170583
267.462081,6,0,0,0,0,127600,128000,0,0,0
267.769634,0,485,385,100,-100,127600,128000,22133,174867,149267
267.769634,1,503,405,98,-98,127600,128000,23087,67113,42025
267.769634,2,2437,2383,54,-54,127600,128000,8324,-247224,-261048
267.769634,3,359,266,93,-93,127600,128000,8236,83864,60056
267.769634,4,80,50,30,-30,127600,128000,-1644,-11956,-19636
267.769634,5,1630,1586,44,-44,127600,128000,3719,-159319,-170583
267.769634,6,0,0,0,0,127600,128000,0,0,0
267.994081,0,485,385,100,-100,127500,128000,22133,174867,149267
267.994081,1,503,405,98,-98,127500,128000,23087,67113,42025
267.994081,2,2437,2393,44,-44,127500,128000,8579,-252479,-263743
267.994081,3,359,266,93,-93,127500,128000,8236,83864,60056
267.994081,4,80,50,30,-30,127500,128000,-1644,-11956,-19636
267.994081,5,1640,1586,54,-54,127500,128000,3591,-156191,-170015
267.994081,6,0,0,0,0,127500,128000,0,0,0
268.24242,0,485,385,100,-100,127700,128000,22133,174867,149267
268.24242,1,503,405,98,-98,127700,128000,23087,67113,42025
268.24242,2,2437,2403,34,-34,127700,128000,8451,-255351,-264055
268.24242,3,359,266,93,-93,127700,128000,8236,83864,60056
268.24242,4,80,50,30,-30,127700,128000,-1644,-11956,-19636
268.24242,5,1640,1586,54,-54,127700,128000,3591,-156191,-170015
268.24242,6,0,0,0,0,127700,128000,0,0,0
268.472441,0,485,385,100,-100,127700,128000,22133,174867,149267
268.472441,1,503,405,98,-98,127700,128000,23087,67113,42025
268.472441,2,2437,2403,34,-34,127700,128000,8451,-255351,-264055
268.472441,3,359,266,93,-93,127700,128000,8236,83864,60056
268.472441,4,80,50,30,-30,127700,128000,-1644,-11956,-19636
268.472441,5,1640,1586,54,-54,127700,128000,3591,-156191,-170015
268.472441,6,0,0,0,0,127700,128000,0,0,0
268.73372,0,485,385,100,-100,127700,128000,22133,174867,149267
268.73372,1,503,405,98,-98,127700,128000,23087,67113,42025
268.73372,2,2437,2403,34,-34,127700,128000,8451,-255351,-264055
268.73372,3,359,266,93,-93,127700,128000,8236,83864,60056
268.73372,4,80,50,30,-30,127700,128000,-1644,-11956,-19636
268.73372,5,1640,1586,54,-54,127700,128000,3591,-156191,-170015
268.73372,6,0,0,0,0,127700,128000,0,0,0
268.979205,0,485,385,100,-100,127700,128000,22133,174867,149267
268.979205,1,503,405,98,-98,127700,128000,23087,67113,42025
268.979205,2,2437,2403,34,-34,127700,128000,8451,-255351,-264055
268.979205,3,359,266,93,-93,127700,128000,8236,83864,60056
268.979205,4,80,50,30,-30,127700,128000,-1644,-11956,-19636
268.979205,5,1640,1586,54,-54,127700,128000,3591,-156191,-170015
268.979205,6,0,0,0,0,127700,128000,0,0,0
269.256582,0,485,385,100,-100,127400,128000,22133,174867,149267
269.256582,1,503,405,98,-98,127400,128000,23087,67113,42025
269.256582,2,2437,2403,34,-34,127400,128000,8451,-255351,-264055
269.256582,3,359,266,93,-93,127400,128000,8236,83864,60056
269.256582,4,80,50,30,-30,127400,128000,-1644,-11956,-19636
269.256582,5,1640,1596,44,-44,127400,128000,3846,-160446,-171710
269.256582,6,0,0,0,0,127400,128000,0,0,0
269.477094,0,485,385,100,-100,127400,128000,22133,174867,149267
269.477094,1,503,405,98,-98,127400,128000,23087,67113,42025
269.477094,2,2437,2413,24,-24,127400,128000,8706,-258606,-264750
269.477094,3,359,266,93,-93,127400,128000,8236,83864,60056
269.477094,4,80,50,30,-30,127400,128000,-1644,-11956,-19636
269.477094,5,1640,1606,34,-34,127400,128000,4101,-163701,-172405
269.477094,6,0,0,0,0,127400,128000,0,0,0
269.7838,0,485,385,100,-100,127400,128000,22133,174867,149267
269.7838,1,503,405,98,-98,127400,128000,23087,67113,42025
269.7838,2,2437,2413,24,-24,127400,128000,8706,-258606,-264750
269.7838,3,359,266,93,-93,127400,128000,8236,83864,60056
269.7838,4,80,50,30,-30,127400,128000,-1644,-11956,-19636
269.7838,5,1640,1606,34,-34,127400,128000,4101,-163701,-172405
269.7838,6,0,0,0,0,127400,128000,0,0,0
270.024877,0,485,385,100,-100,127400,128000,22133,174867,149267
270.024877,1,503,405,98,-98,127400,128000,23087,67113,42025
270.024877,2,2437,2413,24,-24,127400,128000,8706,-258606,-264750
270.024877,3,359,266,93,-93,127400,128000,8236,83864,60056
270.024877,4,80,50,30,-30,127400,128000,-1644,-11956,-19636
270.024877,5,1640,1606,34,-34,127400,128000,4101,-163701,-172405
270.024877,6,0,0,0,0,127400,128000,0,0,0
270.280406,0,485,385,100,-100,127400,128000,22133,174867,149267
270.280406,1,503,405,98,-98,127400,128000,23087,67113,42025
270.280406,2,2437,2413,24,-24,127400,128000,8706,-258606,-264750
270.280406,3,359,266,93,-93,127400,128000,8236,83864,60056
270.280406,4,80,50,30,-30,127400,128000,-1644,-11956,-19636
270.280406,5,1640,1606,34,-34,127400,128000,4101,-163701,-172405
270.280406,6,0,0,0,0,127400,128000,0,0,0
270.466072,0,485,385,100,-100,127400,128000,22133,174867,149267
270.466072,1,503,405,98,-98,127400,128000,23087,67113,42025
270.466072,2,2437,2413,24,-24,127400,128000,8706,-258606,-264750
270.466072,3,359,266,93,-93,127400,128000,8236,83864,60056
270.466072,4,80,50,30,-30,127400,128000,-1644,-11956,-19636
270.466072,5,1640,1606,34,-34,127400,128000,4101,-163701,-172405
270.466072,6,0,0,0,0,127400,128000,0,0,0
270.70578,0,485,385,100,-100,127400,128000,22133,174867,149267
270.70578,1,503,405,98,-98,127400,128000,23087,67113,42025
270.70578,2,2437,2413,24,-24,127400,128000,8706,-258606,-264750
270.70578,3,359,266,93,-93,127400,128000,8236,83864,60056
270.70578,4,80,50,30,-30,127400,128000,-1644,-11956,-19636
270.70578,5,1640,1606,34,-34,127400,128000,4101,-163701,-172405
270.70578,6,0,0,0,0,127400,128000,0,0,0
271.042825,0,485,385,100,-100,128100,128000,22133,174867,184867
271.042825,1,503,405,98,-98,128100,128000,23087,67113,76913
271.042825,2,2437,2423,14,-14,128100,128000,8578,-260478,-259078
271.042825,3,359,268,91,-91,128100,128000,8210,84490,93590
271.042825,4,80,50,30,-30,128100,128000,-1644,-11956,-8956
271.042825,5,1640,1606,34,-34,128100,128000,4101,-163701,-160301
271.042825,6,0,0,0,0,128100,128000,0,0,0
271.230063,0,485,385,100,-100,128100,128000,22133,174867,184867
271.230063,1,503,405,98,-98,128100,128000,23087,67113,76913
271.230063,2,2437,2423,14,-14,128100,128000,8578,-260478,-259078
271.230063,3,359,268,91,-91,128100,128000,8210,84490,93590
271.230063,4,80,50,30,-30,128100,128000,-1644,-11956,-8956
271.230063,5,1640,1606,34,-34,128100,128000,4101,-163701,-160301
271.230063,6,0,0,0,0,128100,128000,0,0,0
271.503491,0,485,385,100,-100,128100,127500,22133,174867,200367
271.503491,1,503,405,98,-98,128100,127500,23087,67113,92103
271.503491,2,2437,2423,14,-14,128100,127500,8578,-260478,-256908
271.503491,3,359,268,91,-91,128100,127500,8210,84490,107695
271.503491,4,80,50,30,-30,128100,127500,-1644,-11956,-4306
271.503491,5,1640,1606,34,-34,128100,127500,4101,-163701,-155031
271.503491,6,0,0,0,0,128100,127500,0,0,0
271.800168,0,485,385,100,-100,127400,127500,22133,174867,164867
271.800168,1,503,405,98,-98,127400,127500,23087,67113,57313
271.800168,2,2437,2433,4,-4,127400,127500,8833,-261733,-262133
271.800168,3,359,268,91,-91,127400,127500,8210,84490,75390
271.800168,4,80,50,30,-30,127400,127500,-1644,-11956,-14956
271.800168,5,1640,1606,34,-34,127400,127500,4101,-163701,-167101
271.800168,6,0,0,0,0,127400,127500,0,0,0
271.969717,0,485,385,100,-100,127000,127500,22133,174867,149367
271.969717,1,503,405,98,-98,127000,127500,23087,67113,42123
271.969717,2,2447,2440,7,-7,127000,127500,8884,-261084,-262869
271.969717,3,359,282,77,-77,127000,127500,8566,80934,61299
271.969717,4,80,50,30,-30,127000,127500,-1644,-11956,-19606
271.969717,5,1640,1606,34,-34,127000,127500,4101,-163701,-172371
271.969717,6,0,0,0,0,127000,127500,0,0,0
272.237918,0,485,385,100,-100,127000,127500,22133,174867,149367
272.237918,1,503,405,98,-98,127000,127500,23087,67113,42123
272.237918,2,2447,2440,7,-7,127000,127500,8884,-261084,-262869
272.237918,3,359,282,77,-77,127000,127500,8566,80934,61299
272.237918,4,80,50,30,-30,127000,127500,-1644,-11956,-19606
272.237918,5,1640,1606,34,-34,127000,127500,4101,-163701,-172371
272.237918,6,0,0,0,0,127000,127500,0,0,0
272.529782,0,485,385,100,-100,127000,127500,22133,174867,149367
272.529782,1,503,405,98,-98,127000,127500,23087,67113,42123
272.529782,2,2457,2440,17,-17,127000,127500,8757,-260957,-265292
272.529782,3,359,282,77,-77,127000,127500,8566,80934,61299
272.529782,4,80,50,30,-30,127000,127500,-1644,-11956,-19606
272.529782,5,1640,1606,34,-34,127000,127500,4101,-163701,-172371
272.529782,6,0,0,0,0,127000,127500,0,0,0
272.776352,0,485,385,100,-100,127100,127300,22133,174867,154867
272.776352,1,503,405,98,-98,127100,127300,23087,67113,47513
272.776352,2,2467,2440,27,-27,127100,127300,8630,-259830,-265230
272.776352,3,359,282,77,-77,127100,127300,8566,80934,65534
272.776352,4,80,50,30,-30,127100,127300,-1644,-11956,-17956
272.776352,5,1650,1606,44,-44,127100,127300,3974,-161574,-170374
272.776352,6,0,0,0,0,127100,127300,0,0,0
272.978655,0,485,385,100,-100,127100,127300,22133,174867,154867
272.978655,1,503,405,98,-98,127100,127300,23087,67113,47513
272.978655,2,2467,2440,27,-27,127100,127300,8630,-259830,-265230
272.978655,3,359,282,77,-77,127100,127300,8566,80934,65534
272.978655,4,80,50,30,-30,127100,127300,-1644,-11956,-17956
272.978655,5,1650,1606,44,-44,127100,127300,3974,-161574,-170374
272.978655,6,0,0,0,0,127100,127300,0,0,0
273.216693,0,485,385,100,-100,127100,127300,22133,174867,154867
273.216693,1,503,405,98,-98,127100,127300,23087,67113,47513
273.216693,2,2467,2440,27,-27,127100,127300,8630,-259830,-265230
273.216693,3,359,282,77,-77,127100,127300,8566,80934,65534
273.216693,4,80,50,30,-30,127100,127300,-1644,-11956,-17956
273.216693,5,1650,1606,44,-44,127100,127300,3974,-161574,-170374
273.216693,6,0,0,0,0,127100,127300,0,0,0
273.540778,0,485,385,100,-100,127100,127100,22133,174867,174867
273.540778,1,503,405,98,-98,127100,127100,23087,67113,67113
273.540778,2,2467,2440,27,-27,127100,127100,8630,-259830,-259830
273.540778,3,359,282,77,-77,127100,127100,8566,80934,80934
273.540778,4,80,50,30,-30,127100,127100,-1644,-11956,-11956
273.540778,5,1650,1606,44,-44,127100,127100,3974,-161574,-161574
273.540778,6,0,0,0,0,127100,127100,0,0,0
273.742992,0,485,385,100,-100,127100,127100,22133,174867,174867
273.742992,1,503,405,98,-98,127100,127100,23087,67113,67113
273.742992,2,2467,2440,27,-27,127100,127100,8630,-259830,-259830
273.742992,3,359,282,77,-77,127100,127100,8566,80934,80934
273.742992,4,80,50,30,-30,127100,127100,-1644,-11956,-11956
273.742992,5,1650,1606,44,-44,127100,127100,3974,-161574,-161574
273.742992,6,0,0,0,0,127100,127100,0,0,0
274.033704,0,485,385,100,-100,127000,127100,22133,174867,164867
274.033704,1,503,405,98,-98,127000,127100,23087,67113,57313
274.033704,2,2477,2440,37,-37,127000,127100,8884,-257084,-260784
274.033704,3,359,282,77,-77,127000,127100,8566,80934,73234
274.033704,4,80,50,30,-30,127000,127100,-1644,-11956,-14956
274.033704,5,1650,1616,34,-34,127000,127100,3847,-166447,-169847
274.033704,6,0,0,0,0,127000,127100,0,0,0
274.248585,0,485,385,100,-100,127000,127100,22133,174867,164867
274.248585,1,503,405,98,-98,127000,127100,23087,67113,57313
274.248585,2,2477,2440,37,-37,127000,127100,8884,-257084,-260784
274.248585,3,359,282,77,-77,127000,127100,8566,80934,73234
274.248585,4,80,50,30,-30,127000,127100,-1644,-11956,-14956
274.248585,5,1650,1616,34,-34,127000,127100,3847,-166447,-169847
274.248585,6,0,0,0,0,127000,127100,0,0,0
274.544915,0,485,385,100,-100,126800,127100,22133,174867,149467
274.544915,1,503,405,98,-98,126800,127100,23087,67113,42221
274.544915,2,2487,2440,47,-47,126800,127100,8757,-253957,-265895
274.544915,3,363,282,81,-81,126800,127100,8592,81908,61334
274.544915,4,80,50,30,-30,126800,127100,-1644,-11956,-19576
274.544915,5,1660,1616,44,-44,126800,127100,3720,-162320,-173496
274.544915,6,0,0,0,0,126800,127100,0,0,0
274.782796,0,485,385,100,-100,126800,127100,22133,174867,149467
274.782796,1,503,405,98,-98,126800,127100,23087,67113,42221
274.782796,2,2487,2440,47,-47,126800,127100,8757,-253957,-265895
274.782796,3,363,282,81,-81,126800,127100,8592,81908,61334
274.782796,4,80,50,30,-30,126800,127100,-1644,-11956,-19576
274.782796,5,1660,1616,44,-44,126800,127100,3720,-162320,-173496
274.782796,6,0,0,0,0,126800,127100,0,0,0
275.027854,0,485,385,100,-100,126800,127100,22133,174867,149467
275.027854,1,503,405,98,-98,126800,127100,23087,67113,42221
275.027854,2,2487,2440,47,-47,126800,127100,8757,-253957,-265895
275.027854,3,363,282,81,-81,126800,127100,8592,81908,61334
275.027854,4,80,50,30,-30,126800,127100,-1644,-11956,-19576
275.027854,5,1660,1616,44,-44,126800,127100,3720,-162320,-173496
275.027854,6,0,0,0,0,126800,127100,0,0,0
275.211797,0,485,385,100,-100,126800,127100,22133,174867,149467
275.211797,1,503,405,98,-98,126800,127100,23087,67113,42221
275.211797,2,2487,2440,47,-47,126800,127100,8757,-253957,-265895
275.211797,3,363,282,81,-81,126800,127100,8592,81908,61334
275.211797,4,80,50,30,-30,126800,127100,-1644,-11956,-19576
275.211797,5,1660,1616,44,-44,126800,127100,3720,-162320,-173496
275.211797,6,0,0,0,0,126800,127100,0,0,0
275.475388,0,485,385,100,-100,126900,127100,22133,174867,154867
275.475388,1,503,405,98,-98,126900,127100,23087,67113,47513
275.475388,2,2497,2440,57,-57,126900,127100,8630,-248830,-260230
275.475388,3,365,282,83,-83,126900,127100,8567,82733,66133
275.475388,4,80,50,30,-30,126900,127100,-1644,-11956,-17956
275.475388,5,1660,1616,44,-44,126900,127100,3720,-162320,-171120
275.475388,6,0,0,0,0,126900,127100,0,0,0
275.788527,0,485,385,100,-100,127000,127100,22133,174867,164867
275.788527,1,503,405,98,-98,127000,127100,23087,67113,57313
275.788527,2,2497,2440,57,-57,127000,127100,8630,-248830,-254530
275.788527,3,369,282,87,-87,127000,127100,8669,83831,75131
275.788527,4,80,50,30,-30,127000,127100,-1644,-11956,-14956
275.788527,5,1660,1616,44,-44,127000,127100,3720,-162320,-166720
275.788527,6,0,0,0,0,127000,127100,0,0,0
276.010493,0,485,385,100,-100,126900,127100,22133,174867,154867
276.010493,1,503,405,98,-98,126900,127100,23087,67113,47513
276.010493,2,2507,2440,67,-67,126900,127100,8503,-243703,-257103
276.010493,3,371,282,89,-89,126900,127100,8720,84580,66780
276.010493,4,80,50,30,-30,126900,127100,-1644,-11956,-17956
276.010493,5,1670,1616,54,-54,126900,127100,3593,-157193,-167993
276.010493,6,0,0,0,0,126900,127100,0,0,0
276.299624,0,485,385,100,-100,126900,127100,22133,174867,154867
276.299624,1,503,405,98,-98,126900,127100,23087,67113,47513
276.299624,2,2507,2440,67,-67,126900,127100,8503,-243703,-257103
276.299624,3,371,282,89,-89,126900,127100,8720,84580,66780
276.299624,4,80,50,30,-30,126900,127100,-1644,-11956,-17956
276.299624,5,1670,1616,54,-54,126900,127100,3593,-157193,-167993
276.299624,6,0,0,0,0,126900,127100,0,0,0
276.515661,0,485,385,100,-100,126900,127100,22133,174867,154867
276.515661,1,503,405,98,-98,126900,127100,23087,67113,47513
276.515661,2,2507,2440,67,-67,126900,127100,8503,-243703,-257103
276.515661,3,371,282,89,-89,126900,127100,8720,84580,66780
276.515661,4,80,50,30,-30,126900,127100,-1644,-11956,-17956
276.515661,5,1670,1616,54,-54,126900,127100,3593,-157193,-167993
276.515661,6,0,0,0,0,126900,127100,0,0,0
276.77588,0,485,385,100,-100,126900,127100,22133,174867,154867
276.77588,1,503,405,98,-98,126900,127100,23087,67113,47513
276.77588,2,2507,2440,67,-67,126900,127100,8503,-243703,-257103
276.77588,3,371,282,89,-89,126900,127100,8720,84580,66780
276.77588,4,80,50,30,-30,126900,127100,-1644,-11956,-17956
276.77588,5,1670,1616,54,-54,126900,127100,3593,-157193,-167993
276.77588,6,0,0,0,0,126900,127100,0,0,0
276.985652,0,485,385,100,-100,126900,127100,22133,174867,154867
276.985652,1,503,405,98,-98,126900,127100,23087,67113,47513
276.985652,2,2507,2440,67,-67,126900,127100,8503,-243703,-257103
276.985652,3,371,282,89,-89,126900,127100,8720,84580,66780
276.985652,4,80,50,30,-30,126900,127100,-1644,-11956,-17956
276.985652,5,1670,1616,54,-54,126900,127100,3593,-157193,-167993
276.985652,6,0,0,0,0,126900,127100,0,0,0
277.274768,0,485,385,100,-100,127000,127100,22133,174867,164867
277.274768,1,503,405,98,-98,127000,127100,23087,67113,57313
277.274768,2,2507,2440,67,-67,127000,127100,8503,-243703,-250403
277.274768,3,371,282,89,-89,127000,127100,8720,84580,75680
277.274768,4,80,50,30,-30,127000,127100,-1644,-11956,-14956
277.274768,5,1670,1616,54,-54,127000,127100,3593,-157193,-162593
277.274768,6,0,0,0,0,127000,127100,0,0,0
277.514922,0,485,385,100,-100,127000,127100,22133,174867,164867
277.514922,1,503,405,98,-98,127000,127100,23087,67113,57313
277.514922,2,2507,2440,67,-67,127000,127100,8503,-243703,-250403
277.514922,3,371,282,89,-89,127000,127100,8720,84580,75680
277.514922,4,80,50,30,-30,127000,127100,-1644,-11956,-14956
277.514922,5,1670,1616,54,-54,127000,127100,3593,-157193,-162593
277.514922,6,0,0,0,0,127000,127100,0,0,0
277.731795,0,485,385,100,-100,127000,127100,22133,174867,164867
277.731795,1,503,405,98,-98,127000,127100,23087,67113,57313
277.731795,2,2507,2440,67,-67,127000,127100,8503,-243703,-250403
277.731795,3,371,282,89,-89,127000,127100,8720,84580,75680
277.731795,4,80,50,30,-30,127000,127100,-1644,-11956,-14956
277.731795,5,1670,1616,54,-54,127000,127100,3593,-157193,-162593
277.731795,6,0,0,0,0,127000,127100,0,0,0
278.015955,0,485,385,100,-100,127000,127100,22133,174867,164867
278.015955,1,503,405,98,-98,127000,127100,23087,67113,57313
278.015955,2,2507,2440,67,-67,127000,127100,8503,-243703,-250403
278.015955,3,371,282,89,-89,127000,127100,8720,84580,75680
278.015955,4,80,50,30,-30,127000,127100,-1644,-11956,-14956
278.015955,5,1670,1616,54,-54,127000,127100,3593,-157193,-162593
278.015955,6,0,0,0,0,127000,127100,0,0,0
278.295911,0,485,385,100,-100,127000,127600,22133,174867,149367
278.295911,1,503,405,98,-98,127000,127600,23087,67113,42123
278.295911,2,2507,2440,67,-67,127000,127600,8503,-243703,-260788
278.295911,3,371,282,89,-89,127000,127600,8720,84580,61885
278.295911,4,80,50,30,-30,127000,127600,-1644,-11956,-19606
278.295911,5,1670,1616,54,-54,127000,127600,3593,-157193,-170963
278.295911,6,0,0,0,0,127000,127600,0,0,0
278.537662,0,485,385,100,-100,127200,127600,22133,174867,149367
278.537662,1,503,405,98,-98,127200,127600,23087,67113,42123
278.537662,2,2507,2460,47,-47,127200,127600,8249,-256449,-268434
278.537662,3,371,282,89,-89,127200,127600,8720,84580,61885
278.537662,4,80,50,30,-30,127200,127600,-1644,-11956,-19606
278.537662,5,1670,1626,44,-44,127200,127600,3466,-162066,-173286
278.537662,6,0,0,0,0,127200,127600,0,0,0
278.701916,0,485,415,70,-70,127900,127600,22900,177100,194950
278.701916,1,503,420,83,-83,127900,127600,23471,68229,89394
278.701916,2,2507,2470,37,-37,127900,127600,8505,-255705,-246270
278.701916,3,371,289,82,-82,127900,127600,8899,85101,106011
278.701916,4,80,50,30,-30,127900,127600,-1644,-11956,-4306
278.701916,5,1670,1636,34,-34,127900,127600,3722,-161322,-152652
278.701916,6,0,0,0,0,127900,127600,0,0,0
279.020543,0,485,415,70,-70,127300,127600,22900,177100,159250
279.020543,1,503,420,83,-83,127300,127600,23471,68229,47064
279.020543,2,2513,2470,43,-43,127300,127600,8429,-253829,-264794
279.020543,3,371,295,76,-76,127300,127600,9052,81948,62568
279.020543,4,80,50,30,-30,127300,127600,-1644,-11956,-19606
279.020543,5,1670,1636,34,-34,127300,127600,3722,-161322,-169992
279.020543,6,0,0,0,0,127300,127600,0,0,0
279.255791,0,485,415,70,-70,127400,127600,22900,177100,163100
279.255791,1,513,420,93,-93,127400,127600,23726,69974,51374
279.255791,2,2513,2480,33,-33,127400,127600,8302,-257702,-264302
279.255791,3,371,295,76,-76,127400,127600,9052,81948,66748
279.255791,4,80,50,30,-30,127400,127600,-1644,-11956,-17956
279.255791,5,1670,1636,34,-34,127400,127600,3722,-161322,-168122
279.255791,6,0,0,0,0,127400,127600,0,0,0
279.511314,0,485,415,70,-70,127100,127600,22900,177100,159250
279.511314,1,513,420,93,-93,127100,127600,23726,69974,46259
279.511314,2,2523,2480,43,-43,127100,127600,8175,-253575,-264540
279.511314,3,373,295,78,-78,127100,127600,9027,82573,62683
279.511314,4,80,50,30,-30,127100,127600,-1644,-11956,-19606
279.511314,5,1680,1636,44,-44,127100,127600,3595,-157195,-168415
279.511314,6,0,0,0,0,127100,127600,0,0,0
279.790756,0,485,415,70,-70,127100,127600,22900,177100,159250
279.790756,1,513,420,93,-93,127100,127600,23726,69974,46259
279.790756,2,2523,2480,43,-43,127100,127600,8175,-253575,-264540
279.790756,3,373,295,78,-78,127100,127600,9027,82573,62683
279.790756,4,80,50,30,-30,127100,127600,-1644,-11956,-19606
279.790756,5,1680,1636,44,-44,127100,127600,3595,-157195,-168415
279.790756,6,0,0,0,0,127100,127600,0,0,0
280.03733,0,495,415,80,-80,127400,127600,23155,178845,162845
280.03733,1,513,420,93,-93,127400,127600,23726,69974,51374
280.03733,2,2523,2490,33,-33,127400,127600,8048,-257448,-264048
280.03733,3,373,295,78,-78,127400,127600,9027,82573,66973
280.03733,4,80,50,30,-30,127400,127600,-1644,-11956,-17956
280.03733,5,1680,1636,44,-44,127400,127600,3595,-157195,-165995
280.03733,6,0,0,0,0,127400,127600,0,0,0
280.288,0,495,415,80,-80,127400,127600,23155,178845,162845
280.288,1,513,420,93,-93,127400,127600,23726,69974,51374
280.288,2,2523,2490,33,-33,127400,127600,8048,-257448,-264048
280.288,3,373,295,78,-78,127400,127600,9027,82573,66973
280.288,4,80,50,30,-30,127400,127600,-1644,-11956,-17956
280.288,5,1680,1636,44,-44,127400,127600,3595,-157195,-165995
280.288,6,0,0,0,0,127400,127600,0,0,0
280.450542,0,505,415,90,-90,127500,127600,23410,180590,171590
280.450542,1,513,420,93,-93,127500,127600,23726,69974,60674
280.450542,2,2523,2490,33,-33,127500,127600,8048,-257448,-260748
280.450542,3,373,295,78,-78,127500,127600,9027,82573,74773
280.450542,4,80,50,30,-30,127500,127600,-1644,-11956,-14956
280.450542,5,1680,1646,34,-34,127500,127600,3467,-161067,-164467
280.450542,6,0,0,0,0,127500,127600,0,0,0
280.784161,0,505,415,90,-90,127500,127600,23410,180590,171590
280.784161,1,513,420,93,-93,127500,127600,23726,69974,60674
280.784161,2,2523,2490,33,-33,127500,127600,8048,-257448,-260748
280.784161,3,373,295,78,-78,127500,127600,9027,82573,74773
280.784161,4,80,50,30,-30,127500,127600,-1644,-11956,-14956
280.784161,5,1680,1646,34,-34,127500,127600,3467,-161067,-164467
280.784161,6,0,0,0,0,127500,127600,0,0,0
280.996026,0,505,415,90,-90,127500,127600,23410,180590,171590
280.996026,1,513,420,93,-93,127500,127600,23726,69974,60674
280.996026,2,2523,2490,33,-33,127500,127600,8048,-257448,-260748
280.996026,3,373,295,78,-78,127500,127600,9027,82573,74773
280.996026,4,80,50,30,-30,127500,127600,-1644,-11956,-14956
280.996026,5,1680,1646,34,-34,127500,127600,3467,-161067,-164467
280.996026,6,0,0,0,0,127500,127600,0,0,0
281.201799,0,515,415,100,-100,127600,127600,23665,182335,182335
281.201799,1,513,420,93,-93,127600,127600,23726,69974,69974
281.201799,2,2523,2500,23,-23,127600,127600,7920,-261320,-261320
281.201799,3,373,295,78,-78,127600,127600,9027,82573,82573
281.201799,4,80,50,30,-30,127600,127600,-1644,-11956,-11956
281.201799,5,1680,1646,34,-34,127600,127600,3467,-161067,-161067
281.201799,6,0,0,0,0,127600,127600,0,0,0
281.481974,0,515,415,100,-100,127600,127600,23665,182335,182335
281.481974,1,513,420,93,-93,127600,127600,23726,69974,69974
281.481974,2,2523,2500,23,-23,127600,127600,7920,-261320,-261320
281.481974,3,373,295,78,-78,127600,127600,9027,82573,82573
281.481974,4,80,50,30,-30,127600,127600,-1644,-11956,-11956
281.481974,5,1680,1646,34,-34,127600,127600,3467,-161067,-161067
281.481974,6,0,0,0,0,127600,127600,0,0,0
281.773851,0,515,415,100,-100,127600,127600,23665,182335,182335
281.773851,1,513,420,93,-93,127600,127600,23726,69974,69974
281.773851,2,2523,2500,23,-23,127600,127600,7920,-261320,-261320
281.773851,3,373,295,78,-78,127600,127600,9027,82573,82573
281.773851,4,80,50,30,-30,127600,127600,-1644,-11956,-11956
281.773851,5,1680,1646,34,-34,127600,127600,3467,-161067,-161067
281.773851,6,0,0,0,0,127600,127600,0,0,0
282.050201,0,515,415,100,-100,127900,127600,23665,182335,207835
282.050201,1,513,420,93,-93,127900,127600,23726,69974,93689
282.050201,2,2523,2510,13,-13,127900,127600,7792,-262192,-258877
282.050201,3,373,295,78,-78,127900,127600,9027,82573,102463
282.050201,4,80,50,30,-30,127900,127600,-1644,-11956,-4306
282.050201,5,1680,1648,32,-32,127900,127600,3441,-161241,-153081
282.050201,6,0,0,0,0,127900,127600,0,0,0
282.20604,0,515,415,100,-100,127900,127600,23665,182335,207835
282.20604,1,513,420,93,-93,127900,127600,23726,69974,93689
282.20604,2,2523,2510,13,-13,127900,127600,7792,-262192,-258877
282.20604,3,373,295,78,-78,127900,127600,9027,82573,102463
282.20604,4,80,50,30,-30,127900,127600,-1644,-11956,-4306
282.20604,5,1680,1648,32,-32,127900,127600,3441,-161241,-153081
282.20604,6,0,0,0,0,127900,127600,0,0,0
282.514741,0,515,415,100,-100,127700,127600,23665,182335,192335
282.514741,1,513,420,93,-93,127700,127600,23726,69974,79274
282.514741,2,2533,2510,23,-23,127700,127600,7664,-261064,-258764
282.514741,3,373,295,78,-78,127700,127600,9027,82573,90373
282.514741,4,80,50,30,-30,127700,127600,-1644,-11956,-8956
282.514741,5,1680,1658,22,-22,127700,127600,3696,-163496,-161296
282.514741,6,0,0,0,0,127700,127600,0,0,0
282.716328,0,515,415,100,-100,128100,127600,23665,182335,207835
282.716328,1,513,420,93,-93,128100,127600,23726,69974,93689
282.716328,2,2533,2520,13,-13,128100,127600,7919,-263319,-260004
282.716328,3,373,295,78,-78,128100,127600,9027,82573,102463
282.716328,4,80,50,30,-30,128100,127600,-1644,-11956,-4306
282.716328,5,1690,1658,32,-32,128100,127600,3568,-162368,-154208
282.716328,6,0,0,0,0,128100,127600,0,0,0
283.006113,0,515,415,100,-100,128100,127600,23665,182335,207835
283.006113,1,513,420,93,-93,128100,127600,23726,69974,93689
283.006113,2,2533,2520,13,-13,128100,127600,7919,-263319,-260004
283.006113,3,373,295,78,-78,128100,127600,9027,82573,102463
283.006113,4,80,50,30,-30,128100,127600,-1644,-11956,-4306
283.006113,5,1690,1658,32,-32,128100,127600,3568,-162368,-154208
283.006113,6,0,0,0,0,128100,127600,0,0,0
283.268538,0,515,415,100,-100,128100,127600,23665,182335,207835
283.268538,1,513,420,93,-93,128100,127600,23726,69974,93689
283.268538,2,2533,2520,13,-13,128100,127600,7919,-263319,-260004
283.268538,3,373,295,78,-78,128100,127600,9027,82573,102463
283.268538,4,80,50,30,-30,128100,127600,-1644,-11956,-4306
283.268538,5,1690,1658,32,-32,128100,127600,3568,-162368,-154208
283.268538,6,0,0,0,0,128100,127600,0,0,0
283.545488,0,515,415,100,-100,127800,127600,23665,182335,202335
283.545488,1,513,420,93,-93,127800,127600,23726,69974,88574
283.545488,2,2533,2520,13,-13,127800,127600,7919,-263319,-260719
283.545488,3,373,295,78,-78,127800,127600,9027,82573,98173
283.545488,4,80,50,30,-30,127800,127600,-1644,-11956,-5956
283.545488,5,1690,1666,24,-24,127800,127600,3466,-163866,-159066
283.545488,6,0,0,0,0,127800,127600,0,0,0
283.742722,0,515,415,100,-100,127800,127600,23665,182335,202335
283.742722,1,513,420,93,-93,127800,127600,23726,69974,88574
283.742722,2,2533,2520,13,-13,127800,127600,7919,-263319,-260719
283.742722,3,373,295,78,-78,127800,127600,9027,82573,98173
283.742722,4,80,50,30,-30,127800,127600,-1644,-11956,-5956
283.742722,5,1690,1666,24,-24,127800,127600,3466,-163866,-159066
283.742722,6,0,0,0,0,127800,127600,0,0,0
283.958047,0,515,415,100,-100,127800,127600,23665,182335,202335
283.958047,1,513,420,93,-93,127800,127600,23726,69974,88574
283.958047,2,2533,2520,13,-13,127800,127600,7919,-263319,-260719
283.958047,3,373,295,78,-78,127800,127600,9027,82573,98173
283.958047,4,80,50,30,-30,127800,127600,-1644,-11956,-5956
283.958047,5,1690,1666,24,-24,127800,127600,3466,-163866,-159066
283.958047,6,0,0,0,0,127800,127600,0,0,0
284.285573,0,515,415,100,-100,128000,127600,23665,182335,207835
284.285573,1,513,420,93,-93,128000,127600,23726,69974,93689
284.285573,2,2543,2520,23,-23,128000,127600,8175,-262575,-256710
284.285573,3,373,295,78,-78,128000,127600,9027,82573,102463
284.285573,4,80,50,30,-30,128000,127600,-1644,-11956,-4306
284.285573,5,1690,1676,14,-14,128000,127600,3338,-165738,-162168
284.285573,6,0,0,0,0,128000,127600,0,0,0
284.534627,0,515,415,100,-100,128000,127600,23665,182335,207835
284.534627,1,513,420,93,-93,128000,127600,23726,69974,93689
284.534627,2,2543,2520,23,-23,128000,127600,8175,-262575,-256710
284.534627,3,373,295,78,-78,128000,127600,9027,82573,102463
284.534627,4,80,50,30,-30,128000,127600,-1644,-11956,-4306
284.534627,5,1690,1676,14,-14,128000,127600,3338,-165738,-162168
284.534627,6,0,0,0,0,128000,127600,0,0,0
284.72842,0,515,415,100,-100,128000,127600,23665,182335,207835
284.72842,1,513,420,93,-93,128000,127600,23726,69974,93689
284.72842,2,2543,2520,23,-23,128000,127600,8175,-262575,-256710
284.72842,3,373,295,78,-78,128000,127600,9027,82573,102463
284.72842,4,80,50,30,-30,128000,127600,-1644,-11956,-4306
284.72842,5,1690,1676,14,-14,128000,127600,3338,-165738,-162168
284.72842,6,0,0,0,0,128000,127600,0,0,0
285.04159,0,515,415,100,-100,128000,127600,23665,182335,207835
285.04159,1,513,420,93,-93,128000,127600,23726,69974,93689
285.04159,2,2543,2520,23,-23,128000,127600,8175,-262575,-256710
285.04159,3,373,295,78,-78,128000,127600,9027,82573,102463
285.04159,4,80,50,30,-30,128000,127600,-1644,-11956,-4306
285.04159,5,1690,1676,14,-14,128000,127600,3338,-165738,-162168
285.04159,6,0,0,0,0,128000,127600,0,0,0
285.294979,0,515,415,100,-100,128000,127600,23665,182335,207835
285.294979,1,513,420,93,-93,128000,127600,23726,69974,93689
285.294979,2,2543,2520,23,-23,128000,127600,8175,-262575,-256710
285.294979,3,373,295,78,-78,128000,127600,9027,82573,102463
285.294979,4,80,50,30,-30,128000,127600,-1644,-11956,-4306
285.294979,5,1690,1676,14,-14,128000,127600,3338,-165738,-162168
285.294979,6,0,0,0,0,128000,127600,0,0,0
285.532966,0,515,415,100,-100,128000,127600,23665,182335,207835
285.532966,1,513,420,93,-93,128000,127600,23726,69974,93689
285.532966,2,2543,2520,23,-23,128000,127600,8175,-262575,-256710
285.532966,3,373,295,78,-78,128000,127600,9027,82573,102463
285.532966,4,80,50,30,-30,128000,127600,-1644,-11956,-4306
285.532966,5,1690,1676,14,-14,128000,127600,3338,-165738,-162168
285.532966,6,0,0,0,0,128000,127600,0,0,0
285.782685,0,515,415,100,-100,127900,127600,23665,182335,207835
285.782685,1,513,420,93,-93,127900,127600,23726,69974,93689
285.782685,2,2551,2520,31,-31,127900,127600,8073,-260873,-252968
285.782685,3,373,295,78,-78,127900,127600,9027,82573,102463
285.782685,4,80,50,30,-30,127900,127600,-1644,-11956,-4306
285.782685,5,1690,1676,14,-14,127900,127600,3338,-165738,-162168
285.782685,6,0,0,0,0,127900,127600,0,0,0
286.021552,0,515,415,100,-100,127900,128300,23665,182335,156635
286.021552,1,513,420,93,-93,127900,128300,23726,69974,46073
286.021552,2,2551,2530,21,-21,127900,128300,7945,-263745,-269142
286.021552,3,373,295,78,-78,127900,128300,9027,82573,62527
286.021552,4,80,50,30,-30,127900,128300,-1644,-11956,-19666
286.021552,5,1700,1676,24,-24,127900,128300,3594,-163994,-170162
286.021552,6,0,0,0,0,127900,128300,0,0,0
286.226037,0,515,415,100,-100,128100,128500,23665,182335,156635
286.226037,1,513,420,93,-93,128100,128500,23726,69974,46073
286.226037,2,2561,2530,31,-31,128100,128500,8201,-260001,-267968
286.226037,3,375,295,80,-80,128100,128500,9078,83322,62762
286.226037,4,80,50,30,-30,128100,128500,-1644,-11956,-19666
286.226037,5,1700,1676,24,-24,128100,128500,3594,-163994,-170162
286.226037,6,0,0,0,0,128100,128500,0,0,0
286.513126,0,515,415,100,-100,128100,128500,23665,182335,156635
286.513126,1,513,420,93,-93,128100,128500,23726,69974,46073
286.513126,2,2561,2530,31,-31,128100,128500,8201,-260001,-267968
286.513126,3,375,295,80,-80,128100,128500,9078,83322,62762
286.513126,4,80,50,30,-30,128100,128500,-1644,-11956,-19666
286.513126,5,1700,1676,24,-24,128100,128500,3594,-163994,-170162
286.513126,6,0,0,0,0,128100,128500,0,0,0
286.733985,0,515,415,100,-100,128100,128500,23665,182335,156635
286.733985,1,513,420,93,-93,128100,128500,23726,69974,46073
286.733985,2,2561,2530,31,-31,128100,128500,8201,-260001,-267968
286.733985,3,375,295,80,-80,128100,128500,9078,83322,62762
286.733985,4,80,50,30,-30,128100,128500,-1644,-11956,-19666
286.733985,5,1700,1676,24,-24,128100,128500,3594,-163994,-170162
286.733985,6,0,0,0,0,128100,128500,0,0,0
286.997441,0,515,415,100,-100,128100,128500,23665,182335,156635
286.997441,1,513,420,93,-93,128100,128500,23726,69974,46073
286.997441,2,2561,2530,31,-31,128100,128500,8201,-260001,-267968
286.997441,3,377,295,82,-82,128100,128500,9129,83671,62597
286.997441,4,80,50,30,-30,128100,128500,-1644,-11956,-19666
286.997441,5,1710,1676,34,-34,128100,128500,3850,-162250,-170988
286.997441,6,0,0,0,0,128100,128500,0,0,0
287.256924,0,515,415,100,-100,128100,128500,23665,182335,156635
287.256924,1,513,420,93,-93,128100,128500,23726,69974,46073
287.256924,2,2561,2530,31,-31,128100,128500,8201,-260001,-267968
287.256924,3,377,295,82,-82,128100,128500,9129,83671,62597
287.256924,4,80,50,30,-30,128100,128500,-1644,-11956,-19666
287.256924,5,1710,1676,34,-34,128100,128500,3850,-162250,-170988
287.256924,6,0,0,0,0,128100,128500,0,0,0
287.526776,0,515,415,100,-100,128100,128500,23665,182335,156635
287.526776,1,513,420,93,-93,128100,128500,23726,69974,46073
287.526776,2,2571,2530,41,-41,128100,128500,8073,-256873,-267410
287.526776,3,379,295,84,-84,128100,128500,9103,84297,62709
287.526776,4,80,50,30,-30,128100,128500,-1644,-11956,-19666
287.526776,5,1720,1676,44,-44,128100,128500,3722,-160122,-171430
287.526776,6,0,0,0,0,128100,128500,0,0,0
287.782243,0,515,415,100,-100,128100,128500,23665,182335,156635
287.782243,1,513,420,93,-93,128100,128500,23726,69974,46073
287.782243,2,2571,2530,41,-41,128100,128500,8073,-256873,-267410
287.782243,3,379,295,84,-84,128100,128500,9103,84297,62709
287.782243,4,80,50,30,-30,128100,128500,-1644,-11956,-19666
287.782243,5,1720,1676,44,-44,128100,128500,3722,-160122,-171430
287.782243,6,0,0,0,0,128100,128500,0,0,0
287.993864,0,515,415,100,-100,128100,128500,23665,182335,156635
287.993864,1,513,420,93,-93,128100,128500,23726,69974,46073
287.993864,2,2571,2530,41,-41,128100,128500,8073,-256873,-267410
287.993864,3,379,295,84,-84,128100,128500,9103,84297,62709
287.993864,4,80,50,30,-30,128100,128500,-1644,-11956,-19666
287.993864,5,1720,1676,44,-44,128100,128500,3722,-160122,-171430
287.993864,6,0,0,0,0,128100,128500,0,0,0
288.247431,0,515,415,100,-100,127900,128500,23665,182335,156635
288.247431,1,513,420,93,-93,127900,128500,23726,69974,46073
288.247431,2,2571,2532,39,-39,127900,128500,8124,-257924,-267947
288.247431,3,381,295,86,-86,127900,128500,9077,84923,62821
288.247431,4,80,50,30,-30,127900,128500,-1644,-11956,-19666
288.247431,5,1720,1676,44,-44,127900,128500,3722,-160122,-171430
288.247431,6,0,0,0,0,127900,128500,0,0,0
288.526664,0,515,415,100,-100,128300,128500,23665,182335,162335
288.526664,1,513,420,93,-93,128300,128500,23726,69974,51374
288.526664,2,2581,2542,39,-39,128300,128500,7868,-257668,-265468
288.526664,3,381,295,86,-86,128300,128500,9077,84923,67723
288.526664,4,80,50,30,-30,128300,128500,-1644,-11956,-17956
288.526664,5,1720,1686,34,-34,128300,128500,3978,-165378,-172178
288.526664,6,0,0,0,0,128300,128500,0,0,0
288.72404,0,515,415,100,-100,128300,128500,23665,182335,162335
288.72404,1,513,420,93,-93,128300,128500,23726,69974,51374
288.72404,2,2581,2542,39,-39,128300,128500,7868,-257668,-265468
288.72404,3,381,295,86,-86,128300,128500,9077,84923,67723
288.72404,4,80,50,30,-30,128300,128500,-1644,-11956,-17956
288.72404,5,1720,1686,34,-34,128300,128500,3978,-165378,-172178
288.72404,6,0,0,0,0,128300,128500,0,0,0
289.034508,0,515,415,100,-100,128300,128500,23665,182335,162335
289.034508,1,513,420,93,-93,128300,128500,23726,69974,51374
289.034508,2,2581,2542,39,-39,128300,128500,7868,-257668,-265468
289.034508,3,381,295,86,-86,128300,128500,9077,84923,67723
289.034508,4,80,50,30,-30,128300,128500,-1644,-11956,-17956
289.034508,5,1720,1686,34,-34,128300,128500,3978,-165378,-172178
289.034508,6,0,0,0,0,128300,128500,0,0,0
289.234637,0,515,415,100,-100,128300,128500,23665,182335,162335
289.234637,1,513,420,93,-93,128300,128500,23726,69974,51374
289.234637,2,2581,2542,39,-39,128300,128500,7868,-257668,-265468
289.234637,3,381,295,86,-86,128300,128500,9077,84923,67723
289.234637,4,80,50,30,-30,128300,128500,-1644,-11956,-17956
289.234637,5,1720,1686,34,-34,128300,128500,3978,-165378,-172178
289.234637,6,0,0,0,0,128300,128500,0,0,0
289.509981,0,515,415,100,-100,128300,128500,23665,182335,162335
289.509981,1,513,420,93,-93,128300,128500,23726,69974,51374
289.509981,2,2581,2552,29,-29,128300,128500,7740,-260540,-266340
289.509981,3,383,295,88,-88,128300,128500,9128,85272,67672
289.509981,4,80,50,30,-30,128300,128500,-1644,-11956,-17956
289.509981,5,1720,1696,24,-24,128300,128500,3850,-167250,-172050
289.509981,6,0,0,0,0,128300,128500,0,0,0
289.736107,0,515,415,100,-100,128300,128500,23665,182335,162335
289.736107,1,513,420,93,-93,128300,128500,23726,69974,51374
289.736107,2,2581,2552,29,-29,128300,128500,7740,-260540,-266340
289.736107,3,383,295,88,-88,128300,128500,9128,85272,67672
289.736107,4,80,50,30,-30,128300,128500,-1644,-11956,-17956
289.736107,5,1720,1696,24,-24,128300,128500,3850,-167250,-172050
289.736107,6,0,0,0,0,128300,128500,0,0,0
290.04042,0,515,415,100,-100,128300,128500,23665,182335,162335
290.04042,1,513,420,93,-93,128300,128500,23726,69974,51374
290.04042,2,2581,2562,19,-19,128300,128500,7612,-262412,-266212
290.04042,3,383,295,88,-88,128300,128500,9128,85272,67672
290.04042,4,80,50,30,-30,128300,128500,-1644,-11956,-17956
290.04042,5,1720,1696,24,-24,128300,128500,3850,-167250,-172050
290.04042,6,0,0,0,0,128300,128500,0,0,0
290.226325,0,515,415,100,-100,128300,128500,23665,182335,162335
290.226325,1,513,420,93,-93,128300,128500,23726,69974,51374
290.226325,2,2581,2562,19,-19,128300,128500,7612,-262412,-266212
290.226325,3,383,295,88,-88,128300,128500,9128,85272,67672
290.226325,4,80,50,30,-30,128300,128500,-1644,-11956,-17956
290.226325,5,1720,1696,24,-24,128300,128500,3850,-167250,-172050
290.226325,6,0,0,0,0,128300,128500,0,0,0
290.452936,0,515,415,100,-100,127800,128500,23665,182335,156635
290.452936,1,513,420,93,-93,127800,128500,23726,69974,46073
290.452936,2,2591,2562,29,-29,127800,128500,7484,-261284,-268737
290.452936,3,385,295,90,-90,127800,128500,9102,85898,62768
290.452936,4,80,50,30,-30,127800,128500,-1644,-11956,-19666
290.452936,5,1730,1696,34,-34,127800,128500,3722,-164122,-172860
290.452936,6,0,0,0,0,127800,128500,0,0,0
290.73424,0,515,415,100,-100,127800,128400,23665,182335,156635
290.73424,1,513,420,93,-93,127800,128400,23726,69974,46073
290.73424,2,2591,2562,29,-29,127800,128400,7484,-261284,-268737
290.73424,3,385,295,90,-90,127800,128400,9102,85898,62768
290.73424,4,80,50,30,-30,127800,128400,-1644,-11956,-19666
290.73424,5,1730,1696,34,-34,127800,128400,3722,-164122,-172860
290.73424,6,0,0,0,0,127800,128400,0,0,0
291.000241,0,515,415,100,-100,127800,128300,23665,182335,156635
291.000241,1,513,420,93,-93,127800,128300,23726,69974,46073
291.000241,2,2591,2562,29,-29,127800,128300,7484,-261284,-268737
291.000241,3,385,295,90,-90,127800,128300,9102,85898,62768
291.000241,4,80,50,30,-30,127800,128300,-1644,-11956,-19666
291.000241,5,1730,1696,34,-34,127800,128300,3722,-164122,-172860
291.000241,6,0,0,0,0,127800,128300,0,0,0
291.281912,0,515,415,100,-100,127800,128300,23665,182335,156635
291.281912,1,513,420,93,-93,127800,128300,23726,69974,46073
291.281912,2,2591,2562,29,-29,127800,128300,7484,-261284,-268737
291.281912,3,385,295,90,-90,127800,128300,9102,85898,62768
291.281912,4,80,50,30,-30,127800,128300,-1644,-11956,-19666
291.281912,5,1730,1696,34,-34,127800,128300,3722,-164122,-172860
291.281912,6,0,0,0,0,127800,128300,0,0,0
291.547314,0,515,415,100,-100,127800,128300,23665,182335,156635
291.547314,1,513,420,93,-93,127800,128300,23726,69974,46073
291.547314,2,2591,2562,29,-29,127800,128300,7484,-261284,-268737
291.547314,3,385,295,90,-90,127800,128300,9102,85898,62768
291.547314,4,80,50,30,-30,127800,128300,-1644,-11956,-19666
291.547314,5,1730,1696,34,-34,127800,128300,3722,-164122,-172860
291.547314,6,0,0,0,0,127800,128300,0,0,0
291.764428,0,515,415,100,-100,127600,128300,23665,182335,156635
291.764428,1,513,420,93,-93,127600,128300,23726,69974,46073
291.764428,2,2601,2562,39,-39,127600,128300,7356,-259156,-269179
291.764428,3,385,295,90,-90,127600,128300,9102,85898,62768
291.764428,4,80,50,30,-30,127600,128300,-1644,-11956,-19666
291.764428,5,1740,1696,44,-44,127600,128300,3594,-161994,-173302
291.764428,6,0,0,0,0,127600,128300,0,0,0
291.999587,0,515,415,100,-100,127600,128300,23665,182335,156635
291.999587,1,513,420,93,-93,127600,128300,23726,69974,46073
291.999587,2,2601,2562,39,-39,127600,128300,7356,-259156,-269179
291.999587,3,385,295,90,-90,127600,128300,9102,85898,62768
291.999587,4,80,50,30,-30,127600,128300,-1644,-11956,-19666
291.999587,5,1740,1696,44,-44,127600,128300,3594,-161994,-173302
291.999587,6,0,0,0,0,127600,128300,0,0,0
292.238698,0,515,415,100,-100,127600,128300,23665,182335,156635
292.238698,1,513,420,93,-93,127600,128300,23726,69974,46073
292.238698,2,2601,2562,39,-39,127600,128300,7356,-259156,-269179
292.238698,3,385,295,90,-90,127600,128300,9102,85898,62768
292.238698,4,80,50,30,-30,127600,128300,-1644,-11956,-19666
292.238698,5,1740,1696,44,-44,127600,128300,3594,-161994,-173302
292.238698,6,0,0,0,0,127600,128300,0,0,0
292.513855,0,515,415,100,-100,128000,128300,23665,182335,156635
292.513855,1,513,420,93,-93,128000,128300,23726,69974,46073
292.513855,2,2601,2564,37,-37,128000,128300,7330,-259730,-269239
292.513855,3,387,295,92,-92,128000,128300,9153,86247,62603
292.513855,4,80,50,30,-30,128000,128300,-1644,-11956,-19666
292.513855,5,1740,1696,44,-44,128000,128300,3594,-161994,-173302
292.513855,6,0,0,0,0,128000,128300,0,0,0
292.745169,0,515,415,100,-100,128000,128300,23665,182335,156635
292.745169,1,513,420,93,-93,128000,128300,23726,69974,46073
292.745169,2,2611,2564,47,-47,128000,128300,7202,-256602,-268681
292.745169,3,387,295,92,-92,128000,128300,9153,86247,62603
292.745169,4,80,50,30,-30,128000,128300,-1644,-11956,-19666
292.745169,5,1740,1706,34,-34,128000,128300,3850,-167250,-175988
292.745169,6,0,0,0,0,128000,128300,0,0,0
293.04956,0,515,415,100,-100,128100,128300,23665,182335,162335
293.04956,1,513,420,93,-93,128100,128300,23726,69974,51374
293.04956,2,2611,2574,37,-37,128100,128300,7074,-260474,-267874
293.04956,3,387,295,92,-92,128100,128300,9153,86247,67847
293.04956,4,80,50,30,-30,128100,128300,-1644,-11956,-17956
293.04956,5,1750,1706,44,-44,128100,128300,4106,-165506,-174306
293.04956,6,0,0,0,0,128100,128300,0,0,0
293.287465,0,515,415,100,-100,128000,128300,23665,182335,156635
293.287465,1,513,420,93,-93,128000,128300,23726,69974,46073
293.287465,2,2619,2574,45,-45,128000,128300,6972,-257972,-269537
293.287465,3,387,295,92,-92,128000,128300,9153,86247,62603
293.287465,4,80,50,30,-30,128000,128300,-1644,-11956,-19666
293.287465,5,1750,1706,44,-44,128000,128300,4106,-165506,-176814
293.287465,6,0,0,0,0,128000,128300,0,0,0
293.502538,0,515,415,100,-100,128000,128300,23665,182335,156635
293.502538,1,513,420,93,-93,128000,128300,23726,69974,46073
293.502538,2,2619,2574,45,-45,128000,128300,6972,-257972,-269537
293.502538,3,387,295,92,-92,128000,128300,9153,86247,62603
293.502538,4,80,50,30,-30,128000,128300,-1644,-11956,-19666
293.502538,5,1750,1706,44,-44,128000,128300,4106,-165506,-176814
293.502538,6,0,0,0,0,128000,128300,0,0,0
293.755201,0,515,415,100,-100,128000,128300,23665,182335,156635
293.755201,1,513,420,93,-93,128000,128300,23726,69974,46073
293.755201,2,2619,2574,45,-45,128000,128300,6972,-257972,-269537
293.755201,3,387,295,92,-92,128000,128300,9153,86247,62603
293.755201,4,80,50,30,-30,128000,128300,-1644,-11956,-19666
293.755201,5,1750,1706,44,-44,128000,128300,4106,-165506,-176814
293.755201,6,0,0,0,0,128000,128300,0,0,0
294.042384,0,515,415,100,-100,127800,128300,23665,182335,156635
294.042384,1,513,420,93,-93,127800,128300,23726,69974,46073
294.042384,2,2629,2584,45,-45,127800,128300,7100,-257100,-268665
294.042384,3,387,295,92,-92,127800,128300,9153,86247,62603
294.042384,4,80,50,30,-30,127800,128300,-1644,-11956,-19666
294.042384,5,1760,1706,54,-54,127800,128300,3978,-162378,-176256
294.042384,6,0,0,0,0,127800,128300,0,0,0
294.247825,0,515,415,100,-100,127900,128300,23665,182335,156635
294.247825,1,513,420,93,-93,127900,128300,23726,69974,46073
294.247825,2,2639,2584,55,-55,127900,128300,6972,-252972,-267107
294.247825,3,387,295,92,-92,127900,128300,9153,86247,62603
294.247825,4,80,50,30,-30,127900,128300,-1644,-11956,-19666
294.247825,5,1760,1706,54,-54,127900,128300,3978,-162378,-176256
294.247825,6,0,0,0,0,127900,128300,0,0,0
294.523284,0,515,415,100,-100,127900,128300,23665,182335,156635
294.523284,1,513,420,93,-93,127900,128300,23726,69974,46073
294.523284,2,2639,2584,55,-55,127900,128300,6972,-252972,-267107
294.523284,3,387,295,92,-92,127900,128300,9153,86247,62603
294.523284,4,80,50,30,-30,127900,128300,-1644,-11956,-19666
294.523284,5,1760,1706,54,-54,127900,128300,3978,-162378,-176256
294.523284,6,0,0,0,0,127900,128300,0,0,0
294.705059,0,515,415,100,-100,127800,128300,23665,182335,156635
294.705059,1,513,420,93,-93,127800,128300,23726,69974,46073
294.705059,2,2649,2584,65,-65,127800,128300,6844,-247844,-264549
294.705059,3,387,295,92,-92,127800,128300,9153,86247,62603
294.705059,4,80,50,30,-30,127800,128300,-1644,-11956,-19666
294.705059,5,1770,1716,54,-54,127800,128300,4490,-164890,-178768
294.705059,6,0,0,0,0,127800,128300,0,0,0
295.007579,0,515,415,100,-100,127700,128300,23665,182335,156635
295.007579,1,513,420,93,-93,127700,128300,23726,69974,46073
295.007579,2,2649,2594,55,-55,127700,128300,7100,-254100,-268235
295.007579,3,387,295,92,-92,127700,128300,9153,86247,62603
295.007579,4,80,50,30,-30,127700,128300,-1644,-11956,-19666
295.007579,5,1780,1716,64,-64,127700,128300,4362,-162762,-179210
295.007579,6,0,0,0,0,127700,128300,0,0,0
295.228862,0,515,415,100,-100,127700,128300,23665,182335,156635
295.228862,1,513,420,93,-93,127700,128300,23726,69974,46073
295.228862,2,2649,2604,45,-45,127700,128300,7355,-259355,-270920
295.228862,3,387,295,92,-92,127700,128300,9153,86247,62603
295.228862,4,80,50,30,-30,127700,128300,-1644,-11956,-19666
295.228862,5,1780,1716,64,-64,127700,128300,4362,-162762,-179210
295.228862,6,0,0,0,0,127700,128300,0,0,0
295.531991,0,515,415,100,-100,128400,128300,23665,182335,192335
295.531991,1,513,420,93,-93,128400,128300,23726,69974,79274
295.531991,2,2649,2604,45,-45,128400,128300,7355,-259355,-254855
295.531991,3,387,295,92,-92,128400,128300,9153,86247,95447
295.531991,4,80,50,30,-30,128400,128300,-1644,-11956,-8956
295.531991,5,1780,1716,64,-64,128400,128300,4362,-162762,-156362
295.531991,6,0,0,0,0,128400,128300,0,0,0
295.800318,0,515,415,100,-100,127600,128300,23665,182335,156635
295.800318,1,513,420,93,-93,127600,128300,23726,69974,46073
295.800318,2,2649,2614,35,-35,127600,128300,7610,-262610,-271605
295.800318,3,387,295,92,-92,127600,128300,9153,86247,62603
295.800318,4,80,50,30,-30,127600,128300,-1644,-11956,-19666
295.800318,5,1780,1716,64,-64,127600,128300,4362,-162762,-179210
295.800318,6,0,0,0,0,127600,128300,0,0,0
296.002048,0,515,415,100,-100,127600,128300,23665,182335,156635
296.002048,1,513,420,93,-93,127600,128300,23726,69974,46073
296.002048,2,2649,2624,25,-25,127600,128300,7865,-265865,-272290
296.002048,3,387,295,92,-92,127600,128300,9153,86247,62603
296.002048,4,80,50,30,-30,127600,128300,-1644,-11956,-19666
296.002048,5,1780,1716,64,-64,127600,128300,4362,-162762,-179210
296.002048,6,0,0,0,0,127600,128300,0,0,0
296.280967,0,515,415,100,-100,127600,128300,23665,182335,156635
296.280967,1,513,420,93,-93,127600,128300,23726,69974,46073
296.280967,2,2650,2624,26,-26,127600,128300,7852,-265652,-272334
296.280967,3,387,295,92,-92,127600,128300,9153,86247,62603
296.280967,4,80,50,30,-30,127600,128300,-1644,-11956,-19666
296.280967,5,1780,1716,64,-64,127600,128300,4362,-162762,-179210
296.280967,6,0,0,0,0,127600,128300,0,0,0
296.505786,0,515,415,100,-100,127600,128300,23665,182335,156635
296.505786,1,513,420,93,-93,127600,128300,23726,69974,46073
296.505786,2,2650,2624,26,-26,127600,128300,7852,-265652,-272334
296.505786,3,387,295,92,-92,127600,128300,9153,86247,62603
296.505786,4,80,50,30,-30,127600,128300,-1644,-11956,-19666
296.505786,5,1780,1716,64,-64,127600,128300,4362,-162762,-179210
296.505786,6,0,0,0,0,127600,128300,0,0,0
296.752455,0,515,415,100,-100,128400,128300,23665,182335,192335
296.752455,1,513,420,93,-93,128400,128300,23726,69974,79274
296.752455,2,2650,2634,16,-16,128400,128300,7724,-267524,-265924
296.752455,3,387,297,90,-90,128400,128300,9127,86873,95873
296.752455,4,80,50,30,-30,128400,128300,-1644,-11956,-8956
296.752455,5,1780,1716,64,-64,128400,128300,4362,-162762,-156362
296.752455,6,0,0,0,0,128400,128300,0,0,0
296.986549,0,515,415,100,-100,128400,127800,23665,182335,207935
296.986549,1,513,420,93,-93,128400,127800,23726,69974,93782
296.986549,2,2650,2634,16,-16,128400,127800,7724,-267524,-263428
296.986549,3,387,297,90,-90,128400,127800,9127,86873,109913
296.986549,4,80,50,30,-30,128400,127800,-1644,-11956,-4276
296.986549,5,1780,1716,64,-64,128400,127800,4362,-162762,-146378
296.986549,6,0,0,0,0,128400,127800,0,0,0
297.209122,0,515,415,100,-100,127500,127800,23665,182335,156735
297.209122,1,513,420,93,-93,127500,127800,23726,69974,46166
297.209122,2,2650,2644,6,-6,127500,127800,7979,-267779,-269315
297.209122,3,387,311,76,-76,127500,127800,9483,86517,67061
297.209122,4,80,50,30,-30,127500,127800,-1644,-11956,-19636
297.209122,5,1780,1716,64,-64,127500,127800,4362,-162762,-179146
297.209122,6,0,0,0,0,127500,127800,0,0,0
297.481572,0,515,415,100,-100,127900,127000,23665,182335,207735
297.481572,1,513,420,93,-93,127900,127000,23726,69974,93596
297.481572,2,2650,2654,-4,4,127900,127000,8234,-267034,-268050
297.481572,3,387,325,62,-62,127900,127000,9763,87837,103585
297.481572,4,80,50,30,-30,127900,127000,-1644,-11956,-4336
297.481572,5,1780,1716,64,-64,127900,127000,4362,-162762,-146506
297.481572,6,0,0,0,0,127900,127000,0,0,0
297.714935,0,515,427,88,-88,126900,127000,23970,184830,176030
297.714935,1,513,420,93,-93,126900,127000,23726,69974,60674
297.714935,2,2665,2654,11,-11,126900,127000,8044,-271344,-272444
297.714935,3,387,330,57,-57,126900,127000,9890,87210,81510
297.714935,4,80,50,30,-30,126900,127000,-1644,-11956,-14956
297.714935,5,1780,1716,64,-64,126900,127000,4362,-162762,-169162
297.714935,6,0,0,0,0,126900,127000,0,0,0
298.044206,0,515,427,88,-88,126900,127000,23970,184830,176030
298.044206,1,513,420,93,-93,126900,127000,23726,69974,60674
298.044206,2,2665,2654,11,-11,126900,127000,8044,-271344,-272444
298.044206,3,387,330,57,-57,126900,127000,9890,87210,81510
298.044206,4,80,50,30,-30,126900,127000,-1644,-11956,-14956
298.044206,5,1780,1716,64,-64,126900,127000,4362,-162762,-169162
298.044206,6,0,0,0,0,126900,127000,0,0,0
298.262531,0,515,427,88,-88,126900,127000,23970,184830,176030
298.262531,1,513,420,93,-93,126900,127000,23726,69974,60674
298.262531,2,2665,2654,11,-11,126900,127000,8044,-271344,-272444
298.262531,3,387,330,57,-57,126900,127000,9890,87210,81510
298.262531,4,80,50,30,-30,126900,127000,-1644,-11956,-14956
298.262531,5,1780,1716,64,-64,126900,127000,4362,-162762,-169162
298.262531,6,0,0,0,0,126900,127000,0,0,0
298.45973,0,515,427,88,-88,126900,127000,23970,184830,176030
298.45973,1,513,420,93,-93,126900,127000,23726,69974,60674
298.45973,2,2665,2654,11,-11,126900,127000,8044,-271344,-272444
298.45973,3,387,330,57,-57,126900,127000,9890,87210,81510
298.45973,4,80,50,30,-30,126900,127000,-1644,-11956,-14956
298.45973,5,1780,1716,64,-64,126900,127000,4362,-162762,-169162
298.45973,6,0,0,0,0,126900,127000,0,0,0
298.743483,0,515,427,88,-88,126900,127000,23970,184830,176030
298.743483,1,513,420,93,-93,126900,127000,23726,69974,60674
298.743483,2,2665,2664,1,-1,126900,127000,8298,-271598,-271698
298.743483,3,387,334,53,-53,126900,127000,9991,87109,81809
298.743483,4,80,50,30,-30,126900,127000,-1644,-11956,-14956
298.743483,5,1780,1716,64,-64,126900,127000,4362,-162762,-169162
298.743483,6,0,0,0,0,126900,127000,0,0,0
299.000286,0,515,427,88,-88,127400,127000,23970,184830,207182
299.000286,1,513,420,93,-93,127400,127000,23726,69974,93596
299.000286,2,2665,2674,-9,9,127400,127000,8552,-271852,-274138
299.000286,3,387,336,51,-51,127400,127000,9966,87534,100488
299.000286,4,80,50,30,-30,127400,127000,-1644,-11956,-4336
299.000286,5,1780,1716,64,-64,127400,127000,4362,-162762,-146506
299.000286,6,0,0,0,0,127400,127000,0,0,0
299.211537,0,515,427,88,-88,127400,127000,23970,184830,207182
299.211537,1,513,420,93,-93,127400,127000,23726,69974,93596
299.211537,2,2665,2674,-9,9,127400,127000,8552,-271852,-274138
299.211537,3,387,336,51,-51,127400,127000,9966,87534,100488
299.211537,4,80,50,30,-30,127400,127000,-1644,-11956,-4336
299.211537,5,1780,1716,64,-64,127400,127000,4362,-162762,-146506
299.211537,6,0,0,0,0,127400,127000,0,0,0
299.496334,0,515,427,88,-88,126800,127000,23970,184830,167230
299.496334,1,513,420,93,-93,126800,127000,23726,69974,51374
299.496334,2,2665,2674,-9,9,126800,127000,8552,-271852,-270052
299.496334,3,387,344,43,-43,126800,127000,10168,87332,78732
299.496334,4,80,50,30,-30,126800,127000,-1644,-11956,-17956
299.496334,5,1780,1716,64,-64,126800,127000,4362,-162762,-175562
299.496334,6,0,0,0,0,126800,127000,0,0,0
299.704614,0,515,427,88,-88,126800,127000,23970,184830,167230
299.704614,1,513,420,93,-93,126800,127000,23726,69974,51374
299.704614,2,2665,2674,-9,9,126800,127000,8552,-271852,-270052
299.704614,3,387,344,43,-43,126800,127000,10168,87332,78732
299.704614,4,80,50,30,-30,126800,127000,-1644,-11956,-17956
299.704614,5,1780,1716,64,-64,126800,127000,4362,-162762,-175562
299.704614,6,0,0,0,0,126800,127000,0,0,0
299.962546,0,515,427,88,-88,126800,126800,23970,184830,184830
299.962546,1,513,420,93,-93,126800,126800,23726,69974,69974
299.962546,2,2665,2674,-9,9,126800,126800,8552,-271852,-271852
299.962546,3,387,347,40,-40,126800,126800,10244,87256,87256
299.962546,4,80,50,30,-30,126800,126800,-1644,-11956,-11956
299.962546,5,1780,1716,64,-64,126800,126800,4362,-162762,-162762
299.962546,6,0,0,0,0,126800,126800,0,0,0
300.223507,0,515,427,88,-88,126800,126800,23970,184830,184830
300.223507,1,513,420,93,-93,126800,126800,23726,69974,69974
300.223507,2,2665,2674,-9,9,126800,126800,8552,-271852,-271852
300.223507,3,387,347,40,-40,126800,126800,10244,87256,87256
300.223507,4,80,50,30,-30,126800,126800,-1644,-11956,-11956
300.223507,5,1780,1716,64,-64,126800,126800,4362,-162762,-162762
300.223507,6,0,0,0,0,126800,126800,0,0,0
300.469213,0,515,427,88,-88,126800,126900,23970,184830,176030
300.469213,1,513,420,93,-93,126800,126900,23726,69974,60674
300.469213,2,2675,2674,1,-1,126800,126900,8425,-272725,-272825
300.469213,3,387,350,37,-37,126800,126900,10320,86880,83180
300.469213,4,80,50,30,-30,126800,126900,-1644,-11956,-14956
300.469213,5,1780,1726,54,-54,126800,126900,4616,-163016,-168416
300.469213,6,0,0,0,0,126800,126900,0,0,0
300.705798,0,515,427,88,-88,126800,126900,23970,184830,176030
300.705798,1,513,420,93,-93,126800,126900,23726,69974,60674
300.705798,2,2675,2674,1,-1,126800,126900,8425,-272725,-272825
300.705798,3,387,350,37,-37,126800,126900,10320,86880,83180
300.705798,4,80,50,30,-30,126800,126900,-1644,-11956,-14956
300.705798,5,1780,1736,44,-44,126800,126900,4870,-165270,-169670
300.705798,6,0,0,0,0,126800,126900,0,0,0
301.043808,0,515,427,88,-88,126800,127000,23970,184830,167230
301.043808,1,513,420,93,-93,126800,127000,23726,69974,51374
301.043808,2,2675,2674,1,-1,126800,127000,8425,-272725,-272925
301.043808,3,387,350,37,-37,126800,127000,10320,86880,79480
301.043808,4,80,50,30,-30,126800,127000,-1644,-11956,-17956
301.043808,5,1780,1746,34,-34,126800,127000,5124,-168524,-175324
301.043808,6,0,0,0,0,126800,127000,0,0,0
301.212183,0,515,427,88,-88,127300,127000,23970,184830,207182
301.212183,1,513,420,93,-93,127300,127000,23726,69974,93596
301.212183,2,2685,2684,1,-1,127300,127000,8171,-272471,-272217
301.212183,3,387,352,35,-35,127300,127000,10295,87505,96395
301.212183,4,80,50,30,-30,127300,127000,-1644,-11956,-4336
301.212183,5,1780,1756,24,-24,127300,127000,5378,-169778,-163682
301.212183,6,0,0,0,0,127300,127000,0,0,0
301.514953,0,515,427,88,-88,126900,127000,23970,184830,176030
301.514953,1,513,420,93,-93,126900,127000,23726,69974,60674
301.514953,2,2695,2684,11,-11,126900,127000,8044,-272344,-273444
301.514953,3,387,352,35,-35,126900,127000,10295,87505,84005
301.514953,4,80,50,30,-30,126900,127000,-1644,-11956,-14956
301.514953,5,1780,1766,14,-14,126900,127000,5632,-171032,-172432
301.514953,6,0,0,0,0,126900,127000,0,0,0
301.73919,0,515,427,88,-88,126800,127000,23970,184830,167230
301.73919,1,513,420,93,-93,126800,127000,23726,69974,51374
301.73919,2,2695,2684,11,-11,126800,127000,8044,-272344,-274544
301.73919,3,387,352,35,-35,126800,127000,10295,87505,80505
301.73919,4,80,50,30,-30,126800,127000,-1644,-11956,-17956
301.73919,5,1780,1766,14,-14,126800,127000,5632,-171032,-173832
301.73919,6,0,0,0,0,126800,127000,0,0,0
302.047652,0,515,427,88,-88,126800,127000,23970,184830,167230
302.047652,1,513,420,93,-93,126800,127000,23726,69974,51374
302.047652,2,2695,2684,11,-11,126800,127000,8044,-272344,-274544
302.047652,3,387,352,35,-35,126800,127000,10295,87505,80505
302.047652,4,80,50,30,-30,126800,127000,-1644,-11956,-17956
302.047652,5,1780,1766,14,-14,126800,127000,5632,-171032,-173832
302.047652,6,0,0,0,0,126800,127000,0,0,0
302.240878,0,515,427,88,-88,126800,127000,23970,184830,167230
302.240878,1,513,420,93,-93,126800,127000,23726,69974,51374
302.240878,2,2695,2684,11,-11,126800,127000,8044,-272344,-274544
302.240878,3,387,352,35,-35,126800,127000,10295,87505,80505
302.240878,4,80,50,30,-30,126800,127000,-1644,-11956,-17956
302.240878,5,1780,1766,14,-14,126800,127000,5632,-171032,-173832
302.240878,6,0,0,0,0,126800,127000,0,0,0
302.526181,0,515,427,88,-88,126800,127100,23970,184830,162478
302.526181,1,513,420,93,-93,126800,127100,23726,69974,46352
302.526181,2,2705,2684,21,-21,126800,127100,7917,-273217,-278551
302.526181,3,387,352,35,-35,126800,127100,10295,87505,78615
302.526181,4,80,50,30,-30,126800,127100,-1644,-11956,-19576
302.526181,5,1782,1766,16,-16,126800,127100,5607,-171007,-175071
302.526181,6,0,0,0,0,126800,127100,0,0,0
302.731081,0,515,427,88,-88,126800,126700,23970,184830,193630
302.731081,1,513,420,93,-93,126800,126700,23726,69974,79274
302.731081,2,2705,2694,11,-11,126800,126700,8171,-274471,-273371
302.731081,3,387,352,35,-35,126800,126700,10295,87505,91005
302.731081,4,80,50,30,-30,126800,126700,-1644,-11956,-8956
302.731081,5,1792,1766,26,-26,126800,126700,5480,-171880,-169280
302.731081,6,0,0,0,0,126800,126700,0,0,0
302.97856,0,515,427,88,-88,126700,126700,23970,184830,184830
302.97856,1,513,420,93,-93,126700,126700,23726,69974,69974
302.97856,2,2705,2704,1,-1,126700,126700,8424,-275724,-275724
302.97856,3,387,354,33,-33,126700,126700,10346,87254,87254
302.97856,4,80,50,30,-30,126700,126700,-1644,-11956,-11956
302.97856,5,1792,1766,26,-26,126700,126700,5480,-171880,-171880
302.97856,6,0,0,0,0,126700,126700,0,0,0
303.226171,0,515,427,88,-88,126700,126800,23970,184830,176030
303.226171,1,513,420,93,-93,126700,126800,23726,69974,60674
303.226171,2,2705,2714,-9,9,126700,126800,8677,-275977,-275077
303.226171,3,387,354,33,-33,126700,126800,10346,87254,83954
303.226171,4,80,50,30,-30,126700,126800,-1644,-11956,-14956
303.226171,5,1792,1766,26,-26,126700,126800,5480,-171880,-174480
303.226171,6,0,0,0,0,126700,126800,0,0,0
303.53507,0,515,427,88,-88,126700,126600,23970,184830,193630
303.53507,1,513,420,93,-93,126700,126600,23726,69974,79274
303.53507,2,2705,2714,-9,9,126700,126600,8677,-275977,-276877
303.53507,3,387,354,33,-33,126700,126600,10346,87254,90554
303.53507,4,80,50,30,-30,126700,126600,-1644,-11956,-8956
303.53507,5,1792,1766,26,-26,126700,126600,5480,-171880,-169280
303.53507,6,0,0,0,0,126700,126600,0,0,0
303.776206,0,515,427,88,-88,126700,126600,23970,184830,193630
303.776206,1,513,496,17,-17,126700,126600,25649,75651,77351
303.776206,2,2705,2724,-19,19,126700,126600,8930,-275230,-277130
303.776206,3,387,358,29,-29,126700,126600,10448,87552,90452
303.776206,4,80,50,30,-30,126700,126600,-1644,-11956,-8956
303.776206,5,1792,1776,16,-16,126700,126600,5733,-171133,-169533
303.776206,6,0,0,0,0,126700,126600,0,0,0
303.962321,0,515,427,88,-88,126600,126600,23970,184830,184830
303.962321,1,513,496,17,-17,126600,126600,25649,75651,75651
303.962321,2,2705,2724,-19,19,126600,126600,8930,-275230,-275230
303.962321,3,387,358,29,-29,126600,126600,10448,87552,87552
303.962321,4,80,50,30,-30,126600,126600,-1644,-11956,-11956
303.962321,5,1792,1786,6,-6,126600,126600,5986,-170386,-170386
303.962321,6,0,0,0,0,126600,126600,0,0,0
304.254181,0,515,427,88,-88,126500,126500,23970,184830,184830
304.254181,1,513,496,17,-17,126500,126500,25649,75651,75651
304.254181,2,2705,2724,-19,19,126500,126500,8930,-275230,-275230
304.254181,3,387,362,25,-25,126500,126500,10550,87450,87450
304.254181,4,80,50,30,-30,126500,126500,-1644,-11956,-11956
304.254181,5,1792,1790,2,-2,126500,126500,6087,-170087,-170087
304.254181,6,0,0,0,0,126500,126500,0,0,0
304.462546,0,515,427,88,-88,126600,126500,23970,184830,193630
304.462546,1,513,496,17,-17,126600,126500,25649,75651,77351
304.462546,2,2713,2724,-11,11,126600,126500,9057,-276957,-278057
304.462546,3,387,364,23,-23,126600,126500,10601,87399,89699
304.462546,4,80,50,30,-30,126600,126500,-1644,-11956,-8956
304.462546,5,1792,1796,-4,4,126600,126500,6011,-170011,-170411
304.462546,6,0,0,0,0,126600,126500,0,0,0
304.793147,0,515,429,86,-86,126500,126500,24021,185179,185179
304.793147,1,513,496,17,-17,126500,126500,25649,75651,75651
304.793147,2,2715,2724,-9,9,126500,126500,9032,-277732,-277732
304.793147,3,387,368,19,-19,126500,126500,10703,87697,87697
304.793147,4,80,50,30,-30,126500,126500,-1644,-11956,-11956
304.793147,5,1792,1796,-4,4,126500,126500,6011,-170011,-170011
304.793147,6,0,0,0,0,126500,126500,0,0,0
305.012432,0,515,429,86,-86,126500,126500,24021,185179,185179
305.012432,1,513,515,-2,2,126500,126500,26130,77070,77070
305.012432,2,2715,2734,-19,19,126500,126500,9285,-276985,-276985
305.012432,3,387,368,19,-19,126500,126500,10703,87697,87697
305.012432,4,80,50,30,-30,126500,126500,-1644,-11956,-11956
305.012432,5,1792,1796,-4,4,126500,126500,6011,-170011,-170011
305.012432,6,0,0,0,0,126500,126500,0,0,0
305.250967,0,515,429,86,-86,126500,126500,24021,185179,185179
305.250967,1,513,515,-2,2,126500,126500,26130,77070,77070
305.250967,2,2717,2734,-17,17,126500,126500,9260,-277360,-277360
305.250967,3,387,370,17,-17,126500,126500,10754,87846,87846
305.250967,4,80,50,30,-30,126500,126500,-1644,-11956,-11956
305.250967,5,1792,1796,-4,4,126500,126500,6011,-170011,-170011
305.250967,6,0,0,0,0,126500,126500,0,0,0
305.50483,0,515,429,86,-86,126400,126500,24021,185179,176579
305.50483,1,513,515,-2,2,126400,126500,26130,77070,77270
305.50483,2,2717,2734,-17,17,126400,126500,9260,-277360,-275660
305.50483,3,387,372,15,-15,126400,126500,10805,87795,86295
305.50483,4,80,50,30,-30,126400,126500,-1644,-11956,-14956
305.50483,5,1792,1796,-4,4,126400,126500,6011,-170011,-169611
305.50483,6,0,0,0,0,126400,126500,0,0,0
305.753562,0,515,429,86,-86,126400,126500,24021,185179,176579
305.753562,1,513,601,-88,88,126400,126500,28306,74894,83694
305.753562,2,2727,2734,-7,7,126400,126500,9133,-279233,-278533
305.753562,3,387,372,15,-15,126400,126500,10805,87795,86295
305.753562,4,80,50,30,-30,126400,126500,-1644,-11956,-14956
305.753562,5,1792,1796,-4,4,126400,126500,6011,-170011,-169611
305.753562,6,0,0,0,0,126400,126500,0,0,0
305.992477,0,515,429,86,-86,126900,125800,24021,185179,206851
305.992477,1,513,611,-98,98,126900,125800,28559,75641,50945
305.992477,2,2727,2744,-17,17,126900,125800,9386,-278486,-282770
305.992477,3,387,378,9,-9,126900,125800,10882,88518,90786
305.992477,4,80,50,30,-30,126900,125800,-1644,-11956,-4396
305.992477,5,1792,1806,-14,14,126900,125800,5885,-168885,-172413
305.992477,6,0,0,0,0,126900,125800,0,0,0
306.253379,0,515,459,56,-56,126200,125800,24778,194622,208734
306.253379,1,513,611,-98,98,126200,125800,28559,75641,50945
306.253379,2,2727,2754,-27,27,126200,125800,9639,-274739,-281543
306.253379,3,387,384,3,-3,126200,125800,11032,90168,90924
306.253379,4,80,50,30,-30,126200,125800,-1644,-11956,-4396
306.253379,5,1792,1806,-14,14,126200,125800,5885,-168885,-172413
306.253379,6,0,0,0,0,126200,125800,0,0,0
306.496746,0,515,489,26,-26,126400,125800,25535,202865,209417
306.496746,1,513,611,-98,98,126400,125800,28559,75641,50945
306.496746,2,2727,2764,-37,37,126400,125800,9627,-271727,-281051
306.496746,3,387,390,-3,3,126400,125800,11107,91493,90737
306.496746,4,80,50,30,-30,126400,125800,-1644,-11956,-4396
306.496746,5,1792,1806,-14,14,126400,125800,5885,-168885,-172413
306.496746,6,0,0,0,0,126400,125800,0,0,0
306.715434,0,515,489,26,-26,126400,126000,25535,202865,209417
306.715434,1,513,611,-98,98,126400,126000,28559,75641,50945
306.715434,2,2727,2764,-37,37,126400,126000,9627,-271727,-281051
306.715434,3,387,390,-3,3,126400,126000,11107,91493,90737
306.715434,4,80,50,30,-30,126400,126000,-1644,-11956,-4396
306.715434,5,1792,1806,-14,14,126400,126000,5885,-168885,-172413
306.715434,6,0,0,0,0,126400,126000,0,0,0
307.037951,0,515,499,16,-16,126200,126000,25787,205213,208413
307.037951,1,513,611,-98,98,126200,126000,28559,75641,56041
307.037951,2,2737,2764,-27,27,126200,126000,9577,-275677,-281077
307.037951,3,387,392,-5,5,126200,126000,11082,92118,91118
307.037951,4,80,50,30,-30,126200,126000,-1644,-11956,-5956
307.037951,5,1794,1806,-12,12,126200,126000,5860,-169260,-171660
307.037951,6,0,0,0,0,126200,126000,0,0,0
307.296131,0,515,507,8,-8,126200,126000,25989,206611,208211
307.296131,1,513,611,-98,98,126200,126000,28559,75641,56041
307.296131,2,2737,2764,-27,27,126200,126000,9577,-275677,-281077
307.296131,3,387,392,-5,5,126200,126000,11082,92118,91118
307.296131,4,80,50,30,-30,126200,126000,-1644,-11956,-5956
307.296131,5,1802,1806,-4,4,126200,126000,5759,-172359,-173159
307.296131,6,0,0,0,0,126200,126000,0,0,0
307.476253,0,515,537,-22,22,126100,126000,26746,211854,209654
307.476253,1,513,611,-98,98,126100,126000,28559,75641,65841
307.476253,2,2737,2764,-27,27,126100,126000,9577,-275677,-278377
307.476253,3,387,394,-7,7,126100,126000,11132,92468,91768
307.476253,4,80,50,30,-30,126100,126000,-1644,-11956,-8956
307.476253,5,1802,1806,-4,4,126100,126000,5759,-172359,-172759
307.476253,6,0,0,0,0,126100,126000,0,0,0
307.704847,0,515,567,-52,52,126100,126000,27503,217097,211897
307.704847,1,513,611,-98,98,126100,126000,28559,75641,65841
307.704847,2,2737,2764,-27,27,126100,126000,9577,-275677,-278377
307.704847,3,387,394,-7,7,126100,126000,11132,92468,91768
307.704847,4,80,50,30,-30,126100,126000,-1644,-11956,-8956
307.704847,5,1802,1806,-4,4,126100,126000,5759,-172359,-172759
307.704847,6,0,0,0,0,126100,126000,0,0,0
308.0099,0,515,571,-56,56,126000,126000,27604,217796,217796
308.0099,1,513,611,-98,98,126000,126000,28559,75641,75641
308.0099,2,2737,2764,-27,27,126000,126000,9577,-275677,-275677
308.0099,3,387,394,-7,7,126000,126000,11132,92468,92468
308.0099,4,80,50,30,-30,126000,126000,-1644,-11956,-11956
308.0099,5,1802,1806,-4,4,126000,126000,5759,-172359,-172359
308.0099,6,0,0,0,0,126000,126000,0,0,0
308.214207,0,515,571,-56,56,126000,125600,27604,217796,203740
308.214207,1,513,611,-98,98,126000,125600,28559,75641,51043
308.214207,2,2737,2774,-37,37,126000,125600,9829,-272929,-282216
308.214207,3,387,396,-9,9,126000,125600,11182,93018,90759
308.214207,4,80,50,30,-30,126000,125600,-1644,-11956,-4426
308.214207,5,1802,1806,-4,4,126000,125600,5759,-172359,-173363
308.214207,6,0,0,0,0,126000,125600,0,0,0
308.464535,0,515,571,-56,56,126000,125500,27604,217796,203740
308.464535,1,513,611,-98,98,126000,125500,28559,75641,51043
308.464535,2,2737,2784,-47,47,126000,125500,10081,-269181,-280978
308.464535,3,387,398,-11,11,126000,125500,11232,93768,91007
308.464535,4,80,50,30,-30,126000,125500,-1644,-11956,-4426
308.464535,5,1802,1806,-4,4,126000,125500,5759,-172359,-173363
308.464535,6,0,0,0,0,126000,125500,0,0,0
308.796533,0,515,571,-56,56,125900,125500,27604,217796,203740
308.796533,1,513,611,-98,98,125900,125500,28559,75641,51043
308.796533,2,2747,2784,-37,37,125900,125500,10333,-274433,-283720
308.796533,3,387,400,-13,13,125900,125500,11282,94318,91055
308.796533,4,80,50,30,-30,125900,125500,-1644,-11956,-4426
308.796533,5,1802,1806,-4,4,125900,125500,5759,-172359,-173363
308.796533,6,0,0,0,0,125900,125500,0,0,0
308.984782,0,515,571,-56,56,125900,125500,27604,217796,203740
308.984782,1,513,611,-98,98,125900,125500,28559,75641,51043
308.984782,2,2749,2784,-35,35,125900,125500,10308,-275208,-283993
308.984782,3,387,402,-15,15,125900,125500,11332,94868,91103
308.984782,4,80,50,30,-30,125900,125500,-1644,-11956,-4426
308.984782,5,1802,1806,-4,4,125900,125500,5759,-172359,-173363
308.984782,6,0,0,0,0,125900,125500,0,0,0
309.213652,0,515,601,-86,86,125800,125500,28359,226841,205255
309.213652,1,513,611,-98,98,125800,125500,28559,75641,51043
309.213652,2,2757,2784,-27,27,125800,125500,10207,-279907,-286684
309.213652,3,387,404,-17,17,125800,125500,11382,95418,91151
309.213652,4,80,50,30,-30,125800,125500,-1644,-11956,-4426
309.213652,5,1802,1806,-4,4,125800,125500,5759,-172359,-173363
309.213652,6,0,0,0,0,125800,125500,0,0,0
309.493859,0,515,615,-100,100,125800,125500,28711,230689,205589
309.493859,1,513,611,-98,98,125800,125500,28559,75641,51043
309.493859,2,2757,2794,-37,37,125800,125500,10459,-277159,-286446
309.493859,3,387,406,-19,19,125800,125500,11432,95968,91199
309.493859,4,80,50,30,-30,125800,125500,-1644,-11956,-4426
309.493859,5,1802,1806,-4,4,125800,125500,5759,-172359,-173363
309.493859,6,0,0,0,0,125800,125500,0,0,0
309.724892,0,515,615,-100,100,125800,125500,28711,230689,205589
309.724892,1,513,611,-98,98,125800,125500,28559,75641,51043
309.724892,2,2757,2794,-37,37,125800,125500,10459,-277159,-286446
309.724892,3,387,408,-21,21,125800,125500,11482,96518,91247
309.724892,4,80,50,30,-30,125800,125500,-1644,-11956,-4426
309.724892,5,1802,1806,-4,4,125800,125500,5759,-172359,-173363
309.724892,6,0,0,0,0,125800,125500,0,0,0
310.010714,0,515,615,-100,100,125800,125400,28711,230689,205589
310.010714,1,513,611,-98,98,125800,125400,28559,75641,51043
310.010714,2,2757,2794,-37,37,125800,125400,10459,-277159,-286446
310.010714,3,387,410,-23,23,125800,125400,11532,96868,91095
310.010714,4,80,50,30,-30,125800,125400,-1644,-11956,-4426
310.010714,5,1802,1806,-4,4,125800,125400,5759,-172359,-173363
310.010714,6,0,0,0,0,125800,125400,0,0,0
310.25845,0,515,615,-100,100,125800,125400,28711,230689,205589
310.25845,1,513,611,-98,98,125800,125400,28559,75641,51043
310.25845,2,2757,2804,-47,47,125800,125400,10711,-273411,-285208
310.25845,3,387,412,-25,25,125800,125400,11582,97618,91343
310.25845,4,80,50,30,-30,125800,125400,-1644,-11956,-4426
310.25845,5,1802,1806,-4,4,125800,125400,5759,-172359,-173363
310.25845,6,0,0,0,0,125800,125400,0,0,0
310.46905,0,515,615,-100,100,125700,125400,28711,230689,205589
310.46905,1,513,611,-98,98,125700,125400,28559,75641,51043
310.46905,2,2757,2804,-47,47,125700,125400,10711,-273411,-285208
310.46905,3,387,414,-27,27,125700,125400,11632,98368,91591
310.46905,4,80,50,30,-30,125700,125400,-1644,-11956,-4426
310.46905,5,1802,1806,-4,4,125700,125400,5759,-172359,-173363
310.46905,6,0,0,0,0,125700,125400,0,0,0
310.786707,0,515,615,-100,100,125700,125300,28711,230689,205589
310.786707,1,513,611,-98,98,125700,125300,28559,75641,51043
310.786707,2,2757,2814,-57,57,125700,125300,10585,-268285,-282592
310.786707,3,387,418,-31,31,125700,125300,11732,99868,92087
310.786707,4,80,50,30,-30,125700,125300,-1644,-11956,-4426
310.786707,5,1802,1806,-4,4,125700,125300,5759,-172359,-173363
310.786707,6,0,0,0,0,125700,125300,0,0,0
311.003035,0,515,615,-100,100,125800,125300,28711,230689,205589
311.003035,1,513,611,-98,98,125800,125300,28559,75641,51043
311.003035,2,2759,2814,-55,55,125800,125300,10560,-269460,-283265
311.003035,3,387,420,-33,33,125800,125300,11782,100618,92335
311.003035,4,80,50,30,-30,125800,125300,-1644,-11956,-4426
311.003035,5,1802,1816,-14,14,125800,125300,6010,-169610,-173124
311.003035,6,0,0,0,0,125800,125300,0,0,0
311.25276,0,515,615,-100,100,125900,125300,28711,230689,205589
311.25276,1,513,611,-98,98,125900,125300,28559,75641,51043
311.25276,2,2763,2814,-51,51,125900,125300,10510,-271810,-284611
311.25276,3,387,424,-37,37,125900,125300,11882,102518,93231
311.25276,4,80,50,30,-30,125900,125300,-1644,-11956,-4426
311.25276,5,1802,1816,-14,14,125900,125300,6010,-169610,-173124
311.25276,6,0,0,0,0,125900,125300,0,0,0
311.463325,0,515,615,-100,100,125900,125300,28711,230689,205589
311.463325,1,513,611,-98,98,125900,125300,28559,75641,51043
311.463325,2,2769,2814,-45,45,125900,125300,10434,-274734,-286029
311.463325,3,387,424,-37,37,125900,125300,11882,102518,93231
311.463325,4,80,50,30,-30,125900,125300,-1644,-11956,-4426
311.463325,5,1802,1822,-20,20,125900,125300,6161,-167361,-172381
311.463325,6,0,0,0,0,125900,125300,0,0,0
311.776547,0,515,615,-100,100,125800,125300,28711,230689,205589
311.776547,1,513,611,-98,98,125800,125300,28559,75641,51043
311.776547,2,2773,2814,-41,41,125800,125300,10459,-276759,-287050
311.776547,3,387,428,-41,41,125800,125300,11907,104093,93802
311.776547,4,80,50,30,-30,125800,125300,-1644,-11956,-4426
311.776547,5,1802,1822,-20,20,125800,125300,6161,-167361,-172381
311.776547,6,0,0,0,0,125800,125300,0,0,0
311.964555,0,515,615,-100,100,126000,125300,28711,230689,205589
311.964555,1,513,611,-98,98,126000,125300,28559,75641,51043
311.964555,2,2779,2814,-35,35,126000,125300,10384,-279684,-288469
311.964555,3,387,430,-43,43,126000,125300,11882,104718,93925
311.964555,4,80,50,30,-30,126000,125300,-1644,-11956,-4426
311.964555,5,1802,1832,-30,30,126000,125300,6262,-164462,-171992
311.964555,6,0,0,0,0,126000,125300,0,0,0
312.293,0,515,615,-100,100,125800,125400,28711,230689,205589
312.293,1,513,611,-98,98,125800,125400,28559,75641,51043
312.293,2,2781,2814,-33,33,125800,125400,10359,-280459,-288742
312.293,3,387,432,-45,45,125800,125400,11932,105268,93973
312.293,4,80,50,30,-30,125800,125400,-1644,-11956,-4426
312.293,5,1802,1832,-30,30,125800,125400,6262,-164462,-171992
312.293,6,0,0,0,0,125800,125400,0,0,0
312.529349,0,515,615,-100,100,125800,125400,28711,230689,205589
312.529349,1,513,611,-98,98,125800,125400,28559,75641,51043
312.529349,2,2781,2814,-33,33,125800,125400,10359,-280459,-288742
312.529349,3,387,432,-45,45,125800,125400,11932,105268,93973
312.529349,4,80,50,30,-30,125800,125400,-1644,-11956,-4426
312.529349,5,1802,1832,-30,30,125800,125400,6262,-164462,-171992
312.529349,6,0,0,0,0,125800,125400,0,0,0
312.757578,0,515,615,-100,100,125700,125400,28711,230689,205589
312.757578,1,513,611,-98,98,125700,125400,28559,75641,51043
312.757578,2,2791,2814,-23,23,125700,125400,10233,-284333,-290106
312.757578,3,387,434,-47,47,125700,125400,11907,105893,94096
312.757578,4,80,50,30,-30,125700,125400,-1644,-11956,-4426
312.757578,5,1812,1832,-20,20,125700,125400,6211,-168411,-173431
312.757578,6,0,0,0,0,125700,125400,0,0,0
313.044355,0,515,615,-100,100,125700,125400,28711,230689,205589
313.044355,1,513,611,-98,98,125700,125400,28559,75641,51043
313.044355,2,2791,2814,-23,23,125700,125400,10233,-284333,-290106
313.044355,3,387,434,-47,47,125700,125400,11907,105893,94096
313.044355,4,80,50,30,-30,125700,125400,-1644,-11956,-4426
313.044355,5,1812,1832,-20,20,125700,125400,6211,-168411,-173431
313.044355,6,0,0,0,0,125700,125400,0,0,0
313.26277,0,515,615,-100,100,125700,125400,28711,230689,205589
313.26277,1,513,611,-98,98,125700,125400,28559,75641,51043
313.26277,2,2791,2824,-33,33,125700,125400,10485,-281585,-289868
313.26277,3,387,436,-49,49,125700,125400,11957,106243,93944
313.26277,4,80,50,30,-30,125700,125400,-1644,-11956,-4426
313.26277,5,1822,1832,-10,10,125700,125400,6085,-172285,-174795
313.26277,6,0,0,0,0,125700,125400,0,0,0
313.468022,0,515,615,-100,100,125800,125400,28711,230689,205589
313.468022,1,513,611,-98,98,125800,125400,28559,75641,51043
313.468022,2,2793,2824,-31,31,125800,125400,10535,-282435,-290216
313.468022,3,387,438,-51,51,125800,125400,11932,106868,94067
313.468022,4,80,50,30,-30,125800,125400,-1644,-11956,-4426
313.468022,5,1822,1832,-10,10,125800,125400,6085,-172285,-174795
313.468022,6,0,0,0,0,125800,125400,0,0,0
313.733767,0,515,615,-100,100,125800,125400,28711,230689,205589
313.733767,1,513,611,-98,98,125800,125400,28559,75641,51043
313.733767,2,2793,2824,-31,31,125800,125400,10535,-282435,-290216
313.733767,3,387,438,-51,51,125800,125400,11932,106868,94067
313.733767,4,80,50,30,-30,125800,125400,-1644,-11956,-4426
313.733767,5,1822,1832,-10,10,125800,125400,6085,-172285,-174795
313.733767,6,0,0,0,0,125800,125400,0,0,0
314.006617,0,515,615,-100,100,125800,125400,28711,230689,205589
314.006617,1,513,611,-98,98,125800,125400,28559,75641,51043
314.006617,2,2801,2824,-23,23,125800,125400,10434,-285534,-291307
314.006617,3,387,438,-51,51,125800,125400,11932,106868,94067
314.006617,4,80,50,30,-30,125800,125400,-1644,-11956,-4426
314.006617,5,1822,1840,-18,18,125800,125400,6286,-170886,-175404
314.006617,6,0,0,0,0,125800,125400,0,0,0
314.257556,0,515,615,-100,100,125800,125400,28711,230689,205589
314.257556,1,513,611,-98,98,125800,125400,28559,75641,51043
314.257556,2,2801,2824,-23,23,125800,125400,10434,-285534,-291307
314.257556,3,387,438,-51,51,125800,125400,11932,106868,94067
314.257556,4,80,50,30,-30,125800,125400,-1644,-11956,-4426
314.257556,5,1822,1840,-18,18,125800,125400,6286,-170886,-175404
314.257556,6,0,0,0,0,125800,125400,0,0,0
314.498703,0,515,615,-100,100,125800,125400,28711,230689,205589
314.498703,1,513,611,-98,98,125800,125400,28559,75641,51043
314.498703,2,2801,2824,-23,23,125800,125400,10434,-285534,-291307
314.498703,3,387,438,-51,51,125800,125400,11932,106868,94067
314.498703,4,80,50,30,-30,125800,125400,-1644,-11956,-4426
314.498703,5,1822,1840,-18,18,125800,125400,6286,-170886,-175404
314.498703,6,0,0,0,0,125800,125400,0,0,0
314.733803,0,515,615,-100,100,125800,125400,28711,230689,205589
314.733803,1,513,611,-98,98,125800,125400,28559,75641,51043
314.733803,2,2801,2824,-23,23,125800,125400,10434,-285534,-291307
314.733803,3,387,438,-51,51,125800,125400,11932,106868,94067
314.733803,4,80,50,30,-30,125800,125400,-1644,-11956,-4426
314.733803,5,1822,1840,-18,18,125800,125400,6286,-170886,-175404
314.733803,6,0,0,0,0,125800,125400,0,0,0
315.030442,0,515,615,-100,100,125800,125400,28711,230689,205589
315.030442,1,513,611,-98,98,125800,125400,28559,75641,51043
315.030442,2,2801,2828,-27,27,125800,125400,10384,-283884,-290661
315.030442,3,387,440,-53,53,125800,125400,11907,107693,94390
315.030442,4,80,50,30,-30,125800,125400,-1644,-11956,-4426
315.030442,5,1822,1840,-18,18,125800,125400,6286,-170886,-175404
315.030442,6,0,0,0,0,125800,125400,0,0,0
315.284291,0,515,615,-100,100,125700,125400,28711,230689,205589
315.284291,1,513,611,-98,98,125700,125400,28559,75641,51043
315.284291,2,2801,2838,-37,37,125700,125400,10635,-281135,-290422
315.284291,3,387,442,-55,55,125700,125400,11957,108243,94438
315.284291,4,80,50,30,-30,125700,125400,-1644,-11956,-4426
315.284291,5,1822,1840,-18,18,125700,125400,6286,-170886,-175404
315.284291,6,0,0,0,0,125700,125400,0,0,0
315.471259,0,515,615,-100,100,125700,125400,28711,230689,205589
315.471259,1,513,611,-98,98,125700,125400,28559,75641,51043
315.471259,2,2801,2848,-47,47,125700,125400,10886,-277386,-289183
315.471259,3,387,444,-57,57,125700,125400,12007,108993,94686
315.471259,4,80,50,30,-30,125700,125400,-1644,-11956,-4426
315.471259,5,1822,1840,-18,18,125700,125400,6286,-170886,-175404
315.471259,6,0,0,0,0,125700,125400,0,0,0
315.778127,0,515,615,-100,100,125400,124900,28711,230689,205689
315.778127,1,513,611,-98,98,125400,124900,28559,75641,51141
315.778127,2,2811,2858,-47,47,125400,124900,11011,-277511,-289261
315.778127,3,387,448,-61,61,125400,124900,12107,112093,96843
315.778127,4,80,50,30,-30,125400,124900,-1644,-11956,-4456
315.778127,5,1822,1840,-18,18,125400,124900,6286,-170886,-175386
315.778127,6,0,0,0,0,125400,124900,0,0,0
315.979572,0,515,615,-100,100,125300,124900,28711,230689,205689
315.979572,1,513,611,-98,98,125300,124900,28559,75641,51141
315.979572,2,2811,2858,-47,47,125300,124900,11011,-277511,-289261
315.979572,3,387,450,-63,63,125300,124900,12157,112843,97093
315.979572,4,80,50,30,-30,125300,124900,-1644,-11956,-4456
315.979572,5,1822,1840,-18,18,125300,124900,6286,-170886,-175386
315.979572,6,0,0,0,0,125300,124900,0,0,0
316.299507,0,515,615,-100,100,125300,124900,28711,230689,205689
316.299507,1,513,611,-98,98,125300,124900,28559,75641,51141
316.299507,2,2821,2858,-37,37,125300,124900,11262,-282762,-292012
316.299507,3,387,454,-67,67,125300,124900,12257,113543,96793
316.299507,4,80,50,30,-30,125300,124900,-1644,-11956,-4456
316.299507,5,1822,1840,-18,18,125300,124900,6286,-170886,-175386
316.299507,6,0,0,0,0,125300,124900,0,0,0
316.4639,0,515,615,-100,100,125300,124900,28711,230689,205689
316.4639,1,513,611,-98,98,125300,124900,28559,75641,51141
316.4639,2,2821,2858,-37,37,125300,124900,11262,-282762,-292012
316.4639,3,387,456,-69,69,125300,124900,12307,114093,96843
316.4639,4,80,50,30,-30,125300,124900,-1644,-11956,-4456
316.4639,5,1822,1850,-28,28,125300,124900,6537,-168137,-175137
316.4639,6,0,0,0,0,125300,124900,0,0,0
316.72945,0,515,615,-100,100,125300,124900,28711,230689,205689
316.72945,1,513,611,-98,98,125300,124900,28559,75641,51141
316.72945,2,2821,2858,-37,37,125300,124900,11262,-282762,-292012
316.72945,3,387,458,-71,71,125300,124900,12357,114843,97093
316.72945,4,80,50,30,-30,125300,124900,-1644,-11956,-4456
316.72945,5,1822,1850,-28,28,125300,124900,6537,-168137,-175137
316.72945,6,0,0,0,0,125300,124900,0,0,0
317.021829,0,515,615,-100,100,125400,124900,28711,230689,205689
317.021829,1,513,611,-98,98,125400,124900,28559,75641,51141
317.021829,2,2831,2858,-27,27,125400,124900,11513,-287013,-293763
317.021829,3,387,458,-71,71,125400,124900,12357,114843,97093
317.021829,4,80,50,30,-30,125400,124900,-1644,-11956,-4456
317.021829,5,1822,1860,-38,38,125400,124900,6412,-165012,-174512
317.021829,6,0,0,0,0,125400,124900,0,0,0
317.269403,0,515,615,-100,100,125400,124900,28711,230689,205689
317.269403,1,513,611,-98,98,125400,124900,28559,75641,51141
317.269403,2,2831,2858,-27,27,125400,124900,11513,-287013,-293763
317.269403,3,387,458,-71,71,125400,124900,12357,114843,97093
317.269403,4,80,50,30,-30,125400,124900,-1644,-11956,-4456
317.269403,5,1822,1860,-38,38,125400,124900,6412,-165012,-174512
317.269403,6,0,0,0,0,125400,124900,0,0,0
317.463917,0,515,615,-100,100,125400,124900,28711,230689,205689
317.463917,1,513,611,-98,98,125400,124900,28559,75641,51141
317.463917,2,2833,2858,-25,25,125400,124900,11563,-287663,-293913
317.463917,3,387,460,-73,73,125400,124900,12332,115268,97018
317.463917,4,80,50,30,-30,125400,124900,-1644,-11956,-4456
317.463917,5,1822,1860,-38,38,125400,124900,6412,-165012,-174512
317.463917,6,0,0,0,0,125400,124900,0,0,0
317.773351,0,515,615,-100,100,125400,125200,28711,230689,210689
317.773351,1,513,611,-98,98,125400,125200,28559,75641,56041
317.773351,2,2833,2858,-25,25,125400,125200,11563,-287663,-292663
317.773351,3,387,460,-73,73,125400,125200,12332,115268,100668
317.773351,4,80,50,30,-30,125400,125200,-1644,-11956,-5956
317.773351,5,1822,1860,-38,38,125400,125200,6412,-165012,-172612
317.773351,6,0,0,0,0,125400,125200,0,0,0
317.997136,0,515,615,-100,100,125400,125200,28711,230689,210689
317.997136,1,513,611,-98,98,125400,125200,28559,75641,56041
317.997136,2,2833,2858,-25,25,125400,125200,11563,-287663,-292663
317.997136,3,387,460,-73,73,125400,125200,12332,115268,100668
317.997136,4,80,50,30,-30,125400,125200,-1644,-11956,-5956
317.997136,5,1822,1860,-38,38,125400,125200,6412,-165012,-172612
317.997136,6,0,0,0,0,125400,125200,0,0,0
318.236993,0,515,615,-100,100,125400,124800,28711,230689,205689
318.236993,1,513,611,-98,98,125400,124800,28559,75641,51141
318.236993,2,2833,2858,-25,25,125400,124800,11563,-287663,-293913
318.236993,3,387,462,-75,75,125400,124800,12382,115618,96868
318.236993,4,80,50,30,-30,125400,124800,-1644,-11956,-4456
318.236993,5,1824,1860,-36,36,125400,124800,6387,-165787,-174787
318.236993,6,0,0,0,0,125400,124800,0,0,0
318.484666,0,515,615,-100,100,125300,124800,28711,230689,205689
318.484666,1,513,611,-98,98,125300,124800,28559,75641,51141
318.484666,2,2833,2868,-35,35,125300,124800,11814,-283914,-292664
318.484666,3,387,464,-77,77,125300,124800,12432,116368,97118
318.484666,4,80,50,30,-30,125300,124800,-1644,-11956,-4456
318.484666,5,1832,1860,-28,28,125300,124800,6287,-171287,-178287
318.484666,6,0,0,0,0,125300,124800,0,0,0
318.703481,0,515,615,-100,100,125300,124800,28711,230689,205689
318.703481,1,513,611,-98,98,125300,124800,28559,75641,51141
318.703481,2,2833,2878,-45,45,125300,124800,12065,-280165,-291415
318.703481,3,387,466,-79,79,125300,124800,12482,117118,97368
318.703481,4,80,50,30,-30,125300,124800,-1644,-11956,-4456
318.703481,5,1832,1860,-28,28,125300,124800,6287,-171287,-178287
318.703481,6,0,0,0,0,125300,124800,0,0,0
318.951592,0,515,615,-100,100,125300,124800,28711,230689,205689
318.951592,1,513,611,-98,98,125300,124800,28559,75641,51141
318.951592,2,2833,2888,-55,55,125300,124800,12316,-275416,-289166
318.951592,3,387,468,-81,81,125300,124800,12532,118068,97818
318.951592,4,90,50,40,-40,125300,124800,-1769,-19831,-9831
318.951592,5,1832,1860,-28,28,125300,124800,6287,-171287,-178287
318.951592,6,0,0,0,0,125300,124800,0,0,0
319.297094,0,515,615,-100,100,125200,124800,28711,230689,205689
319.297094,1,513,611,-98,98,125200,124800,28559,75641,51141
319.297094,2,2833,2888,-55,55,125200,124800,12316,-275416,-289166
319.297094,3,387,470,-83,83,125200,124800,12582,119018,98268
319.297094,4,90,50,40,-40,125200,124800,-1769,-19831,-9831
319.297094,5,1832,1860,-28,28,125200,124800,6287,-171287,-178287
319.297094,6,0,0,0,0,125200,124800,0,0,0
319.486962,0,515,615,-100,100,125200,124800,28711,230689,205689
319.486962,1,513,611,-98,98,125200,124800,28559,75641,51141
319.486962,2,2843,2888,-45,45,125200,124800,12566,-281666,-292916
319.486962,3,387,472,-85,85,125200,124800,12632,119568,98318
319.486962,4,90,50,40,-40,125200,124800,-1769,-19831,-9831
319.486962,5,1832,1860,-28,28,125200,124800,6287,-171287,-178287
319.486962,6,0,0,0,0,125200,124800,0,0,0
319.746795,0,515,615,-100,100,125200,124700,28711,230689,205789
319.746795,1,513,611,-98,98,125200,124700,28559,75641,51239
319.746795,2,2845,2888,-43,43,125200,124700,12541,-282641,-293348
319.746795,3,387,474,-87,87,125200,124700,12682,120118,98455
319.746795,4,90,50,40,-40,125200,124700,-1769,-19831,-9871
319.746795,5,1832,1860,-28,28,125200,124700,6287,-171287,-178259
319.746795,6,0,0,0,0,125200,124700,0,0,0
320.048388,0,515,615,-100,100,125200,124700,28711,230689,205789
320.048388,1,513,611,-98,98,125200,124700,28559,75641,51239
320.048388,2,2847,2888,-41,41,125200,124700,12516,-283616,-293825
320.048388,3,387,476,-89,89,125200,124700,12732,120668,98507
320.048388,4,90,50,40,-40,125200,124700,-1769,-19831,-9871
320.048388,5,1832,1860,-28,28,125200,124700,6287,-171287,-178259
320.048388,6,0,0,0,0,125200,124700,0,0,0
320.247117,0,515,615,-100,100,125100,124600,28711,230689,205789
320.247117,1,513,611,-98,98,125100,124600,28559,75641,51239
320.247117,2,2853,2888,-35,35,125100,124600,12441,-287141,-295856
320.247117,3,387,476,-89,89,125100,124600,12732,120668,98507
320.247117,4,90,50,40,-40,125100,124600,-1769,-19831,-9871
320.247117,5,1832,1860,-28,28,125100,124600,6287,-171287,-178259
320.247117,6,0,0,0,0,125100,124600,0,0,0
320.542341,0,515,615,-100,100,125100,124600,28711,230689,205789
320.542341,1,513,611,-98,98,125100,124600,28559,75641,51239
320.542341,2,2853,2898,-45,45,125100,124600,12691,-283391,-294596
320.542341,3,387,476,-89,89,125100,124600,12732,120668,98507
320.542341,4,90,50,40,-40,125100,124600,-1769,-19831,-9871
320.542341,5,1832,1860,-28,28,125100,124600,6287,-171287,-178259
320.542341,6,0,0,0,0,125100,124600,0,0,0
320.76059,0,515,615,-100,100,125100,124700,28711,230689,205789
320.76059,1,513,611,-98,98,125100,124700,28559,75641,51239
320.76059,2,2863,2898,-35,35,125100,124700,12941,-288641,-297356
320.76059,3,387,478,-91,91,125100,124700,12782,121218,98559
320.76059,4,90,50,40,-40,125100,124700,-1769,-19831,-9871
320.76059,5,1832,1860,-28,28,125100,124700,6287,-171287,-178259
320.76059,6,0,0,0,0,125100,124700,0,0,0
321.035378,0,515,615,-100,100,125100,124700,28711,230689,205789
321.035378,1,513,611,-98,98,125100,124700,28559,75641,51239
321.035378,2,2863,2898,-35,35,125100,124700,12941,-288641,-297356
321.035378,3,387,478,-91,91,125100,124700,12782,121218,98559
321.035378,4,90,50,40,-40,125100,124700,-1769,-19831,-9871
321.035378,5,1832,1860,-28,28,125100,124700,6287,-171287,-178259
321.035378,6,0,0,0,0,125100,124700,0,0,0
321.298968,0,515,615,-100,100,125100,124800,28711,230689,205689
321.298968,1,513,611,-98,98,125100,124800,28559,75641,51141
321.298968,2,2863,2898,-35,35,125100,124800,12941,-288641,-297391
321.298968,3,387,480,-93,93,125100,124800,12832,121768,98518
321.298968,4,90,50,40,-40,125100,124800,-1769,-19831,-9831
321.298968,5,1832,1860,-28,28,125100,124800,6287,-171287,-178287
321.298968,6,0,0,0,0,125100,124800,0,0,0
321.481098,0,515,615,-100,100,125100,124800,28711,230689,205689
321.481098,1,513,611,-98,98,125100,124800,28559,75641,51141
321.481098,2,2863,2898,-35,35,125100,124800,12941,-288641,-297391
321.481098,3,387,480,-93,93,125100,124800,12832,121768,98518
321.481098,4,90,50,40,-40,125100,124800,-1769,-19831,-9831
321.481098,5,1832,1860,-28,28,125100,124800,6287,-171287,-178287
321.481098,6,0,0,0,0,125100,124800,0,0,0
321.709741,0,515,615,-100,100,125000,124800,28711,230689,210689
321.709741,1,513,611,-98,98,125000,124800,28559,75641,56041
321.709741,2,2873,2898,-25,25,125000,124800,12816,-292516,-297516
321.709741,3,387,480,-93,93,125000,124800,12832,121768,103168
321.709741,4,90,50,40,-40,125000,124800,-1769,-19831,-11831
321.709741,5,1832,1860,-28,28,125000,124800,6287,-171287,-176887
321.709741,6,0,0,0,0,125000,124800,0,0,0
322.029482,0,515,615,-100,100,125000,124900,28711,230689,220689
322.029482,1,513,611,-98,98,125000,124900,28559,75641,65841
322.029482,2,2873,2898,-25,25,125000,124900,12816,-292516,-295016
322.029482,3,387,480,-93,93,125000,124900,12832,121768,112468
322.029482,4,90,50,40,-40,125000,124900,-1769,-19831,-15831
322.029482,5,1832,1860,-28,28,125000,124900,6287,-171287,-174087
322.029482,6,0,0,0,0,125000,124900,0,0,0
322.298578,0,515,615,-100,100,125000,124900,28711,230689,220689
322.298578,1,513,611,-98,98,125000,124900,28559,75641,65841
322.298578,2,2873,2898,-25,25,125000,124900,12816,-292516,-295016
322.298578,3,387,480,-93,93,125000,124900,12832,121768,112468
322.298578,4,90,50,40,-40,125000,124900,-1769,-19831,-15831
322.298578,5,1832,1860,-28,28,125000,124900,6287,-171287,-174087
322.298578,6,0,0,0,0,125000,124900,0,0,0
322.459812,0,515,615,-100,100,125000,124900,28711,230689,220689
322.459812,1,513,611,-98,98,125000,124900,28559,75641,65841
322.459812,2,2873,2898,-25,25,125000,124900,12816,-292516,-295016
322.459812,3,387,480,-93,93,125000,124900,12832,121768,112468
322.459812,4,90,50,40,-40,125000,124900,-1769,-19831,-15831
322.459812,5,1832,1860,-28,28,125000,124900,6287,-171287,-174087
322.459812,6,0,0,0,0,125000,124900,0,0,0
322.726032,0,515,615,-100,100,125000,124900,28711,230689,220689
322.726032,1,513,611,-98,98,125000,124900,28559,75641,65841
322.726032,2,2873,2898,-25,25,125000,124900,12816,-292516,-295016
322.726032,3,387,480,-93,93,125000,124900,12832,121768,112468
322.726032,4,90,50,40,-40,125000,124900,-1769,-19831,-15831
322.726032,5,1832,1860,-28,28,125000,124900,6287,-171287,-174087
322.726032,6,0,0,0,0,125000,124900,0,0,0
322.954274,0,515,615,-100,100,125200,124900,28711,230689,205689
322.954274,1,513,611,-98,98,125200,124900,28559,75641,51141
322.954274,2,2883,2898,-15,15,125200,124900,12691,-295391,-299141
322.954274,3,387,480,-93,93,125200,124900,12832,121768,98518
322.954274,4,90,50,40,-40,125200,124900,-1769,-19831,-9831
322.954274,5,1832,1870,-38,38,125200,124900,6537,-169537,-179037
322.954274,6,0,0,0,0,125200,124900,0,0,0
323.231886,0,515,615,-100,100,125300,124900,28711,230689,205689
323.231886,1,513,611,-98,98,125300,124900,28559,75641,51141
323.231886,2,2883,2908,-25,25,125300,124900,12566,-293266,-299516
323.231886,3,387,480,-93,93,125300,124900,12832,121768,98518
323.231886,4,90,50,40,-40,125300,124900,-1769,-19831,-9831
323.231886,5,1842,1870,-28,28,125300,124900,6788,-173788,-180788
323.231886,6,0,0,0,0,125300,124900,0,0,0
323.484036,0,515,615,-100,100,125300,124900,28711,230689,205689
323.484036,1,513,611,-98,98,125300,124900,28559,75641,51141
323.484036,2,2883,2918,-35,35,125300,124900,12817,-290517,-299267
323.484036,3,387,480,-93,93,125300,124900,12832,121768,98518
323.484036,4,90,50,40,-40,125300,124900,-1769,-19831,-9831
323.484036,5,1852,1870,-18,18,125300,124900,6663,-177663,-182163
323.484036,6,0,0,0,0,125300,124900,0,0,0
323.799338,0,515,615,-100,100,125300,124800,28711,230689,205689
323.799338,1,513,611,-98,98,125300,124800,28559,75641,51141
323.799338,2,2883,2918,-35,35,125300,124800,12817,-290517,-299267
323.799338,3,387,480,-93,93,125300,124800,12832,121768,98518
323.799338,4,90,50,40,-40,125300,124800,-1769,-19831,-9831
323.799338,5,1852,1870,-18,18,125300,124800,6663,-177663,-182163
323.799338,6,0,0,0,0,125300,124800,0,0,0
324.043816,0,515,615,-100,100,125100,124800,28711,230689,205689
324.043816,1,513,611,-98,98,125100,124800,28559,75641,51141
324.043816,2,2884,2918,-34,34,125100,124800,12804,-290904,-299404
324.043816,3,387,480,-93,93,125100,124800,12832,121768,98518
324.043816,4,90,50,40,-40,125100,124800,-1769,-19831,-9831
324.043816,5,1852,1870,-18,18,125100,124800,6663,-177663,-182163
324.043816,6,0,0,0,0,125100,124800,0,0,0
324.239001,0,515,615,-100,100,125100,124800,28711,230689,205689
324.239001,1,513,611,-98,98,125100,124800,28559,75641,51141
324.239001,2,2893,2918,-25,25,125100,124800,12691,-294391,-300641
324.239001,3,387,480,-93,93,125100,124800,12832,121768,98518
324.239001,4,90,50,40,-40,125100,124800,-1769,-19831,-9831
324.239001,5,1852,1879,-27,27,125100,124800,6888,-175188,-181938
324.239001,6,0,0,0,0,125100,124800,0,0,0
324.478789,0,515,615,-100,100,125100,124800,28711,230689,205689
324.478789,1,513,611,-98,98,125100,124800,28559,75641,51141
324.478789,2,2893,2918,-25,25,125100,124800,12691,-294391,-300641
324.478789,3,387,480,-93,93,125100,124800,12832,121768,98518
324.478789,4,90,50,40,-40,125100,124800,-1769,-19831,-9831
324.478789,5,1852,1879,-27,27,125100,124800,6888,-175188,-181938
324.478789,6,0,0,0,0,125100,124800,0,0,0
324.788173,0,515,615,-100,100,125100,124800,28711,230689,205689
324.788173,1,513,611,-98,98,125100,124800,28559,75641,51141
324.788173,2,2893,2918,-25,25,125100,124800,12691,-294391,-300641
324.788173,3,387,480,-93,93,125100,124800,12832,121768,98518
324.788173,4,90,50,40,-40,125100,124800,-1769,-19831,-9831
324.788173,5,1852,1879,-27,27,125100,124800,6888,-175188,-181938
324.788173,6,0,0,0,0,125100,124800,0,0,0
324.986403,0,515,615,-100,100,125100,124800,28711,230689,205689
324.986403,1,513,611,-98,98,125100,124800,28559,75641,51141
324.986403,2,2893,2918,-25,25,125100,124800,12691,-294391,-300641
324.986403,3,387,480,-93,93,125100,124800,12832,121768,98518
324.986403,4,90,50,40,-40,125100,124800,-1769,-19831,-9831
324.986403,5,1852,1879,-27,27,125100,124800,6888,-175188,-181938
324.986403,6,0,0,0,0,125100,124800,0,0,0
325.296647,0,515,615,-100,100,125000,124800,28711,230689,210689
325.296647,1,513,611,-98,98,125000,124800,28559,75641,56041
325.296647,2,2893,2918,-25,25,125000,124800,12691,-294391,-299391
325.296647,3,387,480,-93,93,125000,124800,12832,121768,103168
325.296647,4,90,50,40,-40,125000,124800,-1769,-19831,-11831
325.296647,5,1852,1889,-37,37,125000,124800,7138,-173438,-180838
325.296647,6,0,0,0,0,125000,124800,0,0,0
325.507076,0,515,615,-100,100,125100,124800,28711,230689,205689
325.507076,1,513,611,-98,98,125100,124800,28559,75641,51141
325.507076,2,2893,2928,-35,35,125100,124800,12566,-291266,-300016
325.507076,3,387,480,-93,93,125100,124800,12832,121768,98518
325.507076,4,90,50,40,-40,125100,124800,-1769,-19831,-9831
325.507076,5,1852,1889,-37,37,125100,124800,7138,-173438,-182688
325.507076,6,0,0,0,0,125100,124800,0,0,0
325.783,0,515,615,-100,100,125100,124800,28711,230689,205689
325.783,1,513,611,-98,98,125100,124800,28559,75641,51141
325.783,2,2899,2928,-29,35,125100,124800,12491,-1041791,-300241
325.783,3,387,480,-93,93,125100,124800,12832,121768,98518
325.783,4,90,50,40,-40,125100,124800,-1769,-19831,-9831
325.783,5,1862,1889,-27,37,125100,124800,7013,-1425313,-184063
325.783,6,0,0,0,0,125100,124800,0,0,0
326.014219,0,515,615,-100,100,125100,124800,28711,230689,205689
326.014219,1,513,611,-98,98,125100,124800,28559,75641,51141
326.014219,2,2899,2928,-29,29,125100,124800,12491,-293591,-300841
326.014219,3,387,480,-93,93,125100,124800,12832,121768,98518
326.014219,4,90,50,40,-40,125100,124800,-1769,-19831,-9831
326.014219,5,1862,1889,-27,27,125100,124800,7013,-178313,-185063
326.014219,6,0,0,0,0,125100,124800,0,0,0
326.216853,0,515,615,-100,100,125100,124800,28711,230689,205689
326.216853,1,513,611,-98,98,125100,124800,28559,75641,51141
326.216853,2,2899,2938,-39,39,125100,124800,12741,-290841,-300591
326.216853,3,387,480,-93,93,125100,124800,12832,121768,98518
326.216853,4,90,50,40,-40,125100,124800,-1769,-19831,-9831
326.216853,5,1872,1889,-17,17,125100,124800,6888,-182188,-186438
326.216853,6,0,0,0,0,125100,124800,0,0,0
326.464307,0,515,615,-100,100,125100,124800,28711,230689,205689
326.464307,1,513,611,-98,98,125100,124800,28559,75641,51141
326.464307,2,2899,2938,-39,39,125100,124800,12741,-290841,-300591
326.464307,3,387,480,-93,93,125100,124800,12832,121768,98518
326.464307,4,90,50,40,-40,125100,124800,-1769,-19831,-9831
326.464307,5,1872,1889,-17,17,125100,124800,6888,-182188,-186438
326.464307,6,0,0,0,0,125100,124800,0,0,0
326.711821,0,515,615,-100,100,125100,124800,28711,230689,205689
326.711821,1,513,611,-98,98,125100,124800,28559,75641,51141
326.711821,2,2899,2938,-39,39,125100,124800,12741,-290841,-300591
326.711821,3,387,480,-93,93,125100,124800,12832,121768,98518
326.711821,4,90,50,40,-40,125100,124800,-1769,-19831,-9831
326.711821,5,1872,1889,-17,17,125100,124800,6888,-182188,-186438
326.711821,6,0,0,0,0,125100,124800,0,0,0
327.028089,0,515,615,-100,100,125400,124800,28711,230689,205689
327.028089,1,513,611,-98,98,125400,124800,28559,75641,51141
327.028089,2,2909,2948,-39,39,125400,124800,12491,-290591,-300341
327.028089,3,387,480,-93,93,125400,124800,12832,121768,98518
327.028089,4,90,50,40,-40,125400,124800,-1769,-19831,-9831
327.028089,5,1872,1899,-27,27,125400,124800,7138,-179438,-186188
327.028089,6,0,0,0,0,125400,124800,0,0,0
327.244166,0,515,615,-100,100,125100,124800,28711,230689,205689
327.244166,1,513,611,-98,98,125100,124800,28559,75641,51141
327.244166,2,2919,2948,-29,29,125100,124800,12741,-294841,-302091
327.244166,3,387,480,-93,93,125100,124800,12832,121768,98518
327.244166,4,90,50,40,-40,125100,124800,-1769,-19831,-9831
327.244166,5,1872,1909,-37,37,125100,124800,7013,-176313,-185563
327.244166,6,0,0,0,0,125100,124800,0,0,0
327.463694,0,515,615,-100,100,125100,124800,28711,230689,205689
327.463694,1,513,611,-98,98,125100,124800,28559,75641,51141
327.463694,2,2919,2958,-39,39,125100,124800,12616,-291716,-301466
327.463694,3,387,480,-93,93,125100,124800,12832,121768,98518
327.463694,4,90,50,40,-40,125100,124800,-1769,-19831,-9831
327.463694,5,1882,1909,-27,27,125100,124800,7263,-181563,-188313
327.463694,6,0,0,0,0,125100,124800,0,0,0
327.721478,0,515,615,-100,100,125100,124700,28711,230689,205789
327.721478,1,513,611,-98,98,125100,124700,28559,75641,51239
327.721478,2,2919,2958,-39,39,125100,124700,12616,-291716,-301427
327.721478,3,387,480,-93,93,125100,124700,12832,121768,98611
327.721478,4,90,50,40,-40,125100,124700,-1769,-19831,-9871
327.721478,5,1882,1909,-27,27,125100,124700,7263,-181563,-188286
327.721478,6,0,0,0,0,125100,124700,0,0,0
327.988048,0,515,615,-100,100,125100,124700,28711,230689,205789
327.988048,1,513,611,-98,98,125100,124700,28559,75641,51239
327.988048,2,2919,2958,-39,39,125100,124700,12616,-291716,-301427
327.988048,3,387,480,-93,93,125100,124700,12832,121768,98611
327.988048,4,90,50,40,-40,125100,124700,-1769,-19831,-9871
327.988048,5,1882,1909,-27,27,125100,124700,7263,-181563,-188286
327.988048,6,0,0,0,0,125100,124700,0,0,0
328.219976,0,515,615,-100,100,125000,124700,28711,230689,205789
328.219976,1,513,611,-98,98,125000,124700,28559,75641,51239
328.219976,2,2920,2958,-38,38,125000,124700,12604,-292104,-301566
328.219976,3,387,480,-93,93,125000,124700,12832,121768,98611
328.219976,4,90,50,40,-40,125000,124700,-1769,-19831,-9871
328.219976,5,1882,1919,-37,37,125000,124700,7513,-179813,-189026
328.219976,6,0,0,0,0,125000,124700,0,0,0
328.539549,0,515,615,-100,100,125400,124700,28711,230689,205789
328.539549,1,513,611,-98,98,125400,124700,28559,75641,51239
328.539549,2,2929,2968,-39,39,125400,124700,12367,-290567,-300278
328.539549,3,387,480,-93,93,125400,124700,12832,121768,98611
328.539549,4,90,50,40,-40,125400,124700,-1769,-19831,-9871
328.539549,5,1892,1929,-37,37,125400,124700,7263,-176563,-185776
328.539549,6,0,0,0,0,125400,124700,0,0,0
328.75001,0,515,615,-100,100,125400,124700,28711,230689,205789
328.75001,1,513,611,-98,98,125400,124700,28559,75641,51239
328.75001,2,2929,2968,-39,39,125400,124700,12367,-290567,-300278
328.75001,3,387,480,-93,93,125400,124700,12832,121768,98611
328.75001,4,90,50,40,-40,125400,124700,-1769,-19831,-9871
328.75001,5,1892,1929,-37,37,125400,124700,7263,-176563,-185776
328.75001,6,0,0,0,0,125400,124700,0,0,0
329.012518,0,515,615,-100,100,124800,124700,28711,230689,220689
329.012518,1,513,611,-98,98,124800,124700,28559,75641,65841
329.012518,2,2939,2978,-39,39,124800,124700,12492,-288692,-292592
329.012518,3,387,480,-93,93,124800,124700,12832,121768,112468
329.012518,4,90,50,40,-40,124800,124700,-1769,-19831,-15831
329.012518,5,1912,1929,-17,17,124800,124700,7013,-187313,-189013
329.012518,6,0,0,0,0,124800,124700,0,0,0
329.285656,0,515,615,-100,100,124800,124400,28711,230689,205789
329.285656,1,513,611,-98,98,124800,124400,28559,75641,51239
329.285656,2,2939,2978,-39,39,124800,124400,12492,-288692,-298403
329.285656,3,387,480,-93,93,124800,124400,12832,121768,98611
329.285656,4,90,50,40,-40,124800,124400,-1769,-19831,-9871
329.285656,5,1912,1929,-17,17,124800,124400,7013,-187313,-191546
329.285656,6,0,0,0,0,124800,124400,0,0,0
329.472152,0,515,615,-100,100,124800,124400,28711,230689,205789
329.472152,1,513,611,-98,98,124800,124400,28559,75641,51239
329.472152,2,2939,2978,-39,39,124800,124400,12492,-288692,-298403
329.472152,3,387,480,-93,93,124800,124400,12832,121768,98611
329.472152,4,90,50,40,-40,124800,124400,-1769,-19831,-9871
329.472152,5,1912,1929,-17,17,124800,124400,7013,-187313,-191546
329.472152,6,0,0,0,0,124800,124400,0,0,0
329.767,0,515,615,-100,100,125000,124400,28711,230689,205789
329.767,1,513,611,-98,98,125000,124400,28559,75641,51239
329.767,2,2949,2984,-35,35,125000,124400,12292,-290092,-298807
329.767,3,387,480,-93,93,125000,124400,12832,121768,98611
329.767,4,90,50,40,-40,125000,124400,-1769,-19831,-9871
329.767,5,1912,1929,-17,17,125000,124400,7013,-187313,-191546
329.767,6,0,0,0,0,125000,124400,0,0,0
329.9701,0,515,615,-100,100,125000,124400,28711,230689,205789
329.9701,1,513,611,-98,98,125000,124400,28559,75641,51239
329.9701,2,2949,2984,-35,35,125000,124400,12292,-290092,-298807
329.9701,3,387,480,-93,93,125000,124400,12832,121768,98611
329.9701,4,90,50,40,-40,125000,124400,-1769,-19831,-9871
329.9701,5,1912,1929,-17,17,125000,124400,7013,-187313,-191546
329.9701,6,0,0,0,0,125000,124400,0,0,0
330.216907,0,515,615,-100,100,125000,124600,28711,230689,205789
330.216907,1,513,611,-98,98,125000,124600,28559,75641,51239
330.216907,2,2949,2984,-35,35,125000,124600,12292,-290092,-298807
330.216907,3,387,480,-93,93,125000,124600,12832,121768,98611
330.216907,4,90,50,40,-40,125000,124600,-1769,-19831,-9871
330.216907,5,1912,1929,-17,17,125000,124600,7013,-187313,-191546
330.216907,6,0,0,0,0,125000,124600,0,0,0
330.509668,0,515,615,-100,100,125000,124600,28711,230689,205789
330.509668,1,513,611,-98,98,125000,124600,28559,75641,51239
330.509668,2,2949,2984,-35,35,125000,124600,12292,-290092,-298807
330.509668,3,387,480,-93,93,125000,124600,12832,121768,98611
330.509668,4,90,50,40,-40,125000,124600,-1769,-19831,-9871
330.509668,5,1912,1929,-17,17,125000,124600,7013,-187313,-191546
330.509668,6,0,0,0,0,125000,124600,0,0,0
330.786831,0,515,615,-100,100,125000,124600,28711,230689,205789
330.786831,1,513,611,-98,98,125000,124600,28559,75641,51239
330.786831,2,2949,2984,-35,35,125000,124600,12292,-290092,-298807
330.786831,3,387,480,-93,93,125000,124600,12832,121768,98611
330.786831,4,90,50,40,-40,125000,124600,-1769,-19831,-9871
330.786831,5,1912,1929,-17,17,125000,124600,7013,-187313,-191546
330.786831,6,0,0,0,0,125000,124600,0,0,0
331.007645,0,515,615,-100,100,125000,124600,28711,230689,205789
331.007645,1,513,611,-98,98,125000,124600,28559,75641,51239
331.007645,2,2949,2984,-35,35,125000,124600,12292,-290092,-298807
331.007645,3,387,480,-93,93,125000,124600,12832,121768,98611
331.007645,4,90,50,40,-40,125000,124600,-1769,-19831,-9871
331.007645,5,1912,1929,-17,17,125000,124600,7013,-187313,-191546
331.007645,6,0,0,0,0,125000,124600,0,0,0
331.267434,0,515,615,-100,100,124700,124600,28711,230689,220689
331.267434,1,513,611,-98,98,124700,124600,28559,75641,65841
331.267434,2,2969,2984,-15,15,124700,124600,12042,-296842,-298342
331.267434,3,387,480,-93,93,124700,124600,12832,121768,112468
331.267434,4,90,50,40,-40,124700,124600,-1769,-19831,-15831
331.267434,5,1912,1929,-17,17,124700,124600,7013,-187313,-189013
331.267434,6,0,0,0,0,124700,124600,0,0,0
331.516911,0,515,615,-100,100,124700,124600,28711,230689,220689
331.516911,1,513,611,-98,98,124700,124600,28559,75641,65841
331.516911,2,2969,2984,-15,15,124700,124600,12042,-296842,-298342
331.516911,3,387,480,-93,93,124700,124600,12832,121768,112468
331.516911,4,90,50,40,-40,124700,124600,-1769,-19831,-15831
331.516911,5,1912,1929,-17,17,124700,124600,7013,-187313,-189013
331.516911,6,0,0,0,0,124700,124600,0,0,0
331.747284,0,515,615,-100,100,124700,124600,28711,230689,220689
331.747284,1,513,611,-98,98,124700,124600,28559,75641,65841
331.747284,2,2969,2984,-15,15,124700,124600,12042,-296842,-298342
331.747284,3,387,480,-93,93,124700,124600,12832,121768,112468
331.747284,4,90,50,40,-40,124700,124600,-1769,-19831,-15831
331.747284,5,1912,1929,-17,17,124700,124600,7013,-187313,-189013
331.747284,6,0,0,0,0,124700,124600,0,0,0
331.998465,0,515,615,-100,100,124700,124600,28711,230689,220689
331.998465,1,513,611,-98,98,124700,124600,28559,75641,65841
331.998465,2,2969,2984,-15,15,124700,124600,12042,-296842,-298342
331.998465,3,387,480,-93,93,124700,124600,12832,121768,112468
331.998465,4,90,50,40,-40,124700,124600,-1769,-19831,-15831
331.998465,5,1912,1929,-17,17,124700,124600,7013,-187313,-189013
331.998465,6,0,0,0,0,124700,124600,0,0,0
332.274791,0,515,615,-100,100,124700,124600,28711,230689,220689
332.274791,1,513,611,-98,98,124700,124600,28559,75641,65841
332.274791,2,2979,2984,-5,5,124700,124600,11917,-298717,-299217
332.274791,3,387,480,-93,93,124700,124600,12832,121768,112468
332.274791,4,90,50,40,-40,124700,124600,-1769,-19831,-15831
332.274791,5,1912,1929,-17,17,124700,124600,7013,-187313,-189013
332.274791,6,0,0,0,0,124700,124600,0,0,0
332.497401,0,515,615,-100,100,124700,124600,28711,230689,220689
332.497401,1,513,611,-98,98,124700,124600,28559,75641,65841
332.497401,2,2979,2984,-5,5,124700,124600,11917,-298717,-299217
332.497401,3,387,480,-93,93,124700,124600,12832,121768,112468
332.497401,4,90,50,40,-40,124700,124600,-1769,-19831,-15831
332.497401,5,1912,1929,-17,17,124700,124600,7013,-187313,-189013
332.497401,6,0,0,0,0,124700,124600,0,0,0
332.73274,0,515,615,-100,100,124700,124600,28711,230689,220689
332.73274,1,513,611,-98,98,124700,124600,28559,75641,65841
332.73274,2,2979,2984,-5,5,124700,124600,11917,-298717,-299217
332.73274,3,387,480,-93,93,124700,124600,12832,121768,112468
332.73274,4,90,50,40,-40,124700,124600,-1769,-19831,-15831
332.73274,5,1912,1929,-17,17,124700,124600,7013,-187313,-189013
332.73274,6,0,0,0,0,124700,124600,0,0,0
333.002042,0,515,615,-100,100,124700,124600,28711,230689,220689
333.002042,1,513,611,-98,98,124700,124600,28559,75641,65841
333.002042,2,2979,2984,-5,5,124700,124600,11917,-298717,-299217
333.002042,3,387,480,-93,93,124700,124600,12832,121768,112468
333.002042,4,90,50,40,-40,124700,124600,-1769,-19831,-15831
333.002042,5,1912,1929,-17,17,124700,124600,7013,-187313,-189013
333.002042,6,0,0,0,0,124700,124600,0,0,0
333.276971,0,515,615,-100,100,124700,124800,28711,230689,240689
333.276971,1,513,611,-98,98,124700,124800,28559,75641,85441
333.276971,2,2979,2984,-5,5,124700,124800,11917,-298717,-298217
333.276971,3,387,480,-93,93,124700,124800,12832,121768,131068
333.276971,4,90,50,40,-40,124700,124800,-1769,-19831,-23831
333.276971,5,1912,1929,-17,17,124700,124800,7013,-187313,-185613
333.276971,6,0,0,0,0,124700,124800,0,0,0
333.461817,0,515,615,-100,100,125000,124800,28711,230689,210689
333.461817,1,513,611,-98,98,125000,124800,28559,75641,56041
333.461817,2,2979,2994,-15,15,125000,124800,11792,-297592,-300592
333.461817,3,387,480,-93,93,125000,124800,12832,121768,103168
333.461817,4,90,50,40,-40,125000,124800,-1769,-19831,-11831
333.461817,5,1922,1929,-7,7,125000,124800,7263,-190563,-191963
333.461817,6,0,0,0,0,125000,124800,0,0,0
333.723107,0,515,615,-100,100,125000,124800,28711,230689,210689
333.723107,1,513,611,-98,98,125000,124800,28559,75641,56041
333.723107,2,2979,2994,-15,15,125000,124800,11792,-297592,-300592
333.723107,3,387,480,-93,93,125000,124800,12832,121768,103168
333.723107,4,90,50,40,-40,125000,124800,-1769,-19831,-11831
333.723107,5,1922,1929,-7,7,125000,124800,7263,-190563,-191963
333.723107,6,0,0,0,0,125000,124800,0,0,0
334.042147,0,515,615,-100,100,125000,124800,28711,230689,210689
334.042147,1,513,611,-98,98,125000,124800,28559,75641,56041
334.042147,2,2989,2994,-5,5,125000,124800,12042,-299842,-300842
334.042147,3,387,480,-93,93,125000,124800,12832,121768,103168
334.042147,4,90,50,40,-40,125000,124800,-1769,-19831,-11831
334.042147,5,1922,1939,-17,17,125000,124800,7138,-189438,-192838
334.042147,6,0,0,0,0,125000,124800,0,0,0
334.260065,0,515,615,-100,100,125000,124800,28711,230689,210689
334.260065,1,513,611,-98,98,125000,124800,28559,75641,56041
334.260065,2,2989,2994,-5,5,125000,124800,12042,-299842,-300842
334.260065,3,387,480,-93,93,125000,124800,12832,121768,103168
334.260065,4,90,50,40,-40,125000,124800,-1769,-19831,-11831
334.260065,5,1922,1939,-17,17,125000,124800,7138,-189438,-192838
334.260065,6,0,0,0,0,125000,124800,0,0,0
334.49023,0,515,615,-100,100,125000,124800,28711,230689,210689
334.49023,1,513,611,-98,98,125000,124800,28559,75641,56041
334.49023,2,2989,2994,-5,5,125000,124800,12042,-299842,-300842
334.49023,3,387,480,-93,93,125000,124800,12832,121768,103168
334.49023,4,90,50,40,-40,125000,124800,-1769,-19831,-11831
334.49023,5,1922,1939,-17,17,125000,124800,7138,-189438,-192838
334.49023,6,0,0,0,0,125000,124800,0,0,0
334.722989,0,515,615,-100,100,125300,124800,28711,230689,205689
334.722989,1,513,611,-98,98,125300,124800,28559,75641,51141
334.722989,2,2989,3004,-15,15,125300,124800,11917,-298717,-302467
334.722989,3,387,480,-93,93,125300,124800,12832,121768,98518
334.722989,4,90,50,40,-40,125300,124800,-1769,-19831,-9831
334.722989,5,1922,1949,-27,27,125300,124800,7013,-186313,-193063
334.722989,6,0,0,0,0,125300,124800,0,0,0
335.003391,0,515,615,-100,100,125100,124800,28711,230689,205689
335.003391,1,513,611,-98,98,125100,124800,28559,75641,51141
335.003391,2,2989,3014,-25,25,125100,124800,11792,-296592,-302842
335.003391,3,387,480,-93,93,125100,124800,12832,121768,98518
335.003391,4,90,50,40,-40,125100,124800,-1769,-19831,-9831
335.003391,5,1932,1949,-17,17,125100,124800,7263,-190563,-194813
335.003391,6,0,0,0,0,125100,124800,0,0,0
335.295779,0,515,615,-100,100,125100,124800,28711,230689,205689
335.295779,1,513,611,-98,98,125100,124800,28559,75641,51141
335.295779,2,2989,3014,-25,25,125100,124800,11792,-296592,-302842
335.295779,3,387,480,-93,93,125100,124800,12832,121768,98518
335.295779,4,90,50,40,-40,125100,124800,-1769,-19831,-9831
335.295779,5,1932,1949,-17,17,125100,124800,7263,-190563,-194813
335.295779,6,0,0,0,0,125100,124800,0,0,0
335.509789,0,515,615,-100,100,125100,124800,28711,230689,205689
335.509789,1,513,611,-98,98,125100,124800,28559,75641,51141
335.509789,2,2989,3014,-25,25,125100,124800,11792,-296592,-302842
335.509789,3,387,480,-93,93,125100,124800,12832,121768,98518
335.509789,4,90,50,40,-40,125100,124800,-1769,-19831,-9831
335.509789,5,1932,1949,-17,17,125100,124800,7263,-190563,-194813
335.509789,6,0,0,0,0,125100,124800,0,0,0
335.711711,0,515,615,-100,100,125100,124800,28711,230689,205689
335.711711,1,513,611,-98,98,125100,124800,28559,75641,51141
335.711711,2,2999,3014,-15,15,125100,124800,12042,-299842,-303592
335.711711,3,387,480,-93,93,125100,124800,12832,121768,98518
335.711711,4,90,50,40,-40,125100,124800,-1769,-19831,-9831
335.711711,5,1932,1959,-27,27,125100,124800,7138,-188438,-195188
335.711711,6,0,0,0,0,125100,124800,0,0,0
336.043943,0,515,615,-100,100,125100,124800,28711,230689,205689
336.043943,1,513,611,-98,98,125100,124800,28559,75641,51141
336.043943,2,2999,3024,-25,25,125100,124800,12292,-298092,-304342
336.043943,3,387,480,-93,93,125100,124800,12832,121768,98518
336.043943,4,90,50,40,-40,125100,124800,-1769,-19831,-9831
336.043943,5,1942,1959,-17,17,125100,124800,7013,-191313,-195563
336.043943,6,0,0,0,0,125100,124800,0,0,0
336.231146,0,515,615,-100,100,124700,124800,28711,230689,240689
336.231146,1,513,611,-98,98,124700,124800,28559,75641,85441
336.231146,2,3009,3024,-15,15,124700,124800,12167,-300967,-299467
336.231146,3,387,480,-93,93,124700,124800,12832,121768,131068
336.231146,4,90,50,40,-40,124700,124800,-1769,-19831,-23831
336.231146,5,1952,1959,-7,7,124700,124800,6888,-194188,-193488
336.231146,6,0,0,0,0,124700,124800,0,0,0
336.479748,0,515,615,-100,100,124700,124800,28711,230689,240689
336.479748,1,513,611,-98,98,124700,124800,28559,75641,85441
336.479748,2,3009,3024,-15,15,124700,124800,12167,-300967,-299467
336.479748,3,387,480,-93,93,124700,124800,12832,121768,131068
336.479748,4,90,50,40,-40,124700,124800,-1769,-19831,-23831
336.479748,5,1952,1959,-7,7,124700,124800,6888,-194188,-193488
336.479748,6,0,0,0,0,124700,124800,0,0,0
336.754103,0,515,615,-100,100,124700,124800,28711,230689,240689
336.754103,1,513,611,-98,98,124700,124800,28559,75641,85441
336.754103,2,3009,3024,-15,15,124700,124800,12167,-300967,-299467
336.754103,3,387,480,-93,93,124700,124800,12832,121768,131068
336.754103,4,90,50,40,-40,124700,124800,-1769,-19831,-23831
336.754103,5,1952,1959,-7,7,124700,124800,6888,-194188,-193488
336.754103,6,0,0,0,0,124700,124800,0,0,0
336.993861,0,515,615,-100,100,125300,124600,28711,230689,205789
336.993861,1,513,611,-98,98,125300,124600,28559,75641,51239
336.993861,2,3009,3034,-25,25,125300,124600,12042,-298842,-305067
336.993861,3,387,480,-93,93,125300,124600,12832,121768,98611
336.993861,4,90,50,40,-40,125300,124600,-1769,-19831,-9871
336.993861,5,1952,1959,-7,7,125300,124600,6888,-194188,-195931
336.993861,6,0,0,0,0,125300,124600,0,0,0
337.252213,0,515,615,-100,100,125300,124600,28711,230689,205789
337.252213,1,513,611,-98,98,125300,124600,28559,75641,51239
337.252213,2,3009,3034,-25,25,125300,124600,12042,-298842,-305067
337.252213,3,387,480,-93,93,125300,124600,12832,121768,98611
337.252213,4,90,50,40,-40,125300,124600,-1769,-19831,-9871
337.252213,5,1952,1959,-7,7,125300,124600,6888,-194188,-195931
337.252213,6,0,0,0,0,125300,124600,0,0,0
337.538274,0,515,615,-100,100,125100,124600,28711,230689,205789
337.538274,1,513,611,-98,98,125100,124600,28559,75641,51239
337.538274,2,3009,3044,-35,35,125100,124600,11917,-295717,-304432
337.538274,3,387,480,-93,93,125100,124600,12832,121768,98611
337.538274,4,90,50,40,-40,125100,124600,-1769,-19831,-9871
337.538274,5,1952,1959,-7,7,125100,124600,6888,-194188,-195931
337.538274,6,0,0,0,0,125100,124600,0,0,0
337.70204,0,515,615,-100,100,125100,124600,28711,230689,205789
337.70204,1,513,611,-98,98,125100,124600,28559,75641,51239
337.70204,2,3009,3044,-35,35,125100,124600,11917,-295717,-304432
337.70204,3,387,480,-93,93,125100,124600,12832,121768,98611
337.70204,4,90,50,40,-40,125100,124600,-1769,-19831,-9871
337.70204,5,1952,1959,-7,7,125100,124600,6888,-194188,-195931
337.70204,6,0,0,0,0,125100,124600,0,0,0
338.016059,0,515,615,-100,100,125100,124600,28711,230689,205789
338.016059,1,513,611,-98,98,125100,124600,28559,75641,51239
338.016059,2,3009,3044,-35,35,125100,124600,11917,-295717,-304432
338.016059,3,387,480,-93,93,125100,124600,12832,121768,98611
338.016059,4,90,50,40,-40,125100,124600,-1769,-19831,-9871
338.016059,5,1952,1959,-7,7,125100,124600,6888,-194188,-195931
338.016059,6,0,0,0,0,125100,124600,0,0,0
338.210917,0,515,615,-100,100,125100,124600,28711,230689,205789
338.210917,1,513,611,-98,98,125100,124600,28559,75641,51239
338.210917,2,3009,3044,-35,35,125100,124600,11917,-295717,-304432
338.210917,3,387,480,-93,93,125100,124600,12832,121768,98611
338.210917,4,90,50,40,-40,125100,124600,-1769,-19831,-9871
338.210917,5,1952,1959,-7,7,125100,124600,6888,-194188,-195931
338.210917,6,0,0,0,0,125100,124600,0,0,0
338.473576,0,515,615,-100,100,125100,124600,28711,230689,205789
338.473576,1,513,611,-98,98,125100,124600,28559,75641,51239
338.473576,2,3009,3044,-35,35,125100,124600,11917,-295717,-304432
338.473576,3,387,480,-93,93,125100,124600,12832,121768,98611
338.473576,4,90,50,40,-40,125100,124600,-1769,-19831,-9871
338.473576,5,1952,1959,-7,7,125100,124600,6888,-194188,-195931
338.473576,6,0,0,0,0,125100,124600,0,0,0
338.713054,0,515,615,-100,100,125100,124600,28711,230689,205789
338.713054,1,513,611,-98,98,125100,124600,28559,75641,51239
338.713054,2,3009,3044,-35,35,125100,124600,11917,-295717,-304432
338.713054,3,387,480,-93,93,125100,124600,12832,121768,98611
338.713054,4,90,50,40,-40,125100,124600,-1769,-19831,-9871
338.713054,5,1952,1959,-7,7,125100,124600,6888,-194188,-195931
338.713054,6,0,0,0,0,125100,124600,0,0,0
338.968527,0,515,615,-100,100,125100,124600,28711,230689,205789
338.968527,1,513,611,-98,98,125100,124600,28559,75641,51239
338.968527,2,3009,3044,-35,35,125100,124600,11917,-295717,-304432
338.968527,3,387,480,-93,93,125100,124600,12832,121768,98611
338.968527,4,90,50,40,-40,125100,124600,-1769,-19831,-9871
338.968527,5,1952,1959,-7,7,125100,124600,6888,-194188,-195931
338.968527,6,0,0,0,0,125100,124600,0,0,0
339.257817,0,515,615,-100,100,125000,124800,28711,230689,210689
339.257817,1,513,611,-98,98,125000,124800,28559,75641,56041
339.257817,2,3019,3044,-25,25,125000,124800,12167,-298967,-303967
339.257817,3,387,480,-93,93,125000,124800,12832,121768,103168
339.257817,4,90,50,40,-40,125000,124800,-1769,-19831,-11831
339.257817,5,1952,1969,-17,17,125000,124800,6763,-192063,-195463
339.257817,6,0,0,0,0,125000,124800,0,0,0
339.465296,0,515,615,-100,100,125000,124800,28711,230689,210689
339.465296,1,513,611,-98,98,125000,124800,28559,75641,56041
339.465296,2,3019,3044,-25,25,125000,124800,12167,-298967,-303967
339.465296,3,387,480,-93,93,125000,124800,12832,121768,103168
339.465296,4,90,50,40,-40,125000,124800,-1769,-19831,-11831
339.465296,5,1952,1969,-17,17,125000,124800,6763,-192063,-195463
339.465296,6,0,0,0,0,125000,124800,0,0,0
339.74326,0,515,615,-100,100,125000,124800,28711,230689,210689
339.74326,1,513,611,-98,98,125000,124800,28559,75641,56041
339.74326,2,3019,3044,-25,25,125000,124800,12167,-298967,-303967
339.74326,3,387,480,-93,93,125000,124800,12832,121768,103168
339.74326,4,90,50,40,-40,125000,124800,-1769,-19831,-11831
339.74326,5,1952,1969,-17,17,125000,124800,6763,-192063,-195463
339.74326,6,0,0,0,0,125000,124800,0,0,0
339.987466,0,515,615,-100,100,125300,124800,28711,230689,205689
339.987466,1,513,611,-98,98,125300,124800,28559,75641,51141
339.987466,2,3019,3054,-35,35,125300,124800,12042,-295842,-304592
339.987466,3,387,480,-93,93,125300,124800,12832,121768,98518
339.987466,4,90,50,40,-40,125300,124800,-1769,-19831,-9831
339.987466,5,1952,1979,-27,27,125300,124800,6638,-188938,-195688
339.987466,6,0,0,0,0,125300,124800,0,0,0
340.250734,0,515,615,-100,100,125300,124800,28711,230689,205689
340.250734,1,513,611,-98,98,125300,124800,28559,75641,51141
340.250734,2,3019,3064,-45,45,125300,124800,12293,-292093,-303343
340.250734,3,387,480,-93,93,125300,124800,12832,121768,98518
340.250734,4,90,50,40,-40,125300,124800,-1769,-19831,-9831
340.250734,5,1952,1989,-37,37,125300,124800,6889,-185189,-194439
340.250734,6,0,0,0,0,125300,124800,0,0,0
340.542025,0,515,615,-100,100,125400,124800,28711,230689,205689
340.542025,1,513,611,-98,98,125400,124800,28559,75641,51141
340.542025,2,3019,3064,-45,45,125400,124800,12293,-292093,-303343
340.542025,3,387,480,-93,93,125400,124800,12832,121768,98518
340.542025,4,90,50,40,-40,125400,124800,-1769,-19831,-9831
340.542025,5,1952,1989,-37,37,125400,124800,6889,-185189,-194439
340.542025,6,0,0,0,0,125400,124800,0,0,0
340.781463,0,515,615,-100,100,125400,125100,28711,230689,205689
340.781463,1,513,611,-98,98,125400,125100,28559,75641,51141
340.781463,2,3019,3064,-45,45,125400,125100,12293,-292093,-303343
340.781463,3,387,480,-93,93,125400,125100,12832,121768,98518
340.781463,4,90,50,40,-40,125400,125100,-1769,-19831,-9831
340.781463,5,1952,1989,-37,37,125400,125100,6889,-185189,-194439
340.781463,6,0,0,0,0,125400,125100,0,0,0
340.965336,0,515,615,-100,100,125600,125100,28711,230689,205689
340.965336,1,513,611,-98,98,125600,125100,28559,75641,51141
340.965336,2,3029,3064,-35,35,125600,125100,12544,-297344,-306094
340.965336,3,387,480,-93,93,125600,125100,12832,121768,98518
340.965336,4,90,50,40,-40,125600,125100,-1769,-19831,-9831
340.965336,5,1952,1989,-37,37,125600,125100,6889,-185189,-194439
340.965336,6,0,0,0,0,125600,125100,0,0,0
341.244537,0,515,615,-100,100,124600,125100,28711,230689,255689
341.244537,1,513,611,-98,98,124600,125100,28559,75641,100141
341.244537,2,3039,3064,-25,25,124600,125100,12419,-302219,-295969
341.244537,3,387,480,-93,93,124600,125100,12832,121768,145018
341.244537,4,90,50,40,-40,124600,125100,-1769,-19831,-29831
341.244537,5,1962,1989,-27,27,124600,125100,6764,-189064,-182314
341.244537,6,0,0,0,0,124600,125100,0,0,0
341.455281,0,515,615,-100,100,124600,125100,28711,230689,255689
341.455281,1,513,611,-98,98,124600,125100,28559,75641,100141
341.455281,2,3039,3064,-25,25,124600,125100,12419,-302219,-295969
341.455281,3,387,480,-93,93,124600,125100,12832,121768,145018
341.455281,4,90,50,40,-40,124600,125100,-1769,-19831,-29831
341.455281,5,1962,1989,-27,27,124600,125100,6764,-189064,-182314
341.455281,6,0,0,0,0,124600,125100,0,0,0
341.785655,0,515,615,-100,100,124600,125100,28711,230689,255689
341.785655,1,513,611,-98,98,124600,125100,28559,75641,100141
341.785655,2,3039,3064,-25,25,124600,125100,12419,-302219,-295969
341.785655,3,387,480,-93,93,124600,125100,12832,121768,145018
341.785655,4,90,50,40,-40,124600,125100,-1769,-19831,-29831
341.785655,5,1962,1989,-27,27,124600,125100,6764,-189064,-182314
341.785655,6,0,0,0,0,124600,125100,0,0,0
342.017277,0,515,615,-100,100,124600,125100,28711,230689,255689
342.017277,1,513,611,-98,98,124600,125100,28559,75641,100141
342.017277,2,3039,3064,-25,25,124600,125100,12419,-302219,-295969
342.017277,3,387,480,-93,93,124600,125100,12832,121768,145018
342.017277,4,90,50,40,-40,124600,125100,-1769,-19831,-29831
342.017277,5,1962,1989,-27,27,124600,125100,6764,-189064,-182314
342.017277,6,0,0,0,0,124600,125100,0,0,0
342.241084,0,515,615,-100,100,124600,125100,28711,230689,255689
342.241084,1,513,611,-98,98,124600,125100,28559,75641,100141
342.241084,2,3039,3064,-25,25,124600,125100,12419,-302219,-295969
342.241084,3,387,480,-93,93,124600,125100,12832,121768,145018
342.241084,4,90,50,40,-40,124600,125100,-1769,-19831,-29831
342.241084,5,1962,1989,-27,27,124600,125100,6764,-189064,-182314
342.241084,6,0,0,0,0,124600,125100,0,0,0
342.514833,0,515,615,-100,100,124600,125100,28711,230689,255689
342.514833,1,513,611,-98,98,124600,125100,28559,75641,100141
342.514833,2,3039,3064,-25,25,124600,125100,12419,-302219,-295969
342.514833,3,387,480,-93,93,124600,125100,12832,121768,145018
342.514833,4,90,50,40,-40,124600,125100,-1769,-19831,-29831
342.514833,5,1962,1989,-27,27,124600,125100,6764,-189064,-182314
342.514833,6,0,0,0,0,124600,125100,0,0,0
342.754347,0,515,615,-100,100,125500,125100,28711,230689,205689
342.754347,1,513,611,-98,98,125500,125100,28559,75641,51141
342.754347,2,3039,3074,-35,35,125500,125100,12294,-298094,-306844
342.754347,3,387,480,-93,93,125500,125100,12832,121768,98518
342.754347,4,90,50,40,-40,125500,125100,-1769,-19831,-9831
342.754347,5,1962,1999,-37,37,125500,125100,6639,-183939,-193189
342.754347,6,0,0,0,0,125500,125100,0,0,0
342.986674,0,515,615,-100,100,125500,124700,28711,230689,205789
342.986674,1,513,611,-98,98,125500,124700,28559,75641,51239
342.986674,2,3039,3074,-35,35,125500,124700,12294,-298094,-306809
342.986674,3,387,480,-93,93,125500,124700,12832,121768,98611
342.986674,4,90,50,40,-40,125500,124700,-1769,-19831,-9871
342.986674,5,1962,1999,-37,37,125500,124700,6639,-183939,-193152
342.986674,6,0,0,0,0,125500,124700,0,0,0
343.262659,0,515,615,-100,100,125500,124700,28711,230689,205789
343.262659,1,513,611,-98,98,125500,124700,28559,75641,51239
343.262659,2,3039,3074,-35,35,125500,124700,12294,-298094,-306809
343.262659,3,387,480,-93,93,125500,124700,12832,121768,98611
343.262659,4,90,50,40,-40,125500,124700,-1769,-19831,-9871
343.262659,5,1962,1999,-37,37,125500,124700,6639,-183939,-193152
343.262659,6,0,0,0,0,125500,124700,0,0,0
343.508864,0,515,615,-100,100,125500,124700,28711,230689,205789
343.508864,1,513,611,-98,98,125500,124700,28559,75641,51239
343.508864,2,3039,3074,-35,35,125500,124700,12294,-298094,-306809
343.508864,3,387,480,-93,93,125500,124700,12832,121768,98611
343.508864,4,90,50,40,-40,125500,124700,-1769,-19831,-9871
343.508864,5,1962,1999,-37,37,125500,124700,6639,-183939,-193152
343.508864,6,0,0,0,0,125500,124700,0,0,0
343.759771,0,515,615,-100,100,125500,124700,28711,230689,205789
343.759771,1,513,611,-98,98,125500,124700,28559,75641,51239
343.759771,2,3039,3074,-35,35,125500,124700,12294,-298094,-306809
343.759771,3,387,480,-93,93,125500,124700,12832,121768,98611
343.759771,4,90,50,40,-40,125500,124700,-1769,-19831,-9871
343.759771,5,1962,1999,-37,37,125500,124700,6639,-183939,-193152
343.759771,6,0,0,0,0,125500,124700,0,0,0
343.950969,0,515,615,-100,100,125500,124700,28711,230689,205789
343.950969,1,513,611,-98,98,125500,124700,28559,75641,51239
343.950969,2,3039,3074,-35,35,125500,124700,12294,-298094,-306809
343.950969,3,387,480,-93,93,125500,124700,12832,121768,98611
343.950969,4,90,50,40,-40,125500,124700,-1769,-19831,-9871
343.950969,5,1962,1999,-37,37,125500,124700,6639,-183939,-193152
343.950969,6,0,0,0,0,125500,124700,0,0,0
344.284052,0,515,615,-100,100,124600,124700,28711,230689,240689
344.284052,1,513,611,-98,98,124600,124700,28559,75641,85441
344.284052,2,3049,3074,-25,25,124600,124700,12169,-301969,-299469
344.284052,3,387,480,-93,93,124600,124700,12832,121768,131068
344.284052,4,90,50,40,-40,124600,124700,-1769,-19831,-23831
344.284052,5,1972,1999,-27,27,124600,124700,6514,-188814,-186114
344.284052,6,0,0,0,0,124600,124700,0,0,0
344.538636,0,515,615,-100,100,124600,124700,28711,230689,240689
344.538636,1,513,611,-98,98,124600,124700,28559,75641,85441
344.538636,2,3049,3074,-25,25,124600,124700,12169,-301969,-299469
344.538636,3,387,480,-93,93,124600,124700,12832,121768,131068
344.538636,4,90,50,40,-40,124600,124700,-1769,-19831,-23831
344.538636,5,1972,1999,-27,27,124600,124700,6514,-188814,-186114
344.538636,6,0,0,0,0,124600,124700,0,0,0
344.760775,0,515,615,-100,100,124600,124700,28711,230689,240689
344.760775,1,513,611,-98,98,124600,124700,28559,75641,85441
344.760775,2,3049,3074,-25,25,124600,124700,12169,-301969,-299469
344.760775,3,387,480,-93,93,124600,124700,12832,121768,131068
344.760775,4,90,50,40,-40,124600,124700,-1769,-19831,-23831
344.760775,5,1972,1999,-27,27,124600,124700,6514,-188814,-186114
344.760775,6,0,0,0,0,124600,124700,0,0,0
345.045469,0,515,615,-100,100,124600,124700,28711,230689,240689
345.045469,1,513,611,-98,98,124600,124700,28559,75641,85441
345.045469,2,3049,3074,-25,25,124600,124700,12169,-301969,-299469
345.045469,3,387,480,-93,93,124600,124700,12832,121768,131068
345.045469,4,90,50,40,-40,124600,124700,-1769,-19831,-23831
345.045469,5,1972,1999,-27,27,124600,124700,6514,-188814,-186114
345.045469,6,0,0,0,0,124600,124700,0,0,0
345.260474,0,515,615,-100,100,124600,124700,28711,230689,240689
345.260474,1,513,611,-98,98,124600,124700,28559,75641,85441
345.260474,2,3049,3074,-25,25,124600,124700,12169,-301969,-299469
345.260474,3,387,480,-93,93,124600,124700,12832,121768,131068
345.260474,4,90,50,40,-40,124600,124700,-1769,-19831,-23831
345.260474,5,1972,1999,-27,27,124600,124700,6514,-188814,-186114
345.260474,6,0,0,0,0,124600,124700,0,0,0
345.501596,0,515,615,-100,100,124600,124700,28711,230689,240689
345.501596,1,513,611,-98,98,124600,124700,28559,75641,85441
345.501596,2,3049,3074,-25,25,124600,124700,12169,-301969,-299469
345.501596,3,387,480,-93,93,124600,124700,12832,121768,131068
345.501596,4,90,50,40,-40,124600,124700,-1769,-19831,-23831
345.501596,5,1972,1999,-27,27,124600,124700,6514,-188814,-186114
345.501596,6,0,0,0,0,124600,124700,0,0,0
345.729551,0,515,615,-100,100,124600,124700,28711,230689,240689
345.729551,1,513,611,-98,98,124600,124700,28559,75641,85441
345.729551,2,3049,3074,-25,25,124600,124700,12169,-301969,-299469
345.729551,3,387,480,-93,93,124600,124700,12832,121768,131068
345.729551,4,90,50,40,-40,124600,124700,-1769,-19831,-23831
345.729551,5,1972,1999,-27,27,124600,124700,6514,-188814,-186114
345.729551,6,0,0,0,0,124600,124700,0,0,0
345.95869,0,515,615,-100,100,124600,124700,28711,230689,240689
345.95869,1,513,611,-98,98,124600,124700,28559,75641,85441
345.95869,2,3049,3074,-25,25,124600,124700,12169,-301969,-299469
345.95869,3,387,480,-93,93,124600,124700,12832,121768,131068
345.95869,4,90,50,40,-40,124600,124700,-1769,-19831,-23831
345.95869,5,1972,1999,-27,27,124600,124700,6514,-188814,-186114
345.95869,6,0,0,0,0,124600,124700,0,0,0
346.256364,0,515,615,-100,100,124600,124700,28711,230689,240689
346.256364,1,513,611,-98,98,124600,124700,28559,75641,85441
346.256364,2,3049,3074,-25,25,124600,124700,12169,-301969,-299469
346.256364,3,387,480,-93,93,124600,124700,12832,121768,131068
346.256364,4,90,50,40,-40,124600,124700,-1769,-19831,-23831
346.256364,5,1972,1999,-27,27,124600,124700,6514,-188814,-186114
346.256364,6,0,0,0,0,124600,124700,0,0,0
346.523318,0,515,615,-100,100,124600,124700,28711,230689,240689
346.523318,1,513,611,-98,98,124600,124700,28559,75641,85441
346.523318,2,3049,3074,-25,25,124600,124700,12169,-301969,-299469
346.523318,3,387,480,-93,93,124600,124700,12832,121768,131068
346.523318,4,90,50,40,-40,124600,124700,-1769,-19831,-23831
346.523318,5,1972,1999,-27,27,124600,124700,6514,-188814,-186114
346.523318,6,0,0,0,0,124600,124700,0,0,0
346.77423,0,515,615,-100,100,124600,124700,28711,230689,240689
346.77423,1,513,611,-98,98,124600,124700,28559,75641,85441
346.77423,2,3049,3074,-25,25,124600,124700,12169,-301969,-299469
346.77423,3,387,480,-93,93,124600,124700,12832,121768,131068
346.77423,4,90,50,40,-40,124600,124700,-1769,-19831,-23831
346.77423,5,1972,1999,-27,27,124600,124700,6514,-188814,-186114
346.77423,6,0,0,0,0,124600,124700,0,0,0
347.050466,0,515,615,-100,100,124600,124700,28711,230689,240689
347.050466,1,513,611,-98,98,124600,124700,28559,75641,85441
347.050466,2,3049,3074,-25,25,124600,124700,12169,-301969,-299469
347.050466,3,387,480,-93,93,124600,124700,12832,121768,131068
347.050466,4,90,50,40,-40,124600,124700,-1769,-19831,-23831
347.050466,5,1972,1999,-27,27,124600,124700,6514,-188814,-186114
347.050466,6,0,0,0,0,124600,124700,0,0,0
347.247913,0,515,615,-100,100,124600,124700,28711,230689,240689
347.247913,1,513,611,-98,98,124600,124700,28559,75641,85441
347.247913,2,3049,3074,-25,25,124600,124700,12169,-301969,-299469
347.247913,3,387,480,-93,93,124600,124700,12832,121768,131068
347.247913,4,90,50,40,-40,124600,124700,-1769,-19831,-23831
347.247913,5,1972,1999,-27,27,124600,124700,6514,-188814,-186114
347.247913,6,0,0,0,0,124600,124700,0,0,0
347.507792,0,515,615,-100,100,125000,124700,28711,230689,205789
347.507792,1,513,611,-98,98,125000,124700,28559,75641,51239
347.507792,2,3049,3084,-35,35,125000,124700,12419,-300219,-308934
347.507792,3,387,480,-93,93,125000,124700,12832,121768,98611
347.507792,4,90,50,40,-40,125000,124700,-1769,-19831,-9871
347.507792,5,1972,1999,-27,27,125000,124700,6514,-188814,-195537
347.507792,6,0,0,0,0,125000,124700,0,0,0
347.741878,0,515,615,-100,100,125000,124700,28711,230689,205789
347.741878,1,513,611,-98,98,125000,124700,28559,75641,51239
347.741878,2,3051,3084,-33,33,125000,124700,12469,-301069,-309286
347.741878,3,387,480,-93,93,125000,124700,12832,121768,98611
347.741878,4,90,50,40,-40,125000,124700,-1769,-19831,-9871
347.741878,5,1972,2009,-37,37,125000,124700,6689,-186989,-196202
347.741878,6,0,0,0,0,125000,124700,0,0,0
348.032189,0,515,615,-100,100,125000,124700,28711,230689,205789
348.032189,1,513,611,-98,98,125000,124700,28559,75641,51239
348.032189,2,3051,3084,-33,33,125000,124700,12469,-301069,-309286
348.032189,3,387,480,-93,93,125000,124700,12832,121768,98611
348.032189,4,90,50,40,-40,125000,124700,-1769,-19831,-9871
348.032189,5,1972,2009,-37,37,125000,124700,6689,-186989,-196202
348.032189,6,0,0,0,0,125000,124700,0,0,0
348.210691,0,515,615,-100,100,125000,124700,28711,230689,205789
348.210691,1,513,611,-98,98,125000,124700,28559,75641,51239
348.210691,2,3051,3084,-33,33,125000,124700,12469,-301069,-309286
348.210691,3,387,480,-93,93,125000,124700,12832,121768,98611
348.210691,4,90,50,40,-40,125000,124700,-1769,-19831,-9871
348.210691,5,1972,2009,-37,37,125000,124700,6689,-186989,-196202
348.210691,6,0,0,0,0,125000,124700,0,0,0
348.538168,0,515,615,-100,100,125000,124700,28711,230689,205789
348.538168,1,513,611,-98,98,125000,124700,28559,75641,51239
348.538168,2,3051,3084,-33,33,125000,124700,12469,-301069,-309286
348.538168,3,387,480,-93,93,125000,124700,12832,121768,98611
348.538168,4,90,50,40,-40,125000,124700,-1769,-19831,-9871
348.538168,5,1972,2009,-37,37,125000,124700,6689,-186989,-196202
348.538168,6,0,0,0,0,125000,124700,0,0,0
348.753359,0,515,615,-100,100,125400,124700,28711,230689,205789
348.753359,1,513,611,-98,98,125400,124700,28559,75641,51239
348.753359,2,3051,3094,-43,43,125400,124700,12344,-297944,-308651
348.753359,3,387,480,-93,93,125400,124700,12832,121768,98611
348.753359,4,90,50,40,-40,125400,124700,-1769,-19831,-9871
348.753359,5,1972,2019,-47,47,125400,124700,6564,-183864,-195567
348.753359,6,0,0,0,0,125400,124700,0,0,0
348.950459,0,515,615,-100,100,125400,124700,28711,230689,205789
348.950459,1,513,611,-98,98,125400,124700,28559,75641,51239
348.950459,2,3051,3094,-43,43,125400,124700,12344,-297944,-308651
348.950459,3,387,480,-93,93,125400,124700,12832,121768,98611
348.950459,4,90,50,40,-40,125400,124700,-1769,-19831,-9871
348.950459,5,1972,2019,-47,47,125400,124700,6564,-183864,-195567
348.950459,6,0,0,0,0,125400,124700,0,0,0
349.278615,0,515,615,-100,100,125300,125000,28711,230689,205689
349.278615,1,513,611,-98,98,125300,125000,28559,75641,51141
349.278615,2,3051,3104,-53,53,125300,125000,12595,-293195,-306445
349.278615,3,387,480,-93,93,125300,125000,12832,121768,98518
349.278615,4,90,50,40,-40,125300,125000,-1769,-19831,-9831
349.278615,5,1982,2019,-37,37,125300,125000,6439,-189739,-198989
349.278615,6,0,0,0,0,125300,125000,0,0,0
349.541473,0,515,615,-100,100,125200,125000,28711,230689,210689
349.541473,1,513,611,-98,98,125200,125000,28559,75641,56041
349.541473,2,3061,3104,-43,43,125200,125000,12470,-299070,-307670
349.541473,3,387,480,-93,93,125200,125000,12832,121768,103168
349.541473,4,90,50,40,-40,125200,125000,-1769,-19831,-11831
349.541473,5,1986,2019,-33,33,125200,125000,6389,-191689,-198289
349.541473,6,0,0,0,0,125200,125000,0,0,0
349.796493,0,515,615,-100,100,124500,125000,28711,230689,255689
349.796493,1,513,611,-98,98,124500,125000,28559,75641,100141
349.796493,2,3061,3104,-43,43,124500,125000,12470,-299070,-288320
349.796493,3,387,480,-93,93,124500,125000,12832,121768,145018
349.796493,4,90,50,40,-40,124500,125000,-1769,-19831,-29831
349.796493,5,1992,2019,-27,27,124500,125000,6314,-194614,-187864
349.796493,6,0,0,0,0,124500,125000,0,0,0
350.01563,0,515,615,-100,100,124500,125000,28711,230689,255689
350.01563,1,513,611,-98,98,124500,125000,28559,75641,100141
350.01563,2,3061,3104,-43,43,124500,125000,12470,-299070,-288320
350.01563,3,387,480,-93,93,124500,125000,12832,121768,145018
350.01563,4,90,50,40,-40,124500,125000,-1769,-19831,-29831
350.01563,5,1992,2019,-27,27,124500,125000,6314,-194614,-187864
350.01563,6,0,0,0,0,124500,125000,0,0,0
350.214256,0,515,615,-100,100,124500,125000,28711,230689,255689
350.214256,1,513,611,-98,98,124500,125000,28559,75641,100141
350.214256,2,3061,3104,-43,43,124500,125000,12470,-299070,-288320
350.214256,3,387,480,-93,93,124500,125000,12832,121768,145018
350.214256,4,90,50,40,-40,124500,125000,-1769,-19831,-29831
350.214256,5,1992,2019,-27,27,124500,125000,6314,-194614,-187864
350.214256,6,0,0,0,0,124500,125000,0,0,0
350.494068,0,515,615,-100,100,124800,124700,28711,230689,220689
350.494068,1,513,611,-98,98,124800,124700,28559,75641,65841
350.494068,2,3071,3104,-33,33,124800,124700,12345,-304945,-308245
350.494068,3,387,480,-93,93,124800,124700,12832,121768,112468
350.494068,4,90,50,40,-40,124800,124700,-1769,-19831,-15831
350.494068,5,2002,2019,-17,17,124800,124700,6189,-199489,-201189
350.494068,6,0,0,0,0,124800,124700,0,0,0
350.728728,0,515,615,-100,100,124800,124700,28711,230689,220689
350.728728,1,513,611,-98,98,124800,124700,28559,75641,65841
350.728728,2,3077,3104,-27,27,124800,124700,12495,-307495,-310195
350.728728,3,387,480,-93,93,124800,124700,12832,121768,112468
350.728728,4,90,50,40,-40,124800,124700,-1769,-19831,-15831
350.728728,5,2002,2019,-17,17,124800,124700,6189,-199489,-201189
350.728728,6,0,0,0,0,124800,124700,0,0,0
350.956412,0,515,615,-100,100,124800,124700,28711,230689,220689
350.956412,1,513,611,-98,98,124800,124700,28559,75641,65841
350.956412,2,3077,3104,-27,27,124800,124700,12495,-307495,-310195
350.956412,3,387,480,-93,93,124800,124700,12832,121768,112468
350.956412,4,90,50,40,-40,124800,124700,-1769,-19831,-15831
350.956412,5,2002,2019,-17,17,124800,124700,6189,-199489,-201189
350.956412,6,0,0,0,0,124800,124700,0,0,0
351.266999,0,515,615,-100,100,124800,124700,28711,230689,220689
351.266999,1,513,611,-98,98,124800,124700,28559,75641,65841
351.266999,2,3077,3104,-27,27,124800,124700,12495,-307495,-310195
351.266999,3,387,480,-93,93,124800,124700,12832,121768,112468
351.266999,4,90,50,40,-40,124800,124700,-1769,-19831,-15831
351.266999,5,2002,2019,-17,17,124800,124700,6189,-199489,-201189
351.266999,6,0,0,0,0,124800,124700,0,0,0
351.519399,0,515,615,-100,100,124800,124700,28711,230689,220689
351.519399,1,513,611,-98,98,124800,124700,28559,75641,65841
351.519399,2,3077,3104,-27,27,124800,124700,12495,-307495,-310195
351.519399,3,387,480,-93,93,124800,124700,12832,121768,112468
351.519399,4,90,50,40,-40,124800,124700,-1769,-19831,-15831
351.519399,5,2002,2019,-17,17,124800,124700,6189,-199489,-201189
351.519399,6,0,0,0,0,124800,124700,0,0,0
351.76167,0,515,615,-100,100,124800,124500,28711,230689,205789
351.76167,1,513,611,-98,98,124800,124500,28559,75641,51239
351.76167,2,3077,3104,-27,27,124800,124500,12495,-307495,-314218
351.76167,3,387,480,-93,93,124800,124500,12832,121768,98611
351.76167,4,90,50,40,-40,124800,124500,-1769,-19831,-9871
351.76167,5,2002,2019,-17,17,124800,124500,6189,-199489,-203722
351.76167,6,0,0,0,0,124800,124500,0,0,0
352.041159,0,515,615,-100,100,124800,124500,28711,230689,205789
352.041159,1,513,611,-98,98,124800,124500,28559,75641,51239
352.041159,2,3077,3104,-27,27,124800,124500,12495,-307495,-314218
352.041159,3,387,480,-93,93,124800,124500,12832,121768,98611
352.041159,4,90,50,40,-40,124800,124500,-1769,-19831,-9871
352.041159,5,2002,2019,-17,17,124800,124500,6189,-199489,-203722
352.041159,6,0,0,0,0,124800,124500,0,0,0
352.292508,0,515,615,-100,100,124800,124500,28711,230689,205789
352.292508,1,513,611,-98,98,124800,124500,28559,75641,51239
352.292508,2,3077,3104,-27,27,124800,124500,12495,-307495,-314218
352.292508,3,387,480,-93,93,124800,124500,12832,121768,98611
352.292508,4,90,50,40,-40,124800,124500,-1769,-19831,-9871
352.292508,5,2002,2019,-17,17,124800,124500,6189,-199489,-203722
352.292508,6,0,0,0,0,124800,124500,0,0,0
352.524101,0,515,615,-100,100,124800,124400,28711,230689,205789
352.524101,1,513,611,-98,98,124800,124400,28559,75641,51239
352.524101,2,3077,3104,-27,27,124800,124400,12495,-307495,-314218
352.524101,3,387,480,-93,93,124800,124400,12832,121768,98611
352.524101,4,90,50,40,-40,124800,124400,-1769,-19831,-9871
352.524101,5,2002,2019,-17,17,124800,124400,6189,-199489,-203722
352.524101,6,0,0,0,0,124800,124400,0,0,0
352.701898,0,515,615,-100,100,124500,124400,28711,230689,220689
352.701898,1,513,611,-98,98,124500,124400,28559,75641,65841
352.701898,2,3087,3104,-17,17,124500,124400,12370,-310370,-312070
352.701898,3,387,480,-93,93,124500,124400,12832,121768,112468
352.701898,4,90,50,40,-40,124500,124400,-1769,-19831,-15831
352.701898,5,2012,2019,-7,7,124500,124400,6064,-202364,-203064
352.701898,6,0,0,0,0,124500,124400,0,0,0
353.017237,0,515,615,-100,100,124500,124400,28711,230689,220689
353.017237,1,513,611,-98,98,124500,124400,28559,75641,65841
353.017237,2,3087,3104,-17,17,124500,124400,12370,-310370,-312070
353.017237,3,387,480,-93,93,124500,124400,12832,121768,112468
353.017237,4,90,50,40,-40,124500,124400,-1769,-19831,-15831
353.017237,5,2012,2019,-7,7,124500,124400,6064,-202364,-203064
353.017237,6,0,0,0,0,124500,124400,0,0,0
353.295069,0,515,615,-100,100,124500,124400,28711,230689,220689
353.295069,1,513,611,-98,98,124500,124400,28559,75641,65841
353.295069,2,3087,3104,-17,17,124500,124400,12370,-310370,-312070
353.295069,3,387,480,-93,93,124500,124400,12832,121768,112468
353.295069,4,90,50,40,-40,124500,124400,-1769,-19831,-15831
353.295069,5,2012,2019,-7,7,124500,124400,6064,-202364,-203064
353.295069,6,0,0,0,0,124500,124400,0,0,0
353.514655,0,515,615,-100,100,124600,124400,28711,230689,210689
353.514655,1,513,611,-98,98,124600,124400,28559,75641,56041
353.514655,2,3097,3104,-7,7,124600,124400,12619,-312619,-314019
353.514655,3,387,480,-93,93,124600,124400,12832,121768,103168
353.514655,4,90,50,40,-40,124600,124400,-1769,-19831,-11831
353.514655,5,2012,2029,-17,17,124600,124400,5939,-202239,-205639
353.514655,6,0,0,0,0,124600,124400,0,0,0
353.786835,0,515,615,-100,100,124500,124400,28711,230689,220689
353.786835,1,513,611,-98,98,124500,124400,28559,75641,65841
353.786835,2,3097,3114,-17,17,124500,124400,12868,-311868,-313568
353.786835,3,387,480,-93,93,124500,124400,12832,121768,112468
353.786835,4,90,50,40,-40,124500,124400,-1769,-19831,-15831
353.786835,5,2022,2029,-7,7,124500,124400,5814,-205114,-205814
353.786835,6,0,0,0,0,124500,124400,0,0,0
353.989069,0,515,615,-100,100,124500,124400,28711,230689,220689
353.989069,1,513,611,-98,98,124500,124400,28559,75641,65841
353.989069,2,3097,3114,-17,17,124500,124400,12868,-311868,-313568
353.989069,3,387,480,-93,93,124500,124400,12832,121768,112468
353.989069,4,90,50,40,-40,124500,124400,-1769,-19831,-15831
353.989069,5,2022,2029,-7,7,124500,124400,5814,-205114,-205814
353.989069,6,0,0,0,0,124500,124400,0,0,0
354.298754,0,515,615,-100,100,124500,124400,28711,230689,220689
354.298754,1,513,611,-98,98,124500,124400,28559,75641,65841
354.298754,2,3097,3114,-17,17,124500,124400,12868,-311868,-313568
354.298754,3,387,480,-93,93,124500,124400,12832,121768,112468
354.298754,4,90,50,40,-40,124500,124400,-1769,-19831,-15831
354.298754,5,2022,2029,-7,7,124500,124400,5814,-205114,-205814
354.298754,6,0,0,0,0,124500,124400,0,0,0
354.47464,0,515,615,-100,100,124500,124400,28711,230689,220689
354.47464,1,513,611,-98,98,124500,124400,28559,75641,65841
354.47464,2,3097,3114,-17,17,124500,124400,12868,-311868,-313568
354.47464,3,387,480,-93,93,124500,124400,12832,121768,112468
354.47464,4,90,50,40,-40,124500,124400,-1769,-19831,-15831
354.47464,5,2022,2029,-7,7,124500,124400,5814,-205114,-205814
354.47464,6,0,0,0,0,124500,124400,0,0,0
354.750431,0,515,615,-100,100,124500,124500,28711,230689,230689
354.750431,1,513,611,-98,98,124500,124500,28559,75641,75641
354.750431,2,3097,3114,-17,17,124500,124500,12868,-311868,-311868
354.750431,3,387,480,-93,93,124500,124500,12832,121768,121768
354.750431,4,90,50,40,-40,124500,124500,-1769,-19831,-19831
354.750431,5,2022,2029,-7,7,124500,124500,5814,-205114,-205114
354.750431,6,0,0,0,0,124500,124500,0,0,0
354.967535,0,515,615,-100,100,124700,124500,28711,230689,210689
354.967535,1,513,611,-98,98,124700,124500,28559,75641,56041
354.967535,2,3107,3114,-7,7,124700,124500,12743,-314743,-316143
354.967535,3,387,480,-93,93,124700,124500,12832,121768,103168
354.967535,4,90,50,40,-40,124700,124500,-1769,-19831,-11831
354.967535,5,2022,2039,-17,17,124700,124500,6063,-203363,-206763
354.967535,6,0,0,0,0,124700,124500,0,0,0
355.23296,0,515,615,-100,100,124700,124500,28711,230689,210689
355.23296,1,513,611,-98,98,124700,124500,28559,75641,56041
355.23296,2,3107,3124,-17,17,124700,124500,12618,-313618,-317018
355.23296,3,387,480,-93,93,124700,124500,12832,121768,103168
355.23296,4,90,50,40,-40,124700,124500,-1769,-19831,-11831
355.23296,5,2032,2039,-7,7,124700,124500,6312,-205612,-207012
355.23296,6,0,0,0,0,124700,124500,0,0,0
355.53644,0,515,615,-100,100,124700,124500,28711,230689,210689
355.53644,1,513,611,-98,98,124700,124500,28559,75641,56041
355.53644,2,3127,3124,3,-3,124700,124500,12742,-316742,-316142
355.53644,3,387,480,-93,93,124700,124500,12832,121768,103168
355.53644,4,90,50,40,-40,124700,124500,-1769,-19831,-11831
355.53644,5,2032,2049,-17,17,124700,124500,6187,-204487,-207887
355.53644,6,0,0,0,0,124700,124500,0,0,0
355.795349,0,515,615,-100,100,125200,124500,28711,230689,205789
355.795349,1,513,611,-98,98,125200,124500,28559,75641,51239
355.795349,2,3127,3134,-7,7,125200,124500,12991,-316991,-318734
355.795349,3,387,480,-93,93,125200,124500,12832,121768,98611
355.795349,4,90,50,40,-40,125200,124500,-1769,-19831,-9871
355.795349,5,2042,2059,-17,17,125200,124500,5938,-205238,-209471
355.795349,6,0,0,0,0,125200,124500,0,0,0
356.021653,0,515,615,-100,100,124800,124500,28711,230689,205789
356.021653,1,513,611,-98,98,124800,124500,28559,75641,51239
356.021653,2,3127,3144,-17,17,124800,124500,13241,-316241,-320474
356.021653,3,387,480,-93,93,124800,124500,12832,121768,98611
356.021653,4,90,50,40,-40,124800,124500,-1769,-19831,-9871
356.021653,5,2052,2059,-7,7,124800,124500,5813,-208113,-209856
356.021653,6,0,0,0,0,124800,124500,0,0,0
356.277943,0,515,615,-100,100,124800,124500,28711,230689,205789
356.277943,1,513,611,-98,98,124800,124500,28559,75641,51239
356.277943,2,3127,3144,-17,17,124800,124500,13241,-316241,-320474
356.277943,3,387,480,-93,93,124800,124500,12832,121768,98611
356.277943,4,90,50,40,-40,124800,124500,-1769,-19831,-9871
356.277943,5,2052,2059,-7,7,124800,124500,5813,-208113,-209856
356.277943,6,0,0,0,0,124800,124500,0,0,0
356.54633,0,515,615,-100,100,124800,124400,28711,230689,205789
356.54633,1,513,611,-98,98,124800,124400,28559,75641,51239
356.54633,2,3127,3144,-17,17,124800,124400,13241,-316241,-320474
356.54633,3,387,480,-93,93,124800,124400,12832,121768,98611
356.54633,4,90,50,40,-40,124800,124400,-1769,-19831,-9871
356.54633,5,2052,2059,-7,7,124800,124400,5813,-208113,-209856
356.54633,6,0,0,0,0,124800,124400,0,0,0
356.759997,0,515,615,-100,100,124400,124400,28711,230689,230689
356.759997,1,513,611,-98,98,124400,124400,28559,75641,75641
356.759997,2,3137,3144,-7,7,124400,124400,13116,-318116,-318116
356.759997,3,387,480,-93,93,124400,124400,12832,121768,121768
356.759997,4,90,50,40,-40,124400,124400,-1769,-19831,-19831
356.759997,5,2062,2059,3,-3,124400,124400,5688,-209988,-209988
356.759997,6,0,0,0,0,124400,124400,0,0,0
357.019225,0,515,615,-100,100,124400,124000,28711,230689,205889
357.019225,1,513,611,-98,98,124400,124000,28559,75641,51337
357.019225,2,3137,3144,-7,7,124400,124000,13116,-318116,-319852
357.019225,3,387,480,-93,93,124400,124000,12832,121768,98704
357.019225,4,90,50,40,-40,124400,124000,-1769,-19831,-9911
357.019225,5,2062,2059,3,-3,124400,124000,5688,-209988,-209244
357.019225,6,0,0,0,0,124400,124000,0,0,0
357.249207,0,515,615,-100,100,124300,124300,28711,230689,230689
357.249207,1,513,611,-98,98,124300,124300,28559,75641,75641
357.249207,2,3137,3154,-17,17,124300,124300,13365,-317365,-317365
357.249207,3,387,480,-93,93,124300,124300,12832,121768,121768
357.249207,4,90,50,40,-40,124300,124300,-1769,-19831,-19831
357.249207,5,2062,2059,3,-3,124300,124300,5688,-209988,-209988
357.249207,6,0,0,0,0,124300,124300,0,0,0
357.481465,0,515,615,-100,100,124300,124300,28711,230689,230689
357.481465,1,513,611,-98,98,124300,124300,28559,75641,75641
357.481465,2,3137,3154,-17,17,124300,124300,13365,-317365,-317365
357.481465,3,387,480,-93,93,124300,124300,12832,121768,121768
357.481465,4,90,50,40,-40,124300,124300,-1769,-19831,-19831
357.481465,5,2062,2059,3,-3,124300,124300,5688,-209988,-209988
357.481465,6,0,0,0,0,124300,124300,0,0,0
357.789547,0,515,615,-100,100,125000,124300,28711,230689,205789
357.789547,1,513,611,-98,98,125000,124300,28559,75641,51239
357.789547,2,3147,3164,-17,17,125000,124300,13489,-317489,-321722
357.789547,3,387,480,-93,93,125000,124300,12832,121768,98611
357.789547,4,90,50,40,-40,125000,124300,-1769,-19831,-9871
357.789547,5,2062,2069,-7,7,125000,124300,5564,-208864,-210607
357.789547,6,0,0,0,0,125000,124300,0,0,0
357.950755,0,515,615,-100,100,125000,124300,28711,230689,205789
357.950755,1,513,611,-98,98,125000,124300,28559,75641,51239
357.950755,2,3147,3164,-17,17,125000,124300,13489,-317489,-321722
357.950755,3,387,480,-93,93,125000,124300,12832,121768,98611
357.950755,4,90,50,40,-40,125000,124300,-1769,-19831,-9871
357.950755,5,2062,2069,-7,7,125000,124300,5564,-208864,-210607
357.950755,6,0,0,0,0,125000,124300,0,0,0
358.224377,0,515,615,-100,100,124500,124400,28711,230689,220689
358.224377,1,513,611,-98,98,124500,124400,28559,75641,65841
358.224377,2,3157,3164,-7,7,124500,124400,13738,-319738,-320438
358.224377,3,387,480,-93,93,124500,124400,12832,121768,112468
358.224377,4,90,50,40,-40,124500,124400,-1769,-19831,-15831
358.224377,5,2062,2079,-17,17,124500,124400,5440,-207740,-209440
358.224377,6,0,0,0,0,124500,124400,0,0,0
358.45643,0,515,615,-100,100,124500,124400,28711,230689,220689
358.45643,1,513,611,-98,98,124500,124400,28559,75641,65841
358.45643,2,3157,3164,-7,7,124500,124400,13738,-319738,-320438
358.45643,3,387,480,-93,93,124500,124400,12832,121768,112468
358.45643,4,90,50,40,-40,124500,124400,-1769,-19831,-15831
358.45643,5,2062,2079,-17,17,124500,124400,5440,-207740,-209440
358.45643,6,0,0,0,0,124500,124400,0,0,0
358.725657,0,515,615,-100,100,124500,124500,28711,230689,230689
358.725657,1,513,611,-98,98,124500,124500,28559,75641,75641
358.725657,2,3157,3164,-7,7,124500,124500,13738,-319738,-319738
358.725657,3,387,480,-93,93,124500,124500,12832,121768,121768
358.725657,4,90,50,40,-40,124500,124500,-1769,-19831,-19831
358.725657,5,2062,2079,-17,17,124500,124500,5440,-207740,-207740
358.725657,6,0,0,0,0,124500,124500,0,0,0
358.981225,0,515,615,-100,100,124600,124500,28711,230689,220689
358.981225,1,513,611,-98,98,124600,124500,28559,75641,65841
358.981225,2,3157,3174,-17,17,124600,124500,13613,-318613,-320313
358.981225,3,387,480,-93,93,124600,124500,12832,121768,112468
358.981225,4,90,50,40,-40,124600,124500,-1769,-19831,-15831
358.981225,5,2072,2079,-7,7,124600,124500,5689,-209989,-210689
358.981225,6,0,0,0,0,124600,124500,0,0,0
359.226679,0,515,615,-100,100,124600,124500,28711,230689,220689
359.226679,1,513,611,-98,98,124600,124500,28559,75641,65841
359.226679,2,3157,3174,-17,17,124600,124500,13613,-318613,-320313
359.226679,3,387,480,-93,93,124600,124500,12832,121768,112468
359.226679,4,90,50,40,-40,124600,124500,-1769,-19831,-15831
359.226679,5,2072,2079,-7,7,124600,124500,5689,-209989,-210689
359.226679,6,0,0,0,0,124600,124500,0,0,0
359.499401,0,515,615,-100,100,124200,124500,28711,230689,255589
359.499401,1,513,611,-98,98,124200,124500,28559,75641,100043
359.499401,2,3167,3174,-7,7,124200,124500,13862,-320862,-319119
359.499401,3,387,480,-93,93,124200,124500,12832,121768,144925
359.499401,4,90,50,40,-40,124200,124500,-1769,-19831,-29791
359.499401,5,2082,2089,-7,7,124200,124500,5440,-209740,-207997
359.499401,6,0,0,0,0,124200,124500,0,0,0
359.783654,0,515,615,-100,100,124700,124500,28711,230689,210689
359.783654,1,513,611,-98,98,124700,124500,28559,75641,56041
359.783654,2,3167,3184,-17,17,124700,124500,14111,-320111,-323511
359.783654,3,387,480,-93,93,124700,124500,12832,121768,103168
359.783654,4,90,50,40,-40,124700,124500,-1769,-19831,-11831
359.783654,5,2092,2089,3,-3,124700,124500,5315,-211615,-211015
359.783654,6,0,0,0,0,124700,124500,0,0,0
359.995788,0,515,615,-100,100,124700,124500,28711,230689,210689
359.995788,1,513,611,-98,98,124700,124500,28559,75641,56041
359.995788,2,3167,3184,-17,17,124700,124500,14111,-320111,-323511
359.995788,3,387,480,-93,93,124700,124500,12832,121768,103168
359.995788,4,90,50,40,-40,124700,124500,-1769,-19831,-11831
359.995788,5,2092,2089,3,-3,124700,124500,5315,-211615,-211015
359.995788,6,0,0,0,0,124700,124500,0,0,0
360.276642,0,515,615,-100,100,124500,124500,28711,230689,230689
360.276642,1,513,611,-98,98,124500,124500,28559,75641,75641
360.276642,2,3177,3184,-7,7,124500,124500,13987,-320987,-320987
360.276642,3,387,480,-93,93,124500,124500,12832,121768,121768
360.276642,4,90,50,40,-40,124500,124500,-1769,-19831,-19831
360.276642,5,2092,2099,-7,7,124500,124500,5564,-212864,-212864
360.276642,6,0,0,0,0,124500,124500,0,0,0
360.525856,0,515,615,-100,100,124500,124500,28711,230689,230689
360.525856,1,513,611,-98,98,124500,124500,28559,75641,75641
360.525856,2,3177,3184,-7,7,124500,124500,13987,-320987,-320987
360.525856,3,387,480,-93,93,124500,124500,12832,121768,121768
360.525856,4,90,50,40,-40,124500,124500,-1769,-19831,-19831
360.525856,5,2092,2099,-7,7,124500,124500,5564,-212864,-212864
360.525856,6,0,0,0,0,124500,124500,0,0,0
360.757272,0,515,615,-100,100,124500,124300,28711,230689,210689
360.757272,1,513,611,-98,98,124500,124300,28559,75641,56041
360.757272,2,3177,3184,-7,7,124500,124300,13987,-320987,-322387
360.757272,3,387,480,-93,93,124500,124300,12832,121768,103168
360.757272,4,90,50,40,-40,124500,124300,-1769,-19831,-11831
360.757272,5,2092,2099,-7,7,124500,124300,5564,-212864,-214264
360.757272,6,0,0,0,0,124500,124300,0,0,0
360.998826,0,515,615,-100,100,124100,124500,28711,230689,255589
360.998826,1,513,611,-98,98,124100,124500,28559,75641,100043
360.998826,2,3187,3184,3,-3,124100,124500,13863,-319863,-320610
360.998826,3,387,480,-93,93,124100,124500,12832,121768,144925
360.998826,4,90,50,40,-40,124100,124500,-1769,-19831,-29791
360.998826,5,2102,2099,3,-3,124100,124500,5440,-211740,-212487
360.998826,6,0,0,0,0,124100,124500,0,0,0
361.282257,0,515,615,-100,100,124700,124500,28711,230689,210689
361.282257,1,513,611,-98,98,124700,124500,28559,75641,56041
361.282257,2,3187,3200,-13,13,124700,124500,13664,-321664,-324264
361.282257,3,403,480,-77,77,124700,124500,13231,119169,103769
361.282257,4,90,50,40,-40,124700,124500,-1769,-19831,-11831
361.282257,5,2112,2109,3,-3,124700,124500,5564,-212864,-212264
361.282257,6,0,0,0,0,124700,124500,0,0,0
361.544512,0,515,615,-100,100,125200,124500,28711,230689,205789
361.544512,1,513,611,-98,98,125200,124500,28559,75641,51239
361.544512,2,3187,3210,-23,23,125200,124500,13539,-319539,-325266
361.544512,3,403,482,-79,79,125200,124500,13206,119794,100123
361.544512,4,90,50,40,-40,125200,124500,-1769,-19831,-9871
361.544512,5,2112,2109,3,-3,125200,124500,5564,-212864,-212117
361.544512,6,0,0,0,0,125200,124500,0,0,0
361.732371,0,515,615,-100,100,124800,124500,28711,230689,205789
361.732371,1,513,611,-98,98,124800,124500,28559,75641,51239
361.732371,2,3197,3210,-13,13,124800,124500,13414,-322414,-325651
361.732371,3,403,482,-79,79,124800,124500,13206,119794,100123
361.732371,4,90,50,40,-40,124800,124500,-1769,-19831,-9871
361.732371,5,2112,2109,3,-3,124800,124500,5564,-212864,-212117
361.732371,6,0,0,0,0,124800,124500,0,0,0
362.032277,0,515,615,-100,100,124800,124500,28711,230689,205789
362.032277,1,513,611,-98,98,124800,124500,28559,75641,51239
362.032277,2,3197,3210,-13,13,124800,124500,13414,-322414,-325651
362.032277,3,403,482,-79,79,124800,124500,13206,119794,100123
362.032277,4,90,50,40,-40,124800,124500,-1769,-19831,-9871
362.032277,5,2112,2109,3,-3,124800,124500,5564,-212864,-212117
362.032277,6,0,0,0,0,124800,124500,0,0,0
362.278278,0,515,615,-100,100,124800,124500,28711,230689,205789
362.278278,1,513,611,-98,98,124800,124500,28559,75641,51239
362.278278,2,3197,3210,-13,13,124800,124500,13414,-322414,-325651
362.278278,3,403,482,-79,79,124800,124500,13206,119794,100123
362.278278,4,90,50,40,-40,124800,124500,-1769,-19831,-9871
362.278278,5,2112,2109,3,-3,124800,124500,5564,-212864,-212117
362.278278,6,0,0,0,0,124800,124500,0,0,0
362.475525,0,515,615,-100,100,124800,124500,28711,230689,205789
362.475525,1,513,611,-98,98,124800,124500,28559,75641,51239
362.475525,2,3197,3210,-13,13,124800,124500,13414,-322414,-325651
362.475525,3,403,482,-79,79,124800,124500,13206,119794,100123
362.475525,4,90,50,40,-40,124800,124500,-1769,-19831,-9871
362.475525,5,2112,2109,3,-3,124800,124500,5564,-212864,-212117
362.475525,6,0,0,0,0,124800,124500,0,0,0
362.793149,0,515,615,-100,100,124800,124500,28711,230689,205789
362.793149,1,513,611,-98,98,124800,124500,28559,75641,51239
362.793149,2,3197,3210,-13,13,124800,124500,13414,-322414,-325651
362.793149,3,403,482,-79,79,124800,124500,13206,119794,100123
362.793149,4,90,50,40,-40,124800,124500,-1769,-19831,-9871
362.793149,5,2112,2109,3,-3,124800,124500,5564,-212864,-212117
362.793149,6,0,0,0,0,124800,124500,0,0,0
362.95739,0,515,615,-100,100,124800,124500,28711,230689,205789
362.95739,1,513,611,-98,98,124800,124500,28559,75641,51239
362.95739,2,3207,3220,-13,13,124800,124500,13164,-322164,-325401
362.95739,3,403,482,-79,79,124800,124500,13206,119794,100123
362.95739,4,90,50,40,-40,124800,124500,-1769,-19831,-9871
362.95739,5,2112,2119,-7,7,124800,124500,5813,-213113,-214856
362.95739,6,0,0,0,0,124800,124500,0,0,0
363.244023,0,515,615,-100,100,124800,124500,28711,230689,205789
363.244023,1,513,611,-98,98,124800,124500,28559,75641,51239
363.244023,2,3207,3220,-13,13,124800,124500,13164,-322164,-325401
363.244023,3,403,482,-79,79,124800,124500,13206,119794,100123
363.244023,4,90,50,40,-40,124800,124500,-1769,-19831,-9871
363.244023,5,2112,2119,-7,7,124800,124500,5813,-213113,-214856
363.244023,6,0,0,0,0,124800,124500,0,0,0
363.541365,0,515,615,-100,100,124800,124500,28711,230689,205789
363.541365,1,513,611,-98,98,124800,124500,28559,75641,51239
363.541365,2,3207,3220,-13,13,124800,124500,13164,-322164,-325401
363.541365,3,403,482,-79,79,124800,124500,13206,119794,100123
363.541365,4,90,50,40,-40,124800,124500,-1769,-19831,-9871
363.541365,5,2112,2119,-7,7,124800,124500,5813,-213113,-214856
363.541365,6,0,0,0,0,124800,124500,0,0,0
363.768415,0,515,615,-100,100,124000,124500,28711,230689,255589
363.768415,1,513,611,-98,98,124000,124500,28559,75641,100043
363.768415,2,3217,3220,-3,3,124000,124500,13039,-324039,-323292
363.768415,3,405,484,-79,79,124000,124500,13231,120569,140240
363.768415,4,100,50,50,-50,124000,124500,-1893,-15707,-28157
363.768415,5,2122,2119,3,-3,124000,124500,5688,-214988,-215735
363.768415,6,0,0,0,0,124000,124500,0,0,0
363.959705,0,515,615,-100,100,124000,124500,28711,230689,255589
363.959705,1,513,611,-98,98,124000,124500,28559,75641,100043
363.959705,2,3217,3220,-3,3,124000,124500,13039,-324039,-323292
363.959705,3,405,484,-79,79,124000,124500,13231,120569,140240
363.959705,4,100,50,50,-50,124000,124500,-1893,-15707,-28157
363.959705,5,2122,2119,3,-3,124000,124500,5688,-214988,-215735
363.959705,6,0,0,0,0,124000,124500,0,0,0
364.286636,0,515,615,-100,100,124200,124600,28711,230689,255589
364.286636,1,513,611,-98,98,124200,124600,28559,75641,100043
364.286636,2,3227,3220,7,-7,124200,124600,12914,-324914,-326657
364.286636,3,407,484,-77,77,124200,124600,13206,121194,140367
364.286636,4,100,50,50,-50,124200,124600,-1893,-15707,-28157
364.286636,5,2132,2119,13,-13,124200,124600,5563,-215863,-219100
364.286636,6,0,0,0,0,124200,124600,0,0,0
364.480445,0,545,615,-70,70,124200,124600,29456,238944,256374
364.480445,1,527,611,-84,84,124200,124600,28906,79494,100410
364.480445,2,3237,3220,17,-17,124200,124600,13162,-322162,-326395
364.480445,3,416,484,-68,68,124200,124600,13430,123670,140602
364.480445,4,100,50,50,-50,124200,124600,-1893,-15707,-28157
364.480445,5,2142,2119,23,-23,124200,124600,5811,-213111,-218838
364.480445,6,0,0,0,0,124200,124600,0,0,0
364.716216,0,545,615,-70,70,124500,124600,29456,238944,245944
364.716216,1,527,611,-84,84,124500,124600,28906,79494,87894
364.716216,2,3237,3220,17,-17,124500,124600,13162,-322162,-323862
364.716216,3,422,484,-62,62,124500,124600,13579,123521,129721
364.716216,4,100,50,50,-50,124500,124600,-1893,-15707,-20707
364.716216,5,2142,2119,23,-23,124500,124600,5811,-213111,-215411
364.716216,6,0,0,0,0,124500,124600,0,0,0
365.047248,0,545,615,-70,70,124500,124500,29456,238944,238944
365.047248,1,527,611,-84,84,124500,124500,28906,79494,79494
365.047248,2,3237,3220,17,-17,124500,124500,13162,-322162,-322162
365.047248,3,422,484,-62,62,124500,124500,13579,123521,123521
365.047248,4,100,50,50,-50,124500,124500,-1893,-15707,-15707
365.047248,5,2142,2119,23,-23,124500,124500,5811,-213111,-213111
365.047248,6,0,0,0,0,124500,124500,0,0,0
365.277739,0,545,615,-70,70,124400,124500,29456,238944,245944
365.277739,1,527,611,-84,84,124400,124500,28906,79494,87894
365.277739,2,3247,3220,27,-27,124400,124500,13038,-321038,-323738
365.277739,3,422,484,-62,62,124400,124500,13579,123521,129721
365.277739,4,100,50,50,-50,124400,124500,-1893,-15707,-20707
365.277739,5,2142,2129,13,-13,124400,124500,6060,-215360,-216660
365.277739,6,0,0,0,0,124400,124500,0,0,0
365.52867,0,545,615,-70,70,124300,124500,29456,238944,252944
365.52867,1,527,611,-84,84,124300,124500,28906,79494,96294
365.52867,2,3247,3230,17,-17,124300,124500,12914,-322914,-326314
365.52867,3,428,484,-56,56,124300,124500,13728,123972,135172
365.52867,4,100,50,50,-50,124300,124500,-1893,-15707,-25707
365.52867,5,2152,2135,17,-17,124300,124500,6234,-215734,-219134
365.52867,6,0,0,0,0,124300,124500,0,0,0
365.770122,0,545,615,-70,70,124500,124500,29456,238944,238944
365.770122,1,527,611,-84,84,124500,124500,28906,79494,79494
365.770122,2,3247,3230,17,-17,124500,124500,12914,-322914,-322914
365.770122,3,438,484,-46,46,124500,124500,13976,123724,123724
365.770122,4,100,50,50,-50,124500,124500,-1893,-15707,-15707
365.770122,5,2152,2135,17,-17,124500,124500,6234,-215734,-215734
365.770122,6,0,0,0,0,124500,124500,0,0,0
365.977823,0,545,615,-70,70,124500,124500,29456,238944,238944
365.977823,1,527,611,-84,84,124500,124500,28906,79494,79494
365.977823,2,3247,3230,17,-17,124500,124500,12914,-322914,-322914
365.977823,3,438,484,-46,46,124500,124500,13976,123724,123724
365.977823,4,100,50,50,-50,124500,124500,-1893,-15707,-15707
365.977823,5,2152,2135,17,-17,124500,124500,6234,-215734,-215734
365.977823,6,0,0,0,0,124500,124500,0,0,0
366.24028,0,545,615,-70,70,124500,124500,29456,238944,238944
366.24028,1,527,611,-84,84,124500,124500,28906,79494,79494
366.24028,2,3247,3230,17,-17,124500,124500,12914,-322914,-322914
366.24028,3,438,484,-46,46,124500,124500,13976,123724,123724
366.24028,4,100,50,50,-50,124500,124500,-1893,-15707,-15707
366.24028,5,2152,2135,17,-17,124500,124500,6234,-215734,-215734
366.24028,6,0,0,0,0,124500,124500,0,0,0
366.455004,0,545,615,-70,70,124000,124500,29456,238944,256374
366.455004,1,527,611,-84,84,124000,124500,28906,79494,100410
366.455004,2,3257,3240,17,-17,124000,124500,13039,-323039,-327272
366.455004,3,438,484,-46,46,124000,124500,13976,123724,135178
366.455004,4,100,50,50,-50,124000,124500,-1893,-15707,-28157
366.455004,5,2172,2135,37,-37,124000,124500,5986,-214486,-223699
366.455004,6,0,0,0,0,124000,124500,0,0,0
366.76093,0,545,615,-70,70,124200,124300,29456,238944,245944
366.76093,1,527,611,-84,84,124200,124300,28906,79494,87894
366.76093,2,3267,3240,27,-27,124200,124300,12915,-321915,-324615
366.76093,3,438,484,-46,46,124200,124300,13976,123724,128324
366.76093,4,100,50,50,-50,124200,124300,-1893,-15707,-20707
366.76093,5,2172,2145,27,-27,124200,124300,6234,-216734,-219434
366.76093,6,0,0,0,0,124200,124300,0,0,0
367.034597,0,545,615,-70,70,124500,124300,29456,238944,224944
367.034597,1,527,611,-84,84,124500,124300,28906,79494,62694
367.034597,2,3277,3250,27,-27,124500,124300,12667,-321667,-316267
367.034597,3,442,484,-42,42,124500,124300,14076,122824,114424
367.034597,4,100,50,50,-50,124500,124300,-1893,-15707,-5707
367.034597,5,2182,2155,27,-27,124500,124300,6730,-219230,-213830
367.034597,6,0,0,0,0,124500,124300,0,0,0
367.277568,0,545,615,-70,70,124100,124300,29456,238944,252944
367.277568,1,527,611,-84,84,124100,124300,28906,79494,96294
367.277568,2,3287,3260,27,-27,124100,124300,12419,-321419,-326819
367.277568,3,442,484,-42,42,124100,124300,14076,122824,131224
367.277568,4,100,50,50,-50,124100,124300,-1893,-15707,-25707
367.277568,5,2192,2165,27,-27,124100,124300,7226,-221726,-227126
367.277568,6,0,0,0,0,124100,124300,0,0,0
367.504814,0,545,615,-70,70,124000,124300,29456,238944,256374
367.504814,1,527,611,-84,84,124000,124300,28906,79494,100410
367.504814,2,3287,3270,17,-17,124000,124300,12295,-324295,-328528
367.504814,3,442,484,-42,42,124000,124300,14076,122824,133282
367.504814,4,100,50,50,-50,124000,124300,-1893,-15707,-28157
367.504814,5,2202,2175,27,-27,124000,124300,7722,-224222,-230945
367.504814,6,0,0,0,0,124000,124300,0,0,0
367.795635,0,545,615,-70,70,124000,124300,29456,238944,256374
367.795635,1,527,611,-84,84,124000,124300,28906,79494,100410
367.795635,2,3287,3270,17,-17,124000,124300,12295,-324295,-328528
367.795635,3,442,484,-42,42,124000,124300,14076,122824,133282
367.795635,4,100,50,50,-50,124000,124300,-1893,-15707,-28157
367.795635,5,2202,2175,27,-27,124000,124300,7722,-224222,-230945
367.795635,6,0,0,0,0,124000,124300,0,0,0
368.041526,0,545,615,-70,70,124000,124400,29456,238944,256374
368.041526,1,527,611,-84,84,124000,124400,28906,79494,100410
368.041526,2,3297,3280,17,-17,124000,124400,12046,-324046,-328279
368.041526,3,446,484,-38,38,124000,124400,14175,122725,132187
368.041526,4,100,50,50,-50,124000,124400,-1893,-15707,-28157
368.041526,5,2212,2175,37,-37,124000,124400,7598,-223098,-232311
368.041526,6,0,0,0,0,124000,124400,0,0,0
368.299429,0,545,615,-70,70,124400,124400,29456,238944,238944
368.299429,1,527,611,-84,84,124400,124400,28906,79494,79494
368.299429,2,3297,3280,17,-17,124400,124400,12046,-324046,-324046
368.299429,3,450,484,-34,34,124400,124400,14275,122225,122225
368.299429,4,100,50,50,-50,124400,124400,-1893,-15707,-15707
368.299429,5,2212,2175,37,-37,124400,124400,7598,-223098,-223098
368.299429,6,0,0,0,0,124400,124400,0,0,0
368.50976,0,545,615,-70,70,124400,124400,29456,238944,238944
368.50976,1,527,611,-84,84,124400,124400,28906,79494,79494
368.50976,2,3297,3280,17,-17,124400,124400,12046,-324046,-324046
368.50976,3,450,484,-34,34,124400,124400,14275,122225,122225
368.50976,4,100,50,50,-50,124400,124400,-1893,-15707,-15707
368.50976,5,2212,2175,37,-37,124400,124400,7598,-223098,-223098
368.50976,6,0,0,0,0,124400,124400,0,0,0
368.741164,0,545,615,-70,70,124200,124500,29456,238944,256374
368.741164,1,527,611,-84,84,124200,124500,28906,79494,100410
368.741164,2,3307,3280,27,-27,124200,124500,11922,-322922,-329645
368.741164,3,450,484,-34,34,124200,124500,14275,122225,130691
368.741164,4,100,50,50,-50,124200,124500,-1893,-15707,-28157
368.741164,5,2212,2185,27,-27,124200,124500,7846,-225346,-232069
368.741164,6,0,0,0,0,124200,124500,0,0,0
368.970409,0,545,615,-70,70,124300,124500,29456,238944,252944
368.970409,1,527,611,-84,84,124300,124500,28906,79494,96294
368.970409,2,3307,3283,24,-24,124300,124500,11885,-323485,-328285
368.970409,3,453,484,-31,31,124300,124500,14350,122150,128350
368.970409,4,100,50,50,-50,124300,124500,-1893,-15707,-25707
368.970409,5,2212,2185,27,-27,124300,124500,7846,-225346,-230746
368.970409,6,0,0,0,0,124300,124500,0,0,0
369.207637,0,545,615,-70,70,124300,124400,29456,238944,245944
369.207637,1,527,611,-84,84,124300,124400,28906,79494,87894
369.207637,2,3307,3293,14,-14,124300,124400,12133,-325733,-327133
369.207637,3,459,484,-25,25,124300,124400,14500,122000,124500
369.207637,4,100,50,50,-50,124300,124400,-1893,-15707,-20707
369.207637,5,2222,2191,31,-31,124300,124400,7648,-224748,-227848
369.207637,6,0,0,0,0,124300,124400,0,0,0
369.480284,0,545,615,-70,70,124300,124400,29456,238944,245944
369.480284,1,531,611,-80,80,124300,124400,29005,79795,87795
369.480284,2,3317,3298,19,-19,124300,124400,12095,-325195,-327095
369.480284,3,465,484,-19,19,124300,124400,14650,121850,123750
369.480284,4,100,50,50,-50,124300,124400,-1893,-15707,-20707
369.480284,5,2222,2205,17,-17,124300,124400,7697,-227597,-229297
369.480284,6,0,0,0,0,124300,124400,0,0,0
369.750381,0,545,615,-70,70,124300,124400,29456,238944,245944
369.750381,1,531,611,-80,80,124300,124400,29005,79795,87795
369.750381,2,3317,3298,19,-19,124300,124400,12095,-325195,-327095
369.750381,3,465,484,-19,19,124300,124400,14650,121850,123750
369.750381,4,100,50,50,-50,124300,124400,-1893,-15707,-20707
369.750381,5,2222,2205,17,-17,124300,124400,7697,-227597,-229297
369.750381,6,0,0,0,0,124300,124400,0,0,0
370.015734,0,545,615,-70,70,124300,124500,29456,238944,252944
370.015734,1,531,611,-80,80,124300,124500,29005,79795,95795
370.015734,2,3317,3298,19,-19,124300,124500,12095,-325195,-328995
370.015734,3,465,484,-19,19,124300,124500,14650,121850,125650
370.015734,4,100,50,50,-50,124300,124500,-1893,-15707,-25707
370.015734,5,2222,2205,17,-17,124300,124500,7697,-227597,-230997
370.015734,6,0,0,0,0,124300,124500,0,0,0
370.241416,0,545,615,-70,70,124400,124400,29456,238944,238944
370.241416,1,531,611,-80,80,124400,124400,29005,79795,79795
370.241416,2,3317,3303,14,-14,124400,124400,12033,-325633,-325633
370.241416,3,465,484,-19,19,124400,124400,14650,121850,121850
370.241416,4,100,50,50,-50,124400,124400,-1893,-15707,-15707
370.241416,5,2227,2205,22,-22,124400,124400,7821,-227721,-227721
370.241416,6,0,0,0,0,124400,124400,0,0,0
370.519346,0,545,615,-70,70,124300,124400,29456,238944,245944
370.519346,1,531,611,-80,80,124300,124400,29005,79795,87795
370.519346,2,3317,3313,4,-4,124300,124400,12281,-326381,-326781
370.519346,3,465,484,-19,19,124300,124400,14650,121850,123750
370.519346,4,100,50,50,-50,124300,124400,-1893,-15707,-20707
370.519346,5,2232,2205,27,-27,124300,124400,7759,-228159,-230859
370.519346,6,0,0,0,0,124300,124400,0,0,0
370.766668,0,545,615,-70,70,124300,124200,29456,238944,231944
370.766668,1,531,611,-80,80,124300,124200,29005,79795,71795
370.766668,2,3317,3323,-6,6,124300,124200,12530,-326630,-327230
370.766668,3,465,484,-19,19,124300,124200,14650,121850,119950
370.766668,4,100,50,50,-50,124300,124200,-1893,-15707,-10707
370.766668,5,2232,2205,27,-27,124300,124200,7759,-228159,-225459
370.766668,6,0,0,0,0,124300,124200,0,0,0
370.959872,0,545,615,-70,70,124300,124200,29456,238944,231944
370.959872,1,531,611,-80,80,124300,124200,29005,79795,71795
370.959872,2,3317,3326,-9,9,124300,124200,12605,-326405,-327305
370.959872,3,465,484,-19,19,124300,124200,14650,121850,119950
370.959872,4,100,50,50,-50,124300,124200,-1893,-15707,-10707
370.959872,5,2232,2205,27,-27,124300,124200,7759,-228159,-225459
370.959872,6,0,0,0,0,124300,124200,0,0,0
371.267211,0,545,645,-100,100,124200,123900,30201,244199,219399
371.267211,1,531,611,-80,80,124200,123900,29005,79795,59955
371.267211,2,3317,3326,-9,9,124200,123900,12605,-326405,-328637
371.267211,3,465,484,-19,19,124200,123900,14650,121850,117138
371.267211,4,100,50,50,-50,124200,123900,-1893,-15707,-3307
371.267211,5,2232,2205,27,-27,124200,123900,7759,-228159,-221463
371.267211,6,0,0,0,0,124200,123900,0,0,0
371.488964,0,545,645,-100,100,124200,123900,30201,244199,219399
371.488964,1,531,611,-80,80,124200,123900,29005,79795,59955
371.488964,2,3317,3326,-9,9,124200,123900,12605,-326405,-328637
371.488964,3,465,484,-19,19,124200,123900,14650,121850,117138
371.488964,4,100,50,50,-50,124200,123900,-1893,-15707,-3307
371.488964,5,2232,2205,27,-27,124200,123900,7759,-228159,-221463
371.488964,6,0,0,0,0,124200,123900,0,0,0
371.727,0,545,645,-100,100,124200,123600,30201,244199,219499
371.727,1,531,611,-80,80,124200,123600,29005,79795,60035
371.727,2,3317,3326,-9,9,124200,123600,12605,-326405,-328628
371.727,3,465,484,-19,19,124200,123600,14650,121850,117157
371.727,4,100,50,50,-50,124200,123600,-1893,-15707,-3357
371.727,5,2232,2205,27,-27,124200,123600,7759,-228159,-221490
371.727,6,0,0,0,0,124200,123600,0,0,0
372.021249,0,545,645,-100,100,123800,123200,30201,244199,219599
372.021249,1,531,631,-100,100,123800,123200,29501,91299,66699
372.021249,2,3317,3336,-19,19,123800,123200,12853,-321653,-326327
372.021249,3,465,488,-23,23,123800,123200,14750,124150,118492
372.021249,4,110,50,60,-60,123800,123200,-2017,-23583,-8823
372.021249,5,2232,2205,27,-27,123800,123200,7759,-228159,-221517
372.021249,6,0,0,0,0,123800,123200,0,0,0
372.249924,0,545,645,-100,100,123600,123100,30201,244199,219599
372.249924,1,531,631,-100,100,123600,123100,29501,91299,66699
372.249924,2,3317,3346,-29,29,123600,123100,13100,-315900,-323034
372.249924,3,465,490,-25,25,123600,123100,14799,125301,119151
372.249924,4,110,50,60,-60,123600,123100,-2017,-23583,-8823
372.249924,5,2232,2205,27,-27,123600,123100,7759,-228159,-221517
372.249924,6,0,0,0,0,123600,123100,0,0,0
372.496403,0,545,645,-100,100,123500,123100,30201,244199,219599
372.496403,1,531,631,-100,100,123500,123100,29501,91299,66699
372.496403,2,3317,3356,-39,39,123500,123100,13347,-313147,-322741
372.496403,3,465,492,-27,27,123500,123100,14848,125852,119210
372.496403,4,110,50,60,-60,123500,123100,-2017,-23583,-8823
372.496403,5,2232,2205,27,-27,123500,123100,7759,-228159,-221517
372.496403,6,0,0,0,0,123500,123100,0,0,0
372.797979,0,545,645,-100,100,123800,123300,30201,244199,219499
372.797979,1,531,631,-100,100,123800,123300,29501,91299,66599
372.797979,2,3317,3366,-49,49,123800,123300,13223,-309023,-321126
372.797979,3,465,494,-29,29,123800,123300,14897,126403,119240
372.797979,4,110,50,60,-60,123800,123300,-2017,-23583,-8763
372.797979,5,2232,2205,27,-27,123800,123300,7759,-228159,-221490
372.797979,6,0,0,0,0,123800,123300,0,0,0
373.035448,0,545,645,-100,100,123800,123300,30201,244199,219499
373.035448,1,531,631,-100,100,123800,123300,29501,91299,66599
373.035448,2,3319,3366,-47,47,123800,123300,13198,-309998,-321607
373.035448,3,465,496,-31,31,123800,123300,14947,127153,119496
373.035448,4,110,50,60,-60,123800,123300,-2017,-23583,-8763
373.035448,5,2232,2215,17,-17,123800,123300,8006,-227406,-223207
373.035448,6,0,0,0,0,123800,123300,0,0,0
373.249274,0,545,645,-100,100,123900,123400,30201,244199,219499
373.249274,1,531,631,-100,100,123900,123400,29501,91299,66599
373.249274,2,3329,3366,-37,37,123900,123400,13074,-314074,-323213
373.249274,3,465,498,-33,33,123900,123400,14997,127903,119752
373.249274,4,110,50,60,-60,123900,123400,-2017,-23583,-8763
373.249274,5,2232,2225,7,-7,123900,123400,8253,-225253,-223524
373.249274,6,0,0,0,0,123900,123400,0,0,0
373.499268,0,545,645,-100,100,123700,123400,30201,244199,219499
373.499268,1,531,631,-100,100,123700,123400,29501,91299,66599
373.499268,2,3339,3366,-27,27,123700,123400,12950,-319550,-326219
373.499268,3,465,500,-35,35,123700,123400,15046,128454,119809
373.499268,4,110,50,60,-60,123700,123400,-2017,-23583,-8763
373.499268,5,2232,2235,-3,3,123700,123400,8500,-221300,-222041
373.499268,6,0,0,0,0,123700,123400,0,0,0
373.778046,0,545,645,-100,100,123500,123400,30201,244199,234199
373.778046,1,531,631,-100,100,123500,123400,29501,91299,81299
373.778046,2,3339,3376,-37,37,123500,123400,13197,-316797,-320497
373.778046,3,465,502,-37,37,123500,123400,15095,129005,125305
373.778046,4,110,50,60,-60,123500,123400,-2017,-23583,-17583
373.778046,5,2232,2235,-3,3,123500,123400,8500,-221300,-221600
373.778046,6,0,0,0,0,123500,123400,0,0,0
373.952711,0,545,645,-100,100,123500,123400,30201,244199,234199
373.952711,1,531,631,-100,100,123500,123400,29501,91299,81299
373.952711,2,3339,3386,-47,47,123500,123400,13444,-313044,-317744
373.952711,3,465,504,-39,39,123500,123400,15144,129556,125656
373.952711,4,110,50,60,-60,123500,123400,-2017,-23583,-17583
373.952711,5,2232,2235,-3,3,123500,123400,8500,-221300,-221600
373.952711,6,0,0,0,0,123500,123400,0,0,0
374.24442,0,545,645,-100,100,123500,123400,30201,244199,234199
374.24442,1,531,631,-100,100,123500,123400,29501,91299,81299
374.24442,2,3349,3386,-37,37,123500,123400,13691,-318291,-321991
374.24442,3,465,506,-41,41,123500,123400,15193,130107,126007
374.24442,4,110,50,60,-60,123500,123400,-2017,-23583,-17583
374.24442,5,2232,2245,-13,13,123500,123400,8747,-218547,-219847
374.24442,6,0,0,0,0,123500,123400,0,0,0
374.464304,0,545,645,-100,100,123500,123400,30201,244199,234199
374.464304,1,531,631,-100,100,123500,123400,29501,91299,81299
374.464304,2,3349,3386,-37,37,123500,123400,13691,-318291,-321991
374.464304,3,465,508,-43,43,123500,123400,15242,130458,126158
374.464304,4,110,50,60,-60,123500,123400,-2017,-23583,-17583
374.464304,5,2232,2255,-23,23,123500,123400,8994,-216794,-219094
374.464304,6,0,0,0,0,123500,123400,0,0,0
374.701591,0,545,645,-100,100,123500,123100,30201,244199,219599
374.701591,1,531,631,-100,100,123500,123100,29501,91299,66699
374.701591,2,3349,3386,-37,37,123500,123100,13691,-318291,-327393
374.701591,3,465,510,-45,45,123500,123100,15291,131009,119939
374.701591,4,110,50,60,-60,123500,123100,-2017,-23583,-8823
374.701591,5,2232,2255,-23,23,123500,123100,8994,-216794,-222452
374.701591,6,0,0,0,0,123500,123100,0,0,0
374.972257,0,545,645,-100,100,123500,123100,30201,244199,219599
374.972257,1,531,631,-100,100,123500,123100,29501,91299,66699
374.972257,2,3349,3386,-37,37,123500,123100,13691,-318291,-327393
374.972257,3,465,514,-49,49,123500,123100,15389,132111,120057
374.972257,4,110,50,60,-60,123500,123100,-2017,-23583,-8823
374.972257,5,2232,2255,-23,23,123500,123100,8994,-216794,-222452
374.972257,6,0,0,0,0,123500,123100,0,0,0
375.267229,0,545,645,-100,100,123500,123300,30201,244199,224199
375.267229,1,531,631,-100,100,123500,123300,29501,91299,71299
375.267229,2,3349,3386,-37,37,123500,123300,13691,-318291,-325691
375.267229,3,465,516,-51,51,123500,123300,15438,132462,122262
375.267229,4,110,50,60,-60,123500,123300,-2017,-23583,-11583
375.267229,5,2232,2255,-23,23,123500,123300,8994,-216794,-221394
375.267229,6,0,0,0,0,123500,123300,0,0,0
375.490935,0,545,645,-100,100,123700,123300,30201,244199,219499
375.490935,1,531,631,-100,100,123700,123300,29501,91299,66599
375.490935,2,3351,3396,-45,45,123700,123300,13542,-316942,-328057
375.490935,3,465,518,-53,53,123700,123300,15487,133013,119922
375.490935,4,110,50,60,-60,123700,123300,-2017,-23583,-8763
375.490935,5,2232,2255,-23,23,123700,123300,8994,-216794,-222475
375.490935,6,0,0,0,0,123700,123300,0,0,0
375.764953,0,545,645,-100,100,123900,123300,30201,244199,219499
375.764953,1,531,631,-100,100,123900,123300,29501,91299,66599
375.764953,2,3361,3396,-35,35,123900,123300,13790,-322190,-330835
375.764953,3,465,518,-53,53,123900,123300,15487,133013,119922
375.764953,4,110,50,60,-60,123900,123300,-2017,-23583,-8763
375.764953,5,2232,2265,-33,33,123900,123300,8870,-212670,-220821
375.764953,6,0,0,0,0,123900,123300,0,0,0
376.045549,0,545,645,-100,100,123800,123500,30201,244199,219499
376.045549,1,531,631,-100,100,123800,123500,29501,91299,66599
376.045549,2,3363,3396,-33,33,123800,123500,13840,-323040,-331191
376.045549,3,465,520,-55,55,123800,123500,15462,133638,120053
376.045549,4,110,50,60,-60,123800,123500,-2017,-23583,-8763
376.045549,5,2232,2265,-33,33,123800,123500,8870,-212670,-220821
376.045549,6,0,0,0,0,123800,123500,0,0,0
376.240735,0,545,645,-100,100,123800,123500,30201,244199,219499
376.240735,1,531,631,-100,100,123800,123500,29501,91299,66599
376.240735,2,3371,3406,-35,35,123800,123500,13617,-322017,-330662
376.240735,3,465,520,-55,55,123800,123500,15462,133638,120053
376.240735,4,110,50,60,-60,123800,123500,-2017,-23583,-8763
376.240735,5,2242,2273,-31,31,123800,123500,9316,-215716,-223373
376.240735,6,0,0,0,0,123800,123500,0,0,0
376.506726,0,545,645,-100,100,123800,123500,30201,244199,219499
376.506726,1,531,631,-100,100,123800,123500,29501,91299,66599
376.506726,2,3381,3416,-35,35,123800,123500,13518,-321918,-330563
376.506726,3,465,522,-57,57,123800,123500,15437,134263,120184
376.506726,4,110,50,60,-60,123800,123500,-2017,-23583,-8763
376.506726,5,2252,2281,-29,29,123800,123500,9688,-218688,-225851
376.506726,6,0,0,0,0,123800,123500,0,0,0
376.757123,0,545,645,-100,100,123700,123400,30201,244199,219499
376.757123,1,531,631,-100,100,123700,123400,29501,91299,66599
376.757123,2,3381,3416,-35,35,123700,123400,13518,-321918,-330563
376.757123,3,465,524,-59,59,123700,123400,15486,134814,120241
376.757123,4,110,50,60,-60,123700,123400,-2017,-23583,-8763
376.757123,5,2254,2281,-27,27,123700,123400,9663,-219463,-226132
376.757123,6,0,0,0,0,123700,123400,0,0,0
377.016414,0,545,645,-100,100,124000,123400,30201,244199,219499
377.016414,1,531,631,-100,100,124000,123400,29501,91299,66599
377.016414,2,3385,3426,-41,41,124000,123400,13344,-319344,-329471
377.016414,3,465,528,-63,63,124000,123400,15586,135914,120353
377.016414,4,110,50,60,-60,124000,123400,-2017,-23583,-8763
377.016414,5,2254,2281,-27,27,124000,123400,9663,-219463,-226132
377.016414,6,0,0,0,0,124000,123400,0,0,0
377.216059,0,545,645,-100,100,123600,123400,30201,244199,224199
377.216059,1,531,631,-100,100,123600,123400,29501,91299,71299
377.216059,2,3395,3426,-31,31,123600,123400,13220,-325020,-331220
377.216059,3,465,530,-65,65,123600,123400,15636,136664,123664
377.216059,4,110,50,60,-60,123600,123400,-2017,-23583,-11583
377.216059,5,2262,2281,-19,19,123600,123400,9564,-222564,-226364
377.216059,6,0,0,0,0,123600,123400,0,0,0
377.463662,0,545,645,-100,100,123600,123400,30201,244199,224199
377.463662,1,531,631,-100,100,123600,123400,29501,91299,71299
377.463662,2,3395,3426,-31,31,123600,123400,13220,-325020,-331220
377.463662,3,465,532,-67,67,123600,123400,15685,137215,123815
377.463662,4,110,50,60,-60,123600,123400,-2017,-23583,-11583
377.463662,5,2262,2281,-19,19,123600,123400,9564,-222564,-226364
377.463662,6,0,0,0,0,123600,123400,0,0,0
377.752142,0,545,645,-100,100,123600,123400,30201,244199,224199
377.752142,1,531,631,-100,100,123600,123400,29501,91299,71299
377.752142,2,3395,3426,-31,31,123600,123400,13220,-325020,-331220
377.752142,3,465,532,-67,67,123600,123400,15685,137215,123815
377.752142,4,110,50,60,-60,123600,123400,-2017,-23583,-11583
377.752142,5,2262,2281,-19,19,123600,123400,9564,-222564,-226364
377.752142,6,0,0,0,0,123600,123400,0,0,0
378.03772,0,545,645,-100,100,123700,123500,30201,244199,224199
378.03772,1,531,631,-100,100,123700,123500,29501,91299,71299
378.03772,2,3405,3426,-21,21,123700,123500,13467,-329267,-333467
378.03772,3,465,534,-69,69,123700,123500,15660,137840,124040
378.03772,4,110,50,60,-60,123700,123500,-2017,-23583,-11583
378.03772,5,2262,2289,-27,27,123700,123500,9465,-220065,-225465
378.03772,6,0,0,0,0,123700,123500,0,0,0
378.230154,0,545,645,-100,100,123800,123500,30201,244199,219499
378.230154,1,531,631,-100,100,123800,123500,29501,91299,66599
378.230154,2,3405,3436,-31,31,123800,123500,13343,-328143,-335800
378.230154,3,465,534,-69,69,123800,123500,15660,137840,120797
378.230154,4,110,50,60,-60,123800,123500,-2017,-23583,-8763
378.230154,5,2272,2289,-17,17,123800,123500,9713,-222313,-226512
378.230154,6,0,0,0,0,123800,123500,0,0,0
378.53161,0,545,645,-100,100,124200,123500,30201,244199,219499
378.53161,1,531,631,-100,100,124200,123500,29501,91299,66599
378.53161,2,3415,3440,-25,25,124200,123500,13542,-330942,-337117
378.53161,3,471,536,-65,65,124200,123500,15784,135116,119061
378.53161,4,110,50,60,-60,124200,123500,-2017,-23583,-8763
378.53161,5,2272,2299,-27,27,124200,123500,9589,-220189,-226858
378.53161,6,0,0,0,0,124200,123500,0,0,0
378.767065,0,545,645,-100,100,123800,123500,30201,244199,219499
378.767065,1,531,631,-100,100,123800,123500,29501,91299,66599
378.767065,2,3415,3440,-25,25,123800,123500,13542,-330942,-337117
378.767065,3,471,538,-67,67,123800,123500,15834,135266,118717
378.767065,4,110,50,60,-60,123800,123500,-2017,-23583,-8763
378.767065,5,2274,2299,-25,25,123800,123500,9564,-220564,-226739
378.767065,6,0,0,0,0,123800,123500,0,0,0
378.981157,0,545,645,-100,100,123800,123500,30201,244199,219499
378.981157,1,531,631,-100,100,123800,123500,29501,91299,66599
378.981157,2,3415,3440,-25,25,123800,123500,13542,-330942,-337117
378.981157,3,471,538,-67,67,123800,123500,15834,135266,118717
378.981157,4,110,50,60,-60,123800,123500,-2017,-23583,-8763
378.981157,5,2274,2299,-25,25,123800,123500,9564,-220564,-226739
378.981157,6,0,0,0,0,123800,123500,0,0,0
379.217378,0,545,645,-100,100,123800,123500,30201,244199,219499
379.217378,1,531,631,-100,100,123800,123500,29501,91299,66599
379.217378,2,3415,3440,-25,25,123800,123500,13542,-330942,-337117
379.217378,3,471,538,-67,67,123800,123500,15834,135266,118717
379.217378,4,110,50,60,-60,123800,123500,-2017,-23583,-8763
379.217378,5,2274,2299,-25,25,123800,123500,9564,-220564,-226739
379.217378,6,0,0,0,0,123800,123500,0,0,0
379.504027,0,545,645,-100,100,124100,123500,30201,244199,219499
379.504027,1,531,631,-100,100,124100,123500,29501,91299,66599
379.504027,2,3415,3450,-35,35,124100,123500,13418,-327818,-336463
379.504027,3,471,540,-69,69,124100,123500,15809,135891,118848
379.504027,4,110,50,60,-60,124100,123500,-2017,-23583,-8763
379.504027,5,2274,2301,-27,27,124100,123500,9539,-219739,-226408
379.504027,6,0,0,0,0,124100,123500,0,0,0
379.790684,0,545,645,-100,100,123900,123500,30201,244199,219499
379.790684,1,531,631,-100,100,123900,123500,29501,91299,66599
379.790684,2,3417,3450,-33,33,123900,123500,13468,-328668,-336819
379.790684,3,471,542,-71,71,123900,123500,15784,136516,118979
379.790684,4,110,50,60,-60,123900,123500,-2017,-23583,-8763
379.790684,5,2274,2301,-27,27,123900,123500,9539,-219739,-226408
379.790684,6,0,0,0,0,123900,123500,0,0,0
380.021133,0,545,645,-100,100,123900,123500,30201,244199,219499
380.021133,1,531,631,-100,100,123900,123500,29501,91299,66599
380.021133,2,3417,3450,-33,33,123900,123500,13468,-328668,-336819
380.021133,3,471,542,-71,71,123900,123500,15784,136516,118979
380.021133,4,110,50,60,-60,123900,123500,-2017,-23583,-8763
380.021133,5,2274,2301,-27,27,123900,123500,9539,-219739,-226408
380.021133,6,0,0,0,0,123900,123500,0,0,0
380.243792,0,545,645,-100,100,123700,123500,30201,244199,224199
380.243792,1,531,631,-100,100,123700,123500,29501,91299,71299
380.243792,2,3419,3450,-31,31,123700,123500,13443,-329443,-335643
380.243792,3,471,544,-73,73,123700,123500,15833,137067,122467
380.243792,4,110,50,60,-60,123700,123500,-2017,-23583,-11583
380.243792,5,2274,2301,-27,27,123700,123500,9539,-219739,-225139
380.243792,6,0,0,0,0,123700,123500,0,0,0
380.476014,0,545,645,-100,100,123700,123500,30201,244199,224199
380.476014,1,531,631,-100,100,123700,123500,29501,91299,71299
380.476014,2,3419,3450,-31,31,123700,123500,13443,-329443,-335643
380.476014,3,471,544,-73,73,123700,123500,15833,137067,122467
380.476014,4,110,50,60,-60,123700,123500,-2017,-23583,-11583
380.476014,5,2274,2301,-27,27,123700,123500,9539,-219739,-225139
380.476014,6,0,0,0,0,123700,123500,0,0,0
380.777748,0,545,645,-100,100,123700,123200,30201,244199,219599
380.777748,1,531,631,-100,100,123700,123200,29501,91299,66699
380.777748,2,3421,3450,-29,29,123700,123200,13418,-330418,-337552
380.777748,3,471,546,-75,75,123700,123200,15882,137818,119368
380.777748,4,110,50,60,-60,123700,123200,-2017,-23583,-8823
380.777748,5,2274,2301,-27,27,123700,123200,9539,-219739,-226381
380.777748,6,0,0,0,0,123700,123200,0,0,0
381.033929,0,545,645,-100,100,123700,123200,30201,244199,219599
381.033929,1,531,631,-100,100,123700,123200,29501,91299,66699
381.033929,2,3421,3460,-39,39,123700,123200,13665,-327665,-337259
381.033929,3,471,546,-75,75,123700,123200,15882,137818,119368
381.033929,4,110,50,60,-60,123700,123200,-2017,-23583,-8823
381.033929,5,2284,2301,-17,17,123700,123200,9415,-224615,-228797
381.033929,6,0,0,0,0,123700,123200,0,0,0
381.265148,0,545,645,-100,100,123600,123300,30201,244199,219499
381.265148,1,531,631,-100,100,123600,123300,29501,91299,66599
381.265148,2,3421,3460,-39,39,123600,123300,13665,-327665,-337298
381.265148,3,471,548,-77,77,123600,123300,15931,138169,119150
381.265148,4,110,50,60,-60,123600,123300,-2017,-23583,-8763
381.265148,5,2284,2301,-17,17,123600,123300,9415,-224615,-228814
381.265148,6,0,0,0,0,123600,123300,0,0,0
381.47357,0,545,645,-100,100,123600,123300,30201,244199,219499
381.47357,1,531,631,-100,100,123600,123300,29501,91299,66599
381.47357,2,3421,3460,-39,39,123600,123300,13665,-327665,-337298
381.47357,3,471,548,-77,77,123600,123300,15931,138169,119150
381.47357,4,110,50,60,-60,123600,123300,-2017,-23583,-8763
381.47357,5,2284,2301,-17,17,123600,123300,9415,-224615,-228814
381.47357,6,0,0,0,0,123600,123300,0,0,0
381.776344,0,545,645,-100,100,123600,123200,30201,244199,219599
381.776344,1,531,631,-100,100,123600,123200,29501,91299,66699
381.776344,2,3421,3470,-49,49,123600,123200,13912,-323912,-335966
381.776344,3,471,550,-79,79,123600,123200,15980,138920,119486
381.776344,4,110,50,60,-60,123600,123200,-2017,-23583,-8823
381.776344,5,2284,2301,-17,17,123600,123200,9415,-224615,-228797
381.776344,6,0,0,0,0,123600,123200,0,0,0
381.999151,0,545,645,-100,100,123600,123200,30201,244199,219599
381.999151,1,531,631,-100,100,123600,123200,29501,91299,66699
381.999151,2,3421,3470,-49,49,123600,123200,13912,-323912,-335966
381.999151,3,471,552,-81,81,123600,123200,16029,139471,119545
381.999151,4,110,50,60,-60,123600,123200,-2017,-23583,-8823
381.999151,5,2284,2301,-17,17,123600,123200,9415,-224615,-228797
381.999151,6,0,0,0,0,123600,123200,0,0,0
382.27117,0,545,645,-100,100,123600,123300,30201,244199,219499
382.27117,1,531,631,-100,100,123600,123300,29501,91299,66599
382.27117,2,3421,3470,-49,49,123600,123300,13912,-323912,-336015
382.27117,3,471,554,-83,83,123600,123300,16078,140222,119721
382.27117,4,110,50,60,-60,123600,123300,-2017,-23583,-8763
382.27117,5,2284,2301,-17,17,123600,123300,9415,-224615,-228814
382.27117,6,0,0,0,0,123600,123300,0,0,0
382.547835,0,545,645,-100,100,124000,123300,30201,244199,219499
382.547835,1,531,631,-100,100,124000,123300,29501,91299,66599
382.547835,2,3431,3480,-49,49,124000,123300,14036,-324036,-336139
382.547835,3,471,558,-87,87,124000,123300,16102,141198,119709
382.547835,4,110,50,60,-60,124000,123300,-2017,-23583,-8763
382.547835,5,2284,2301,-17,17,124000,123300,9415,-224615,-228814
382.547835,6,0,0,0,0,124000,123300,0,0,0
382.770829,0,545,645,-100,100,123800,123300,30201,244199,219499
382.770829,1,531,631,-100,100,123800,123300,29501,91299,66599
382.770829,2,3441,3480,-39,39,123800,123300,13912,-328912,-338545
382.770829,3,471,558,-87,87,123800,123300,16102,141198,119709
382.770829,4,110,50,60,-60,123800,123300,-2017,-23583,-8763
382.770829,5,2284,2311,-27,27,123800,123300,9663,-220863,-227532
382.770829,6,0,0,0,0,123800,123300,0,0,0
382.99339,0,545,645,-100,100,123800,123300,30201,244199,219499
382.99339,1,531,631,-100,100,123800,123300,29501,91299,66599
382.99339,2,3445,3480,-35,35,123800,123300,13936,-330736,-339381
382.99339,3,471,562,-91,91,123800,123300,16127,142573,120096
382.99339,4,110,50,60,-60,123800,123300,-2017,-23583,-8763
382.99339,5,2284,2311,-27,27,123800,123300,9663,-220863,-227532
382.99339,6,0,0,0,0,123800,123300,0,0,0
383.246661,0,545,645,-100,100,123800,123300,30201,244199,219499
383.246661,1,531,631,-100,100,123800,123300,29501,91299,66599
383.246661,2,3445,3480,-35,35,123800,123300,13936,-330736,-339381
383.246661,3,471,562,-91,91,123800,123300,16127,142573,120096
383.246661,4,110,50,60,-60,123800,123300,-2017,-23583,-8763
383.246661,5,2284,2311,-27,27,123800,123300,9663,-220863,-227532
383.246661,6,0,0,0,0,123800,123300,0,0,0
383.461792,0,545,645,-100,100,123900,123300,30201,244199,219499
383.461792,1,531,631,-100,100,123900,123300,29501,91299,66599
383.461792,2,3445,3490,-45,45,123900,123300,13812,-327612,-338727
383.461792,3,471,562,-91,91,123900,123300,16127,142573,120096
383.461792,4,110,50,60,-60,123900,123300,-2017,-23583,-8763
383.461792,5,2284,2317,-33,33,123900,123300,9589,-218989,-227140
383.461792,6,0,0,0,0,123900,123300,0,0,0
383.716466,0,545,645,-100,100,124000,123300,30201,244199,219499
383.716466,1,531,631,-100,100,124000,123300,29501,91299,66599
383.716466,2,3455,3490,-35,35,124000,123300,14060,-332460,-341105
383.716466,3,471,562,-91,91,124000,123300,16127,142573,120096
383.716466,4,110,50,60,-60,124000,123300,-2017,-23583,-8763
383.716466,5,2284,2321,-37,37,124000,123300,9539,-217739,-226878
383.716466,6,0,0,0,0,124000,123300,0,0,0
383.99222,0,545,645,-100,100,124000,123300,30201,244199,219499
383.99222,1,531,631,-100,100,124000,123300,29501,91299,66599
383.99222,2,3455,3490,-35,35,124000,123300,14060,-332460,-341105
383.99222,3,471,562,-91,91,124000,123300,16127,142573,120096
383.99222,4,110,50,60,-60,124000,123300,-2017,-23583,-8763
383.99222,5,2284,2321,-37,37,124000,123300,9539,-217739,-226878
383.99222,6,0,0,0,0,124000,123300,0,0,0
384.271388,0,545,645,-100,100,124000,123300,30201,244199,219499
384.271388,1,531,631,-100,100,124000,123300,29501,91299,66599
384.271388,2,3455,3491,-36,36,124000,123300,14048,-332148,-341040
384.271388,3,471,562,-91,91,124000,123300,16127,142573,120096
384.271388,4,110,50,60,-60,124000,123300,-2017,-23583,-8763
384.271388,5,2284,2331,-47,47,124000,123300,9415,-214615,-226224
384.271388,6,0,0,0,0,124000,123300,0,0,0
384.490146,0,545,645,-100,100,124000,123300,30201,244199,219499
384.490146,1,531,631,-100,100,124000,123300,29501,91299,66599
384.490146,2,3457,3491,-34,34,124000,123300,14023,-332923,-341321
384.490146,3,471,564,-93,93,124000,123300,16177,143123,120152
384.490146,4,110,50,60,-60,124000,123300,-2017,-23583,-8763
384.490146,5,2284,2331,-47,47,124000,123300,9415,-214615,-226224
384.490146,6,0,0,0,0,124000,123300,0,0,0
384.721718,0,545,645,-100,100,124000,123300,30201,244199,219499
384.721718,1,531,631,-100,100,124000,123300,29501,91299,66599
384.721718,2,3457,3491,-34,34,124000,123300,14023,-332923,-341321
384.721718,3,471,564,-93,93,124000,123300,16177,143123,120152
384.721718,4,110,50,60,-60,124000,123300,-2017,-23583,-8763
384.721718,5,2284,2331,-47,47,124000,123300,9415,-214615,-226224
384.721718,6,0,0,0,0,124000,123300,0,0,0
385.028792,0,545,645,-100,100,124000,123300,30201,244199,219499
385.028792,1,531,631,-100,100,124000,123300,29501,91299,66599
385.028792,2,3457,3491,-34,34,124000,123300,14023,-332923,-341321
385.028792,3,471,564,-93,93,124000,123300,16177,143123,120152
385.028792,4,110,50,60,-60,124000,123300,-2017,-23583,-8763
385.028792,5,2284,2331,-47,47,124000,123300,9415,-214615,-226224
385.028792,6,0,0,0,0,124000,123300,0,0,0
385.293769,0,545,645,-100,100,124200,123300,30201,244199,219499
385.293769,1,531,631,-100,100,124200,123300,29501,91299,66599
385.293769,2,3457,3501,-44,44,124200,123300,13899,-328799,-339667
385.293769,3,471,564,-93,93,124200,123300,16177,143123,120152
385.293769,4,110,50,60,-60,124200,123300,-2017,-23583,-8763
385.293769,5,2284,2331,-47,47,124200,123300,9415,-214615,-226224
385.293769,6,0,0,0,0,124200,123300,0,0,0
385.535845,0,545,645,-100,100,124200,123300,30201,244199,219499
385.535845,1,531,631,-100,100,124200,123300,29501,91299,66599
385.535845,2,3457,3501,-44,44,124200,123300,13899,-328799,-339667
385.535845,3,471,564,-93,93,124200,123300,16177,143123,120152
385.535845,4,110,50,60,-60,124200,123300,-2017,-23583,-8763
385.535845,5,2284,2331,-47,47,124200,123300,9415,-214615,-226224
385.535845,6,0,0,0,0,124200,123300,0,0,0
385.779062,0,545,645,-100,100,124200,123300,30201,244199,219499
385.779062,1,531,631,-100,100,124200,123300,29501,91299,66599
385.779062,2,3457,3501,-44,44,124200,123300,13899,-328799,-339667
385.779062,3,471,564,-93,93,124200,123300,16177,143123,120152
385.779062,4,110,50,60,-60,124200,123300,-2017,-23583,-8763
385.779062,5,2284,2331,-47,47,124200,123300,9415,-214615,-226224
385.779062,6,0,0,0,0,124200,123300,0,0,0
386.031156,0,545,645,-100,100,124200,123300,30201,244199,219499
386.031156,1,531,631,-100,100,124200,123300,29501,91299,66599
386.031156,2,3457,3501,-44,44,124200,123300,13899,-328799,-339667
386.031156,3,471,564,-93,93,124200,123300,16177,143123,120152
386.031156,4,110,50,60,-60,124200,123300,-2017,-23583,-8763
386.031156,5,2284,2331,-47,47,124200,123300,9415,-214615,-226224
386.031156,6,0,0,0,0,124200,123300,0,0,0
386.261925,0,545,645,-100,100,124200,123500,30201,244199,219499
386.261925,1,531,631,-100,100,124200,123500,29501,91299,66599
386.261925,2,3457,3501,-44,44,124200,123500,13899,-328799,-339667
386.261925,3,471,564,-93,93,124200,123500,16177,143123,120152
386.261925,4,110,50,60,-60,124200,123500,-2017,-23583,-8763
386.261925,5,2284,2331,-47,47,124200,123500,9415,-214615,-226224
386.261925,6,0,0,0,0,124200,123500,0,0,0
386.461584,0,545,645,-100,100,124200,123500,30201,244199,219499
386.461584,1,531,631,-100,100,124200,123500,29501,91299,66599
386.461584,2,3457,3501,-44,44,124200,123500,13899,-328799,-339667
386.461584,3,471,564,-93,93,124200,123500,16177,143123,120152
386.461584,4,110,50,60,-60,124200,123500,-2017,-23583,-8763
386.461584,5,2284,2331,-47,47,124200,123500,9415,-214615,-226224
386.461584,6,0,0,0,0,124200,123500,0,0,0
386.74551,0,545,645,-100,100,124200,123600,30201,244199,219499
386.74551,1,531,631,-100,100,124200,123600,29501,91299,66599
386.74551,2,3457,3501,-44,44,124200,123600,13899,-328799,-339667
386.74551,3,471,564,-93,93,124200,123600,16177,143123,120152
386.74551,4,110,50,60,-60,124200,123600,-2017,-23583,-8763
386.74551,5,2284,2331,-47,47,124200,123600,9415,-214615,-226224
386.74551,6,0,0,0,0,124200,123600,0,0,0
387.019864,0,545,645,-100,100,124200,123700,30201,244199,219499
387.019864,1,531,631,-100,100,124200,123700,29501,91299,66599
387.019864,2,3467,3511,-44,44,124200,123700,14023,-329923,-340791
387.019864,3,471,564,-93,93,124200,123700,16177,143123,120152
387.019864,4,110,50,60,-60,124200,123700,-2017,-23583,-8763
387.019864,5,2294,2341,-47,47,124200,123700,9539,-215739,-227348
387.019864,6,0,0,0,0,124200,123700,0,0,0
387.252163,0,545,645,-100,100,124200,123700,30201,244199,219499
387.252163,1,531,631,-100,100,124200,123700,29501,91299,66599
387.252163,2,3477,3521,-44,44,124200,123700,14147,-332047,-342915
387.252163,3,471,564,-93,93,124200,123700,16177,143123,120152
387.252163,4,110,50,60,-60,124200,123700,-2017,-23583,-8763
387.252163,5,2304,2351,-47,47,124200,123700,9663,-217863,-229472
387.252163,6,0,0,0,0,124200,123700,0,0,0
387.494595,0,545,645,-100,100,124200,123700,30201,244199,219499
387.494595,1,531,631,-100,100,124200,123700,29501,91299,66599
387.494595,2,3477,3521,-44,44,124200,123700,14147,-332047,-342915
387.494595,3,471,564,-93,93,124200,123700,16177,143123,120152
387.494595,4,110,50,60,-60,124200,123700,-2017,-23583,-8763
387.494595,5,2304,2351,-47,47,124200,123700,9663,-217863,-229472
387.494595,6,0,0,0,0,124200,123700,0,0,0
387.768958,0,545,645,-100,100,124200,123700,30201,244199,219499
387.768958,1,531,631,-100,100,124200,123700,29501,91299,66599
387.768958,2,3477,3521,-44,44,124200,123700,14147,-332047,-342915
387.768958,3,471,564,-93,93,124200,123700,16177,143123,120152
387.768958,4,110,50,60,-60,124200,123700,-2017,-23583,-8763
387.768958,5,2304,2351,-47,47,124200,123700,9663,-217863,-229472
387.768958,6,0,0,0,0,124200,123700,0,0,0
388.016214,0,545,645,-100,100,124200,123800,30201,244199,219399
388.016214,1,531,631,-100,100,124200,123800,29501,91299,66499
388.016214,2,3477,3521,-44,44,124200,123800,14147,-332047,-342959
388.016214,3,471,564,-93,93,124200,123800,16177,143123,120059
388.016214,4,110,50,60,-60,124200,123800,-2017,-23583,-8703
388.016214,5,2304,2351,-47,47,124200,123800,9663,-217863,-229519
388.016214,6,0,0,0,0,124200,123800,0,0,0
388.226046,0,545,645,-100,100,123600,123800,30201,244199,264199
388.226046,1,531,631,-100,100,123600,123800,29501,91299,111299
388.226046,2,3487,3521,-34,34,123600,123800,14023,-336923,-330123
388.226046,3,471,564,-93,93,123600,123800,16177,143123,161723
388.226046,4,110,50,60,-60,123600,123800,-2017,-23583,-35583
388.226046,5,2314,2351,-37,37,123600,123800,9539,-222739,-215339
388.226046,6,0,0,0,0,123600,123800,0,0,0
388.540033,0,545,645,-100,100,124400,123800,30201,244199,219399
388.540033,1,531,631,-100,100,124400,123800,29501,91299,66499
388.540033,2,3487,3531,-44,44,124400,123800,14271,-333171,-344083
388.540033,3,471,564,-93,93,124400,123800,16177,143123,120059
388.540033,4,110,50,60,-60,124400,123800,-2017,-23583,-8703
388.540033,5,2324,2351,-27,27,124400,123800,9415,-227615,-234311
388.540033,6,0,0,0,0,124400,123800,0,0,0
388.738627,0,545,645,-100,100,124400,123700,30201,244199,219499
388.738627,1,531,631,-100,100,124400,123700,29501,91299,66599
388.738627,2,3487,3531,-44,44,124400,123700,14271,-333171,-344039
388.738627,3,471,564,-93,93,124400,123700,16177,143123,120152
388.738627,4,110,50,60,-60,124400,123700,-2017,-23583,-8763
388.738627,5,2324,2351,-27,27,124400,123700,9415,-227615,-234284
388.738627,6,0,0,0,0,124400,123700,0,0,0
389.024905,0,545,645,-100,100,124200,123700,30201,244199,219499
389.024905,1,531,631,-100,100,124200,123700,29501,91299,66599
389.024905,2,3496,3531,-35,35,124200,123700,14159,-337559,-346204
389.024905,3,471,564,-93,93,124200,123700,16177,143123,120152
389.024905,4,110,50,60,-60,124200,123700,-2017,-23583,-8763
389.024905,5,2324,2351,-27,27,124200,123700,9415,-227615,-234284
389.024905,6,0,0,0,0,124200,123700,0,0,0
389.300162,0,545,645,-100,100,124200,123700,30201,244199,219499
389.300162,1,531,631,-100,100,124200,123700,29501,91299,66599
389.300162,2,3496,3531,-35,35,124200,123700,14159,-337559,-346204
389.300162,3,471,564,-93,93,124200,123700,16177,143123,120152
389.300162,4,110,50,60,-60,124200,123700,-2017,-23583,-8763
389.300162,5,2324,2351,-27,27,124200,123700,9415,-227615,-234284
389.300162,6,0,0,0,0,124200,123700,0,0,0
389.493554,0,545,645,-100,100,124200,123600,30201,244199,219499
389.493554,1,531,631,-100,100,124200,123600,29501,91299,66599
389.493554,2,3496,3531,-35,35,124200,123600,14159,-337559,-346204
389.493554,3,471,564,-93,93,124200,123600,16177,143123,120152
389.493554,4,110,50,60,-60,124200,123600,-2017,-23583,-8763
389.493554,5,2324,2351,-27,27,124200,123600,9415,-227615,-234284
389.493554,6,0,0,0,0,124200,123600,0,0,0
389.718107,0,545,645,-100,100,124200,123600,30201,244199,219499
389.718107,1,531,631,-100,100,124200,123600,29501,91299,66599
389.718107,2,3496,3531,-35,35,124200,123600,14159,-337559,-346204
389.718107,3,471,564,-93,93,124200,123600,16177,143123,120152
389.718107,4,110,50,60,-60,124200,123600,-2017,-23583,-8763
389.718107,5,2324,2351,-27,27,124200,123600,9415,-227615,-234284
389.718107,6,0,0,0,0,124200,123600,0,0,0
389.974422,0,545,645,-100,100,124200,123700,30201,244199,219499
389.974422,1,531,631,-100,100,124200,123700,29501,91299,66599
389.974422,2,3496,3541,-45,45,124200,123700,14035,-333435,-344550
389.974422,3,471,564,-93,93,124200,123700,16177,143123,120152
389.974422,4,110,50,60,-60,124200,123700,-2017,-23583,-8763
389.974422,5,2324,2351,-27,27,124200,123700,9415,-227615,-234284
389.974422,6,0,0,0,0,124200,123700,0,0,0
390.217728,0,545,645,-100,100,124400,123700,30201,244199,219499
390.217728,1,531,631,-100,100,124400,123700,29501,91299,66599
390.217728,2,3496,3551,-55,55,124400,123700,13911,-328311,-341896
390.217728,3,471,564,-93,93,124400,123700,16177,143123,120152
390.217728,4,110,50,60,-60,124400,123700,-2017,-23583,-8763
390.217728,5,2324,2351,-27,27,124400,123700,9415,-227615,-234284
390.217728,6,0,0,0,0,124400,123700,0,0,0
390.471644,0,545,645,-100,100,124400,123700,30201,244199,219499
390.471644,1,531,631,-100,100,124400,123700,29501,91299,66599
390.471644,2,3496,3551,-55,55,124400,123700,13911,-328311,-341896
390.471644,3,471,564,-93,93,124400,123700,16177,143123,120152
390.471644,4,110,50,60,-60,124400,123700,-2017,-23583,-8763
390.471644,5,2324,2351,-27,27,124400,123700,9415,-227615,-234284
390.471644,6,0,0,0,0,124400,123700,0,0,0
390.709906,0,545,645,-100,100,124400,123700,30201,244199,219499
390.709906,1,531,631,-100,100,124400,123700,29501,91299,66599
390.709906,2,3496,3551,-55,55,124400,123700,13911,-328311,-341896
390.709906,3,471,564,-93,93,124400,123700,16177,143123,120152
390.709906,4,110,50,60,-60,124400,123700,-2017,-23583,-8763
390.709906,5,2324,2351,-27,27,124400,123700,9415,-227615,-234284
390.709906,6,0,0,0,0,124400,123700,0,0,0
390.996836,0,545,645,-100,100,123500,123700,30201,244199,264199
390.996836,1,531,631,-100,100,123500,123700,29501,91299,111299
390.996836,2,3506,3551,-45,45,123500,123700,13787,-334187,-325187
390.996836,3,471,564,-93,93,123500,123700,16177,143123,161723
390.996836,4,110,50,60,-60,123500,123700,-2017,-23583,-35583
390.996836,5,2334,2351,-17,17,123500,123700,9291,-230491,-227091
390.996836,6,0,0,0,0,123500,123700,0,0,0
391.285723,0,545,645,-100,100,123800,123600,30201,244199,224199
391.285723,1,531,631,-100,100,123800,123600,29501,91299,71299
391.285723,2,3516,3551,-35,35,123800,123600,14035,-336435,-343435
391.285723,3,471,564,-93,93,123800,123600,16177,143123,124523
391.285723,4,110,50,60,-60,123800,123600,-2017,-23583,-11583
391.285723,5,2344,2361,-17,17,123800,123600,9415,-232615,-236015
391.285723,6,0,0,0,0,123800,123600,0,0,0
391.46706,0,545,645,-100,100,123900,123600,30201,244199,219499
391.46706,1,531,631,-100,100,123900,123600,29501,91299,66599
391.46706,2,3526,3551,-25,25,123900,123600,14283,-340683,-346858
391.46706,3,471,564,-93,93,123900,123600,16177,143123,120152
391.46706,4,110,50,60,-60,123900,123600,-2017,-23583,-8763
391.46706,5,2344,2361,-17,17,123900,123600,9415,-232615,-236814
391.46706,6,0,0,0,0,123900,123600,0,0,0
391.721552,0,545,645,-100,100,123900,123600,30201,244199,219499
391.721552,1,531,631,-100,100,123900,123600,29501,91299,66599
391.721552,2,3526,3551,-25,25,123900,123600,14283,-340683,-346858
391.721552,3,471,564,-93,93,123900,123600,16177,143123,120152
391.721552,4,110,50,60,-60,123900,123600,-2017,-23583,-8763
391.721552,5,2344,2361,-17,17,123900,123600,9415,-232615,-236814
391.721552,6,0,0,0,0,123900,123600,0,0,0
392.027306,0,545,645,-100,100,123900,123600,30201,244199,219499
392.027306,1,531,631,-100,100,123900,123600,29501,91299,66599
392.027306,2,3526,3551,-25,25,123900,123600,14283,-340683,-346858
392.027306,3,471,564,-93,93,123900,123600,16177,143123,120152
392.027306,4,110,50,60,-60,123900,123600,-2017,-23583,-8763
392.027306,5,2344,2361,-17,17,123900,123600,9415,-232615,-236814
392.027306,6,0,0,0,0,123900,123600,0,0,0
392.216918,0,545,645,-100,100,124100,123600,30201,244199,219499
392.216918,1,531,631,-100,100,124100,123600,29501,91299,66599
392.216918,2,3526,3571,-45,45,124100,123600,14407,-334807,-345922
392.216918,3,471,564,-93,93,124100,123600,16177,143123,120152
392.216918,4,110,50,60,-60,124100,123600,-2017,-23583,-8763
392.216918,5,2344,2371,-27,27,124100,123600,9291,-230491,-237160
392.216918,6,0,0,0,0,124100,123600,0,0,0
392.455462,0,545,645,-100,100,124100,123600,30201,244199,219499
392.455462,1,531,631,-100,100,124100,123600,29501,91299,66599
392.455462,2,3526,3571,-45,45,124100,123600,14407,-334807,-345922
392.455462,3,471,564,-93,93,124100,123600,16177,143123,120152
392.455462,4,110,50,60,-60,124100,123600,-2017,-23583,-8763
392.455462,5,2344,2381,-37,37,124100,123600,9539,-226739,-235878
392.455462,6,0,0,0,0,124100,123600,0,0,0
392.776049,0,545,645,-100,100,123500,123800,30201,244199,268999
392.776049,1,531,631,-100,100,123500,123800,29501,91299,116099
392.776049,2,3536,3571,-35,35,123500,123800,14283,-336683,-328003
392.776049,3,471,564,-93,93,123500,123800,16177,143123,166187
392.776049,4,110,50,60,-60,123500,123800,-2017,-23583,-38463
392.776049,5,2354,2381,-27,27,123500,123800,9415,-226615,-219919
392.776049,6,0,0,0,0,123500,123800,0,0,0
393.050017,0,545,645,-100,100,124100,123800,30201,244199,219399
393.050017,1,531,631,-100,100,124100,123800,29501,91299,66499
393.050017,2,3546,3571,-25,25,124100,123800,14531,-339931,-346131
393.050017,3,471,564,-93,93,124100,123800,16177,143123,120059
393.050017,4,110,50,60,-60,124100,123800,-2017,-23583,-8703
393.050017,5,2364,2391,-27,27,124100,123800,9167,-230367,-237063
393.050017,6,0,0,0,0,124100,123800,0,0,0
393.236521,0,545,645,-100,100,124100,123800,30201,244199,219399
393.236521,1,531,631,-100,100,124100,123800,29501,91299,66499
393.236521,2,3546,3581,-35,35,124100,123800,14779,-337179,-345859
393.236521,3,471,564,-93,93,124100,123800,16177,143123,120059
393.236521,4,110,50,60,-60,124100,123800,-2017,-23583,-8703
393.236521,5,2364,2391,-27,27,124100,123800,9167,-230367,-237063
393.236521,6,0,0,0,0,124100,123800,0,0,0
393.495982,0,545,645,-100,100,124100,123800,30201,244199,219399
393.495982,1,531,631,-100,100,124100,123800,29501,91299,66499
393.495982,2,3546,3581,-35,35,124100,123800,14779,-337179,-345859
393.495982,3,471,564,-93,93,124100,123800,16177,143123,120059
393.495982,4,110,50,60,-60,124100,123800,-2017,-23583,-8703
393.495982,5,2364,2391,-27,27,124100,123800,9167,-230367,-237063
393.495982,6,0,0,0,0,124100,123800,0,0,0
393.731304,0,545,645,-100,100,124100,123800,30201,244199,219399
393.731304,1,531,631,-100,100,124100,123800,29501,91299,66499
393.731304,2,3546,3581,-35,35,124100,123800,14779,-337179,-345859
393.731304,3,471,564,-93,93,124100,123800,16177,143123,120059
393.731304,4,110,50,60,-60,124100,123800,-2017,-23583,-8703
393.731304,5,2364,2391,-27,27,124100,123800,9167,-230367,-237063
393.731304,6,0,0,0,0,124100,123800,0,0,0
393.984514,0,545,645,-100,100,124100,123800,30201,244199,219399
393.984514,1,531,631,-100,100,124100,123800,29501,91299,66499
393.984514,2,3546,3581,-35,35,124100,123800,14779,-337179,-345859
393.984514,3,471,564,-93,93,124100,123800,16177,143123,120059
393.984514,4,110,50,60,-60,124100,123800,-2017,-23583,-8703
393.984514,5,2364,2391,-27,27,124100,123800,9167,-230367,-237063
393.984514,6,0,0,0,0,124100,123800,0,0,0
394.234706,0,545,645,-100,100,124100,123800,30201,244199,219399
394.234706,1,531,631,-100,100,124100,123800,29501,91299,66499
394.234706,2,3546,3581,-35,35,124100,123800,14779,-337179,-345859
394.234706,3,471,564,-93,93,124100,123800,16177,143123,120059
394.234706,4,110,50,60,-60,124100,123800,-2017,-23583,-8703
394.234706,5,2364,2391,-27,27,124100,123800,9167,-230367,-237063
394.234706,6,0,0,0,0,124100,123800,0,0,0
394.493079,0,545,645,-100,100,124100,123700,30201,244199,219499
394.493079,1,531,631,-100,100,124100,123700,29501,91299,66599
394.493079,2,3546,3581,-35,35,124100,123700,14779,-337179,-345824
394.493079,3,471,564,-93,93,124100,123700,16177,143123,120152
394.493079,4,110,50,60,-60,124100,123700,-2017,-23583,-8763
394.493079,5,2364,2391,-27,27,124100,123700,9167,-230367,-237036
394.493079,6,0,0,0,0,124100,123700,0,0,0
394.756317,0,545,645,-100,100,124100,123700,30201,244199,219499
394.756317,1,531,631,-100,100,124100,123700,29501,91299,66599
394.756317,2,3546,3591,-45,45,124100,123700,15027,-335427,-346542
394.756317,3,471,564,-93,93,124100,123700,16177,143123,120152
394.756317,4,110,50,60,-60,124100,123700,-2017,-23583,-8763
394.756317,5,2364,2391,-27,27,124100,123700,9167,-230367,-237036
394.756317,6,0,0,0,0,124100,123700,0,0,0
395.021165,0,545,645,-100,100,124000,123700,30201,244199,219499
395.021165,1,531,631,-100,100,124000,123700,29501,91299,66599
395.021165,2,3556,3591,-35,35,124000,123700,14903,-341303,-349948
395.021165,3,471,564,-93,93,124000,123700,16177,143123,120152
395.021165,4,110,50,60,-60,124000,123700,-2017,-23583,-8763
395.021165,5,2374,2391,-17,17,124000,123700,9043,-235243,-239442
395.021165,6,0,0,0,0,124000,123700,0,0,0
395.298587,0,545,645,-100,100,124400,123800,30201,244199,219399
395.298587,1,531,631,-100,100,124400,123800,29501,91299,66499
395.298587,2,3560,3601,-41,41,124400,123800,14878,-339078,-349246
395.298587,3,471,564,-93,93,124400,123800,16177,143123,120059
395.298587,4,110,50,60,-60,124400,123800,-2017,-23583,-8703
395.298587,5,2374,2391,-17,17,124400,123800,9043,-235243,-239459
395.298587,6,0,0,0,0,124400,123800,0,0,0
395.484973,0,545,645,-100,100,124500,123800,30201,244199,219399
395.484973,1,531,631,-100,100,124500,123800,29501,91299,66499
395.484973,2,3570,3601,-31,31,124500,123800,14903,-342103,-349791
395.484973,3,471,564,-93,93,124500,123800,16177,143123,120059
395.484973,4,110,50,60,-60,124500,123800,-2017,-23583,-8703
395.484973,5,2374,2401,-27,27,124500,123800,9142,-234342,-241038
395.484973,6,0,0,0,0,124500,123800,0,0,0
395.756378,0,545,645,-100,100,124500,123800,30201,244199,219399
395.756378,1,531,631,-100,100,124500,123800,29501,91299,66499
395.756378,2,3570,3601,-31,31,124500,123800,14903,-342103,-349791
395.756378,3,471,564,-93,93,124500,123800,16177,143123,120059
395.756378,4,110,50,60,-60,124500,123800,-2017,-23583,-8703
395.756378,5,2374,2401,-27,27,124500,123800,9142,-234342,-241038
395.756378,6,0,0,0,0,124500,123800,0,0,0
395.996978,0,545,645,-100,100,124500,123800,30201,244199,219399
395.996978,1,531,631,-100,100,124500,123800,29501,91299,66499
395.996978,2,3570,3601,-31,31,124500,123800,14903,-342103,-349791
395.996978,3,471,564,-93,93,124500,123800,16177,143123,120059
395.996978,4,110,50,60,-60,124500,123800,-2017,-23583,-8703
395.996978,5,2374,2401,-27,27,124500,123800,9142,-234342,-241038
395.996978,6,0,0,0,0,124500,123800,0,0,0
396.282693,0,545,645,-100,100,124500,123800,30201,244199,219399
396.282693,1,531,631,-100,100,124500,123800,29501,91299,66499
396.282693,2,3570,3601,-31,31,124500,123800,14903,-342103,-349791
396.282693,3,471,564,-93,93,124500,123800,16177,143123,120059
396.282693,4,110,50,60,-60,124500,123800,-2017,-23583,-8703
396.282693,5,2374,2401,-27,27,124500,123800,9142,-234342,-241038
396.282693,6,0,0,0,0,124500,123800,0,0,0
396.543313,0,545,645,-100,100,124500,123800,30201,244199,219399
396.543313,1,531,631,-100,100,124500,123800,29501,91299,66499
396.543313,2,3570,3601,-31,31,124500,123800,14903,-342103,-349791
396.543313,3,471,564,-93,93,124500,123800,16177,143123,120059
396.543313,4,110,50,60,-60,124500,123800,-2017,-23583,-8703
396.543313,5,2374,2401,-27,27,124500,123800,9142,-234342,-241038
396.543313,6,0,0,0,0,124500,123800,0,0,0
396.79463,0,545,645,-100,100,124500,123800,30201,244199,219399
396.79463,1,531,631,-100,100,124500,123800,29501,91299,66499
396.79463,2,3570,3601,-31,31,124500,123800,14903,-342103,-349791
396.79463,3,471,564,-93,93,124500,123800,16177,143123,120059
396.79463,4,110,50,60,-60,124500,123800,-2017,-23583,-8703
396.79463,5,2374,2401,-27,27,124500,123800,9142,-234342,-241038
396.79463,6,0,0,0,0,124500,123800,0,0,0
396.966288,0,545,645,-100,100,124500,124100,30201,244199,219399
396.966288,1,531,631,-100,100,124500,124100,29501,91299,66499
396.966288,2,3570,3601,-31,31,124500,124100,14903,-342103,-349791
396.966288,3,471,564,-93,93,124500,124100,16177,143123,120059
396.966288,4,110,50,60,-60,124500,124100,-2017,-23583,-8703
396.966288,5,2374,2401,-27,27,124500,124100,9142,-234342,-241038
396.966288,6,0,0,0,0,124500,124100,0,0,0
397.282889,0,545,645,-100,100,124400,124100,30201,244199,219399
397.282889,1,531,631,-100,100,124400,124100,29501,91299,66499
397.282889,2,3580,3601,-21,21,124400,124100,15152,-345352,-350560
397.282889,3,471,564,-93,93,124400,124100,16177,143123,120059
397.282889,4,110,50,60,-60,124400,124100,-2017,-23583,-8703
397.282889,5,2384,2401,-17,17,124400,124100,9391,-237591,-241807
397.282889,6,0,0,0,0,124400,124100,0,0,0
397.515782,0,545,645,-100,100,124400,124100,30201,244199,219399
397.515782,1,531,631,-100,100,124400,124100,29501,91299,66499
397.515782,2,3580,3601,-21,21,124400,124100,15152,-345352,-350560
397.515782,3,471,564,-93,93,124400,124100,16177,143123,120059
397.515782,4,110,50,60,-60,124400,124100,-2017,-23583,-8703
397.515782,5,2384,2401,-17,17,124400,124100,9391,-237591,-241807
397.515782,6,0,0,0,0,124400,124100,0,0,0
397.790243,0,545,645,-100,100,124400,123900,30201,244199,219399
397.790243,1,531,631,-100,100,124400,123900,29501,91299,66499
397.790243,2,3580,3601,-21,21,124400,123900,15152,-345352,-350560
397.790243,3,471,564,-93,93,124400,123900,16177,143123,120059
397.790243,4,110,50,60,-60,124400,123900,-2017,-23583,-8703
397.790243,5,2384,2401,-17,17,124400,123900,9391,-237591,-241807
397.790243,6,0,0,0,0,124400,123900,0,0,0
397.99475,0,545,645,-100,100,124200,124000,30201,244199,224199
397.99475,1,531,631,-100,100,124200,124000,29501,91299,71299
397.99475,2,3580,3610,-30,30,124200,124000,15376,-343776,-349776
397.99475,3,471,564,-93,93,124200,124000,16177,143123,124523
397.99475,4,110,50,60,-60,124200,124000,-2017,-23583,-11583
397.99475,5,2384,2401,-17,17,124200,124000,9391,-237591,-240991
397.99475,6,0,0,0,0,124200,124000,0,0,0
398.20301,0,545,645,-100,100,124300,124000,30201,244199,219399
398.20301,1,531,631,-100,100,124300,124000,29501,91299,66499
398.20301,2,3580,3620,-40,40,124300,124000,15252,-340652,-350572
398.20301,3,471,564,-93,93,124300,124000,16177,143123,120059
398.20301,4,110,50,60,-60,124300,124000,-2017,-23583,-8703
398.20301,5,2384,2401,-17,17,124300,124000,9391,-237591,-241807
398.20301,6,0,0,0,0,124300,124000,0,0,0
398.478539,0,545,645,-100,100,124400,124000,30201,244199,219399
398.478539,1,531,631,-100,100,124400,124000,29501,91299,66499
398.478539,2,3580,3630,-50,50,124400,124000,15501,-336901,-349301
398.478539,3,471,564,-93,93,124400,124000,16177,143123,120059
398.478539,4,110,50,60,-60,124400,124000,-2017,-23583,-8703
398.478539,5,2384,2401,-17,17,124400,124000,9391,-237591,-241807
398.478539,6,0,0,0,0,124400,124000,0,0,0
398.723917,0,545,645,-100,100,123700,124000,30201,244199,268999
398.723917,1,531,631,-100,100,123700,124000,29501,91299,116099
398.723917,2,3590,3630,-40,40,123700,124000,15750,-342150,-332230
398.723917,3,471,564,-93,93,123700,124000,16177,143123,166187
398.723917,4,110,50,60,-60,123700,124000,-2017,-23583,-38463
398.723917,5,2394,2401,-7,7,123700,124000,9267,-240467,-238731
398.723917,6,0,0,0,0,123700,124000,0,0,0
398.987971,0,545,645,-100,100,123700,123800,30201,244199,254199
398.987971,1,531,631,-100,100,123700,123800,29501,91299,101299
398.987971,2,3590,3630,-40,40,123700,123800,15750,-342150,-338150
398.987971,3,471,564,-93,93,123700,123800,16177,143123,152423
398.987971,4,110,50,60,-60,123700,123800,-2017,-23583,-29583
398.987971,5,2394,2401,-7,7,123700,123800,9267,-240467,-239767
398.987971,6,0,0,0,0,123700,123800,0,0,0
399.210153,0,545,645,-100,100,123700,123800,30201,244199,254199
399.210153,1,531,631,-100,100,123700,123800,29501,91299,101299
399.210153,2,3590,3630,-40,40,123700,123800,15750,-342150,-338150
399.210153,3,471,564,-93,93,123700,123800,16177,143123,152423
399.210153,4,110,50,60,-60,123700,123800,-2017,-23583,-29583
399.210153,5,2394,2401,-7,7,123700,123800,9267,-240467,-239767
399.210153,6,0,0,0,0,123700,123800,0,0,0
399.524194,0,545,645,-100,100,124400,123800,30201,244199,219399
399.524194,1,531,631,-100,100,124400,123800,29501,91299,66499
399.524194,2,3590,3640,-50,50,124400,123800,15626,-338026,-350426
399.524194,3,471,564,-93,93,124400,123800,16177,143123,120059
399.524194,4,110,50,60,-60,124400,123800,-2017,-23583,-8703
399.524194,5,2394,2401,-7,7,124400,123800,9267,-240467,-242203
399.524194,6,0,0,0,0,124400,123800,0,0,0
399.7457,0,545,645,-100,100,124400,123800,30201,244199,219399
399.7457,1,531,631,-100,100,124400,123800,29501,91299,66499
399.7457,2,3590,3640,-50,50,124400,123800,15626,-338026,-350426
399.7457,3,471,564,-93,93,124400,123800,16177,143123,120059
399.7457,4,110,50,60,-60,124400,123800,-2017,-23583,-8703
399.7457,5,2394,2401,-7,7,124400,123800,9267,-240467,-242203
399.7457,6,0,0,0,0,124400,123800,0,0,0
399.986022,0,545,645,-100,100,124400,123800,30201,244199,219399
399.986022,1,531,631,-100,100,124400,123800,29501,91299,66499
399.986022,2,3590,3640,-50,50,124400,123800,15626,-338026,-350426
399.986022,3,471,564,-93,93,124400,123800,16177,143123,120059
399.986022,4,110,50,60,-60,124400,123800,-2017,-23583,-8703
399.986022,5,2394,2401,-7,7,124400,123800,9267,-240467,-242203
399.986022,6,0,0,0,0,124400,123800,0,0,0
400.204139,0,545,645,-100,100,124400,123800,30201,244199,219399
400.204139,1,531,631,-100,100,124400,123800,29501,91299,66499
400.204139,2,3590,3640,-50,50,124400,123800,15626,-338026,-350426
400.204139,3,471,564,-93,93,124400,123800,16177,143123,120059
400.204139,4,110,50,60,-60,124400,123800,-2017,-23583,-8703
400.204139,5,2394,2401,-7,7,124400,123800,9267,-240467,-242203
400.204139,6,0,0,0,0,124400,123800,0,0,0
400.500861,0,545,645,-100,100,124400,123800,30201,244199,219399
400.500861,1,531,631,-100,100,124400,123800,29501,91299,66499
400.500861,2,3590,3640,-50,50,124400,123800,15626,-338026,-350426
400.500861,3,471,564,-93,93,124400,123800,16177,143123,120059
400.500861,4,110,50,60,-60,124400,123800,-2017,-23583,-8703
400.500861,5,2394,2401,-7,7,124400,123800,9267,-240467,-242203
400.500861,6,0,0,0,0,124400,123800,0,0,0
400.733009,0,545,645,-100,100,124400,123800,30201,244199,219399
400.733009,1,531,631,-100,100,124400,123800,29501,91299,66499
400.733009,2,3590,3640,-50,50,124400,123800,15626,-338026,-350426
400.733009,3,471,564,-93,93,124400,123800,16177,143123,120059
400.733009,4,110,50,60,-60,124400,123800,-2017,-23583,-8703
400.733009,5,2394,2401,-7,7,124400,123800,9267,-240467,-242203
400.733009,6,0,0,0,0,124400,123800,0,0,0
400.961295,0,545,645,-100,100,124400,123800,30201,244199,219399
400.961295,1,531,631,-100,100,124400,123800,29501,91299,66499
400.961295,2,3600,3640,-40,40,124400,123800,15875,-343275,-353195
400.961295,3,471,564,-93,93,124400,123800,16177,143123,120059
400.961295,4,110,50,60,-60,124400,123800,-2017,-23583,-8703
400.961295,5,2394,2401,-7,7,124400,123800,9267,-240467,-242203
400.961295,6,0,0,0,0,124400,123800,0,0,0
401.297844,0,545,645,-100,100,124400,123800,30201,244199,219399
401.297844,1,531,631,-100,100,124400,123800,29501,91299,66499
401.297844,2,3600,3640,-40,40,124400,123800,15875,-343275,-353195
401.297844,3,471,564,-93,93,124400,123800,16177,143123,120059
401.297844,4,110,50,60,-60,124400,123800,-2017,-23583,-8703
401.297844,5,2394,2401,-7,7,124400,123800,9267,-240467,-242203
401.297844,6,0,0,0,0,124400,123800,0,0,0
401.541734,0,545,645,-100,100,124400,123800,30201,244199,219399
401.541734,1,531,631,-100,100,124400,123800,29501,91299,66499
401.541734,2,3610,3640,-30,30,124400,123800,16124,-347524,-354964
401.541734,3,471,564,-93,93,124400,123800,16177,143123,120059
401.541734,4,110,50,60,-60,124400,123800,-2017,-23583,-8703
401.541734,5,2394,2401,-7,7,124400,123800,9267,-240467,-242203
401.541734,6,0,0,0,0,124400,123800,0,0,0
401.714852,0,545,645,-100,100,124400,124000,30201,244199,219399
401.714852,1,531,631,-100,100,124400,124000,29501,91299,66499
401.714852,2,3610,3640,-30,30,124400,124000,16124,-347524,-354964
401.714852,3,471,564,-93,93,124400,124000,16177,143123,120059
401.714852,4,110,50,60,-60,124400,124000,-2017,-23583,-8703
401.714852,5,2394,2401,-7,7,124400,124000,9267,-240467,-242203
401.714852,6,0,0,0,0,124400,124000,0,0,0
402.025984,0,545,645,-100,100,124400,124000,30201,244199,219399
402.025984,1,531,631,-100,100,124400,124000,29501,91299,66499
402.025984,2,3610,3650,-40,40,124400,124000,16000,-344400,-354320
402.025984,3,471,564,-93,93,124400,124000,16177,143123,120059
402.025984,4,110,50,60,-60,124400,124000,-2017,-23583,-8703
402.025984,5,2394,2401,-7,7,124400,124000,9267,-240467,-242203
402.025984,6,0,0,0,0,124400,124000,0,0,0
402.268603,0,545,645,-100,100,124300,124000,30201,244199,219399
402.268603,1,531,631,-100,100,124300,124000,29501,91299,66499
402.268603,2,3614,3660,-46,46,124300,124000,16199,-342199,-353607
402.268603,3,471,564,-93,93,124300,124000,16177,143123,120059
402.268603,4,110,50,60,-60,124300,124000,-2017,-23583,-8703
402.268603,5,2394,2401,-7,7,124300,124000,9267,-240467,-242203
402.268603,6,0,0,0,0,124300,124000,0,0,0
402.520811,0,545,645,-100,100,124300,124000,30201,244199,219399
402.520811,1,531,631,-100,100,124300,124000,29501,91299,66499
402.520811,2,3614,3660,-46,46,124300,124000,16199,-342199,-353607
402.520811,3,471,564,-93,93,124300,124000,16177,143123,120059
402.520811,4,110,50,60,-60,124300,124000,-2017,-23583,-8703
402.520811,5,2394,2401,-7,7,124300,124000,9267,-240467,-242203
402.520811,6,0,0,0,0,124300,124000,0,0,0
402.724021,0,545,645,-100,100,123800,124000,30201,244199,264199
402.724021,1,531,631,-100,100,123800,124000,29501,91299,111299
402.724021,2,3624,3660,-36,36,123800,124000,16075,-347075,-339875
402.724021,3,471,564,-93,93,123800,124000,16177,143123,161723
402.724021,4,110,50,60,-60,123800,124000,-2017,-23583,-35583
402.724021,5,2404,2401,3,-3,123800,124000,9143,-242343,-242943
402.724021,6,0,0,0,0,123800,124000,0,0,0
403.003237,0,545,645,-100,100,123800,124000,30201,244199,264199
403.003237,1,531,631,-100,100,123800,124000,29501,91299,111299
403.003237,2,3624,3660,-36,36,123800,124000,16075,-347075,-339875
403.003237,3,471,564,-93,93,123800,124000,16177,143123,161723
403.003237,4,110,50,60,-60,123800,124000,-2017,-23583,-35583
403.003237,5,2404,2401,3,-3,123800,124000,9143,-242343,-242943
403.003237,6,0,0,0,0,123800,124000,0,0,0
403.262936,0,545,645,-100,100,123800,124000,30201,244199,264199
403.262936,1,531,631,-100,100,123800,124000,29501,91299,111299
403.262936,2,3624,3660,-36,36,123800,124000,16075,-347075,-339875
403.262936,3,471,564,-93,93,123800,124000,16177,143123,161723
403.262936,4,110,50,60,-60,123800,124000,-2017,-23583,-35583
403.262936,5,2404,2401,3,-3,123800,124000,9143,-242343,-242943
403.262936,6,0,0,0,0,123800,124000,0,0,0
403.510551,0,545,645,-100,100,123800,124000,30201,244199,264199
403.510551,1,531,631,-100,100,123800,124000,29501,91299,111299
403.510551,2,3624,3660,-36,36,123800,124000,16075,-347075,-339875
403.510551,3,471,564,-93,93,123800,124000,16177,143123,161723
403.510551,4,110,50,60,-60,123800,124000,-2017,-23583,-35583
403.510551,5,2404,2401,3,-3,123800,124000,9143,-242343,-242943
403.510551,6,0,0,0,0,123800,124000,0,0,0
403.704113,0,545,645,-100,100,123800,124000,30201,244199,264199
403.704113,1,531,631,-100,100,123800,124000,29501,91299,111299
403.704113,2,3624,3660,-36,36,123800,124000,16075,-347075,-339875
403.704113,3,471,564,-93,93,123800,124000,16177,143123,161723
403.704113,4,110,50,60,-60,123800,124000,-2017,-23583,-35583
403.704113,5,2404,2401,3,-3,123800,124000,9143,-242343,-242943
403.704113,6,0,0,0,0,123800,124000,0,0,0
403.954576,0,545,645,-100,100,123800,124000,30201,244199,264199
403.954576,1,531,631,-100,100,123800,124000,29501,91299,111299
403.954576,2,3624,3660,-36,36,123800,124000,16075,-347075,-339875
403.954576,3,471,564,-93,93,123800,124000,16177,143123,161723
403.954576,4,110,50,60,-60,123800,124000,-2017,-23583,-35583
403.954576,5,2404,2401,3,-3,123800,124000,9143,-242343,-242943
403.954576,6,0,0,0,0,123800,124000,0,0,0
404.202099,0,545,645,-100,100,123800,123700,30201,244199,234199
404.202099,1,531,631,-100,100,123800,123700,29501,91299,81299
404.202099,2,3624,3660,-36,36,123800,123700,16075,-347075,-350675
404.202099,3,471,564,-93,93,123800,123700,16177,143123,133823
404.202099,4,110,50,60,-60,123800,123700,-2017,-23583,-17583
404.202099,5,2404,2401,3,-3,123800,123700,9143,-242343,-242043
404.202099,6,0,0,0,0,123800,123700,0,0,0
404.541746,0,545,645,-100,100,123800,123700,30201,244199,234199
404.541746,1,531,631,-100,100,123800,123700,29501,91299,81299
404.541746,2,3624,3660,-36,36,123800,123700,16075,-347075,-350675
404.541746,3,471,564,-93,93,123800,123700,16177,143123,133823
404.541746,4,110,50,60,-60,123800,123700,-2017,-23583,-17583
404.541746,5,2404,2401,3,-3,123800,123700,9143,-242343,-242043
404.541746,6,0,0,0,0,123800,123700,0,0,0
404.786112,0,545,645,-100,100,124000,123700,30201,244199,219499
404.786112,1,531,631,-100,100,124000,123700,29501,91299,66599
404.786112,2,3634,3660,-26,26,124000,123700,15951,-350951,-357373
404.786112,3,471,564,-93,93,124000,123700,16177,143123,120152
404.786112,4,110,50,60,-60,124000,123700,-2017,-23583,-8763
404.786112,5,2404,2411,-7,7,124000,123700,9391,-239591,-241320
404.786112,6,0,0,0,0,124000,123700,0,0,0
405.003684,0,545,645,-100,100,124000,123700,30201,244199,219499
405.003684,1,531,631,-100,100,124000,123700,29501,91299,66599
405.003684,2,3634,3660,-26,26,124000,123700,15951,-350951,-357373
405.003684,3,471,564,-93,93,124000,123700,16177,143123,120152
405.003684,4,110,50,60,-60,124000,123700,-2017,-23583,-8763
405.003684,5,2404,2411,-7,7,124000,123700,9391,-239591,-241320
405.003684,6,0,0,0,0,124000,123700,0,0,0
405.205294,0,545,645,-100,100,124000,123700,30201,244199,219499
405.205294,1,531,631,-100,100,124000,123700,29501,91299,66599
405.205294,2,3634,3660,-26,26,124000,123700,15951,-350951,-357373
405.205294,3,471,564,-93,93,124000,123700,16177,143123,120152
405.205294,4,110,50,60,-60,124000,123700,-2017,-23583,-8763
405.205294,5,2404,2411,-7,7,124000,123700,9391,-239591,-241320
405.205294,6,0,0,0,0,124000,123700,0,0,0
405.471697,0,545,645,-100,100,124000,123700,30201,244199,219499
405.471697,1,531,631,-100,100,124000,123700,29501,91299,66599
405.471697,2,3634,3660,-26,26,124000,123700,15951,-350951,-357373
405.471697,3,471,564,-93,93,124000,123700,16177,143123,120152
405.471697,4,110,50,60,-60,124000,123700,-2017,-23583,-8763
405.471697,5,2404,2411,-7,7,124000,123700,9391,-239591,-241320
405.471697,6,0,0,0,0,124000,123700,0,0,0
405.723293,0,545,645,-100,100,124000,123700,30201,244199,219499
405.723293,1,531,631,-100,100,124000,123700,29501,91299,66599
405.723293,2,3634,3660,-26,26,124000,123700,15951,-350951,-357373
405.723293,3,471,564,-93,93,124000,123700,16177,143123,120152
405.723293,4,110,50,60,-60,124000,123700,-2017,-23583,-8763
405.723293,5,2404,2411,-7,7,124000,123700,9391,-239591,-241320
405.723293,6,0,0,0,0,124000,123700,0,0,0
405.962853,0,545,645,-100,100,124000,123700,30201,244199,219499
405.962853,1,531,631,-100,100,124000,123700,29501,91299,66599
405.962853,2,3634,3660,-26,26,124000,123700,15951,-350951,-357373
405.962853,3,471,564,-93,93,124000,123700,16177,143123,120152
405.962853,4,110,50,60,-60,124000,123700,-2017,-23583,-8763
405.962853,5,2404,2411,-7,7,124000,123700,9391,-239591,-241320
405.962853,6,0,0,0,0,124000,123700,0,0,0
406.254211,0,545,645,-100,100,124000,123700,30201,244199,219499
406.254211,1,531,631,-100,100,124000,123700,29501,91299,66599
406.254211,2,3634,3660,-26,26,124000,123700,15951,-350951,-357373
406.254211,3,471,564,-93,93,124000,123700,16177,143123,120152
406.254211,4,110,50,60,-60,124000,123700,-2017,-23583,-8763
406.254211,5,2404,2411,-7,7,124000,123700,9391,-239591,-241320
406.254211,6,0,0,0,0,124000,123700,0,0,0
406.532197,0,545,645,-100,100,124000,123700,30201,244199,219499
406.532197,1,531,631,-100,100,124000,123700,29501,91299,66599
406.532197,2,3634,3660,-26,26,124000,123700,15951,-350951,-357373
406.532197,3,471,564,-93,93,124000,123700,16177,143123,120152
406.532197,4,110,50,60,-60,124000,123700,-2017,-23583,-8763
406.532197,5,2404,2411,-7,7,124000,123700,9391,-239591,-241320
406.532197,6,0,0,0,0,124000,123700,0,0,0
406.727221,0,545,645,-100,100,124000,123700,30201,244199,219499
406.727221,1,531,631,-100,100,124000,123700,29501,91299,66599
406.727221,2,3634,3660,-26,26,124000,123700,15951,-350951,-357373
406.727221,3,471,564,-93,93,124000,123700,16177,143123,120152
406.727221,4,110,50,60,-60,124000,123700,-2017,-23583,-8763
406.727221,5,2404,2411,-7,7,124000,123700,9391,-239591,-241320
406.727221,6,0,0,0,0,124000,123700,0,0,0
407.023687,0,545,645,-100,100,124000,123700,30201,244199,219499
407.023687,1,531,631,-100,100,124000,123700,29501,91299,66599
407.023687,2,3634,3660,-26,26,124000,123700,15951,-350951,-357373
407.023687,3,471,564,-93,93,124000,123700,16177,143123,120152
407.023687,4,110,50,60,-60,124000,123700,-2017,-23583,-8763
407.023687,5,2404,2411,-7,7,124000,123700,9391,-239591,-241320
407.023687,6,0,0,0,0,124000,123700,0,0,0
407.239372,0,545,645,-100,100,124400,123800,30201,244199,219399
407.239372,1,531,631,-100,100,124400,123800,29501,91299,66499
407.239372,2,3634,3670,-36,26,124400,123800,15827,891173,-355755
407.239372,3,471,564,-93,93,124400,123800,16177,143123,120059
407.239372,4,110,50,60,-60,124400,123800,-2017,-23583,-8703
407.239372,5,2404,2411,-7,7,124400,123800,9391,-239591,-241327
407.239372,6,0,0,0,0,124400,123800,0,0,0
407.483552,0,545,645,-100,100,124400,123800,30201,244199,219399
407.483552,1,531,631,-100,100,124400,123800,29501,91299,66499
407.483552,2,3634,3670,-36,36,124400,123800,15827,-347827,-356755
407.483552,3,471,564,-93,93,124400,123800,16177,143123,120059
407.483552,4,110,50,60,-60,124400,123800,-2017,-23583,-8703
407.483552,5,2404,2411,-7,7,124400,123800,9391,-239591,-241327
407.483552,6,0,0,0,0,124400,123800,0,0,0
407.728849,0,545,645,-100,100,124400,123800,30201,244199,219399
407.728849,1,531,631,-100,100,124400,123800,29501,91299,66499
407.728849,2,3634,3670,-36,36,124400,123800,15827,-347827,-356755
407.728849,3,471,564,-93,93,124400,123800,16177,143123,120059
407.728849,4,110,50,60,-60,124400,123800,-2017,-23583,-8703
407.728849,5,2404,2411,-7,7,124400,123800,9391,-239591,-241327
407.728849,6,0,0,0,0,124400,123800,0,0,0
407.985314,0,545,645,-100,100,124400,123800,30201,244199,219399
407.985314,1,531,631,-100,100,124400,123800,29501,91299,66499
407.985314,2,3634,3670,-36,36,124400,123800,15827,-347827,-356755
407.985314,3,471,564,-93,93,124400,123800,16177,143123,120059
407.985314,4,110,50,60,-60,124400,123800,-2017,-23583,-8703
407.985314,5,2404,2411,-7,7,124400,123800,9391,-239591,-241327
407.985314,6,0,0,0,0,124400,123800,0,0,0
408.246747,0,545,645,-100,100,124400,123800,30201,244199,219399
408.246747,1,531,631,-100,100,124400,123800,29501,91299,66499
408.246747,2,3634,3670,-36,36,124400,123800,15827,-347827,-356755
408.246747,3,471,564,-93,93,124400,123800,16177,143123,120059
408.246747,4,110,50,60,-60,124400,123800,-2017,-23583,-8703
408.246747,5,2404,2411,-7,7,124400,123800,9391,-239591,-241327
408.246747,6,0,0,0,0,124400,123800,0,0,0
408.548799,0,545,645,-100,100,124400,124000,30201,244199,219399
408.548799,1,531,631,-100,100,124400,124000,29501,91299,66499
408.548799,2,3634,3680,-46,46,124400,124000,15703,-345703,-357111
408.548799,3,471,564,-93,93,124400,124000,16177,143123,120059
408.548799,4,110,50,60,-60,124400,124000,-2017,-23583,-8703
408.548799,5,2404,2411,-7,7,124400,124000,9391,-239591,-241327
408.548799,6,0,0,0,0,124400,124000,0,0,0
408.72343,0,545,645,-100,100,124400,124000,30201,244199,219399
408.72343,1,531,631,-100,100,124400,124000,29501,91299,66499
408.72343,2,3644,3680,-36,36,124400,124000,15952,-349952,-358880
408.72343,3,471,564,-93,93,124400,124000,16177,143123,120059
408.72343,4,110,50,60,-60,124400,124000,-2017,-23583,-8703
408.72343,5,2404,2411,-7,7,124400,124000,9391,-239591,-241327
408.72343,6,0,0,0,0,124400,124000,0,0,0
408.950787,0,545,645,-100,100,124400,123800,30201,244199,219399
408.950787,1,531,631,-100,100,124400,123800,29501,91299,66499
408.950787,2,3644,3680,-36,36,124400,123800,15952,-349952,-358880
408.950787,3,471,564,-93,93,124400,123800,16177,143123,120059
408.950787,4,110,50,60,-60,124400,123800,-2017,-23583,-8703
408.950787,5,2404,2411,-7,7,124400,123800,9391,-239591,-241327
408.950787,6,0,0,0,0,124400,123800,0,0,0
409.217998,0,545,645,-100,100,124200,123800,30201,244199,219399
409.217998,1,531,631,-100,100,124200,123800,29501,91299,66499
409.217998,2,3644,3690,-46,46,124200,123800,15828,-345828,-357236
409.217998,3,471,564,-93,93,124200,123800,16177,143123,120059
409.217998,4,110,50,60,-60,124200,123800,-2017,-23583,-8703
409.217998,5,2404,2411,-7,7,124200,123800,9391,-239591,-241327
409.217998,6,0,0,0,0,124200,123800,0,0,0
409.46855,0,545,645,-100,100,124200,123600,30201,244199,219499
409.46855,1,531,631,-100,100,124200,123600,29501,91299,66599
409.46855,2,3654,3690,-36,36,124200,123600,15704,-352704,-361596
409.46855,3,471,564,-93,93,124200,123600,16177,143123,120152
409.46855,4,110,50,60,-60,124200,123600,-2017,-23583,-8763
409.46855,5,2404,2411,-7,7,124200,123600,9391,-239591,-241320
409.46855,6,0,0,0,0,124200,123600,0,0,0
409.761193,0,545,645,-100,100,124000,123600,30201,244199,219499
409.761193,1,531,631,-100,100,124000,123600,29501,91299,66599
409.761193,2,3654,3690,-36,36,124000,123600,15704,-352704,-361596
409.761193,3,471,564,-93,93,124000,123600,16177,143123,120152
409.761193,4,110,50,60,-60,124000,123600,-2017,-23583,-8763
409.761193,5,2404,2411,-7,7,124000,123600,9391,-239591,-241320
409.761193,6,0,0,0,0,124000,123600,0,0,0
410.003677,0,545,645,-100,100,124000,123600,30201,244199,219499
410.003677,1,531,631,-100,100,124000,123600,29501,91299,66599
410.003677,2,3654,3690,-36,36,124000,123600,15704,-352704,-361596
410.003677,3,471,564,-93,93,124000,123600,16177,143123,120152
410.003677,4,110,50,60,-60,124000,123600,-2017,-23583,-8763
410.003677,5,2404,2411,-7,7,124000,123600,9391,-239591,-241320
410.003677,6,0,0,0,0,124000,123600,0,0,0
410.229975,0,545,645,-100,100,124200,123200,30201,244199,219599
410.229975,1,531,631,-100,100,124200,123200,29501,91299,66699
410.229975,2,3654,3700,-46,46,124200,123200,15580,-349580,-360896
410.229975,3,471,564,-93,93,124200,123200,16177,143123,120245
410.229975,4,110,50,60,-60,124200,123200,-2017,-23583,-8823
410.229975,5,2404,2411,-7,7,124200,123200,9391,-239591,-241313
410.229975,6,0,0,0,0,124200,123200,0,0,0
410.480447,0,545,645,-100,100,123800,123000,30201,244199,219599
410.480447,1,531,631,-100,100,123800,123000,29501,91299,66699
410.480447,2,3654,3710,-56,56,123800,123000,15828,-343828,-357604
410.480447,3,471,564,-93,93,123800,123000,16177,143123,120245
410.480447,4,110,50,60,-60,123800,123000,-2017,-23583,-8823
410.480447,5,2404,2411,-7,7,123800,123000,9391,-239591,-241313
410.480447,6,0,0,0,0,123800,123000,0,0,0
410.729386,0,545,645,-100,100,123600,123100,30201,244199,219599
410.729386,1,531,631,-100,100,123600,123100,29501,91299,66699
410.729386,2,3659,3720,-61,61,123600,123100,16013,-340513,-355519
410.729386,3,471,564,-93,93,123600,123100,16177,143123,120245
410.729386,4,110,50,60,-60,123600,123100,-2017,-23583,-8823
410.729386,5,2404,2411,-7,7,123600,123100,9391,-239591,-241313
410.729386,6,0,0,0,0,123600,123100,0,0,0
411.020514,0,545,645,-100,100,123800,123200,30201,244199,219599
411.020514,1,531,631,-100,100,123800,123200,29501,91299,66699
411.020514,2,3669,3720,-51,51,123800,123200,16261,-347761,-360307
411.020514,3,471,564,-93,93,123800,123200,16177,143123,120245
411.020514,4,110,50,60,-60,123800,123200,-2017,-23583,-8823
411.020514,5,2404,2411,-7,7,123800,123200,9391,-239591,-241313
411.020514,6,0,0,0,0,123800,123200,0,0,0
411.202044,0,545,645,-100,100,123700,123200,30201,244199,219599
411.202044,1,531,631,-100,100,123700,123200,29501,91299,66699
411.202044,2,3679,3720,-41,41,123700,123200,16508,-354008,-364094
411.202044,3,471,564,-93,93,123700,123200,16177,143123,120245
411.202044,4,110,50,60,-60,123700,123200,-2017,-23583,-8823
411.202044,5,2404,2411,-7,7,123700,123200,9391,-239591,-241313
411.202044,6,0,0,0,0,123700,123200,0,0,0
411.526995,0,545,645,-100,100,123500,123000,30201,244199,219599
411.526995,1,531,631,-100,100,123500,123000,29501,91299,66699
411.526995,2,3689,3720,-31,31,123500,123000,16384,-358884,-366510
411.526995,3,471,564,-93,93,123500,123000,16177,143123,120245
411.526995,4,110,50,60,-60,123500,123000,-2017,-23583,-8823
411.526995,5,2404,2411,-7,7,123500,123000,9391,-239591,-241313
411.526995,6,0,0,0,0,123500,123000,0,0,0
411.780665,0,545,645,-100,100,123500,123000,30201,244199,219599
411.780665,1,531,631,-100,100,123500,123000,29501,91299,66699
411.780665,2,3689,3730,-41,41,123500,123000,16631,-355131,-365217
411.780665,3,471,564,-93,93,123500,123000,16177,143123,120245
411.780665,4,110,50,60,-60,123500,123000,-2017,-23583,-8823
411.780665,5,2404,2411,-7,7,123500,123000,9391,-239591,-241313
411.780665,6,0,0,0,0,123500,123000,0,0,0
412.013653,0,545,645,-100,100,123500,122900,30201,244199,219599
412.013653,1,531,631,-100,100,123500,122900,29501,91299,66699
412.013653,2,3689,3730,-41,41,123500,122900,16631,-355131,-365217
412.013653,3,471,564,-93,93,123500,122900,16177,143123,120245
412.013653,4,110,50,60,-60,123500,122900,-2017,-23583,-8823
412.013653,5,2404,2411,-7,7,123500,122900,9391,-239591,-241313
412.013653,6,0,0,0,0,123500,122900,0,0,0
412.277833,0,545,645,-100,100,123500,122900,30201,244199,219599
412.277833,1,531,631,-100,100,123500,122900,29501,91299,66699
412.277833,2,3689,3740,-51,51,123500,122900,16878,-351378,-363924
412.277833,3,471,564,-93,93,123500,122900,16177,143123,120245
412.277833,4,110,50,60,-60,123500,122900,-2017,-23583,-8823
412.277833,5,2404,2411,-7,7,123500,122900,9391,-239591,-241313
412.277833,6,0,0,0,0,123500,122900,0,0,0
412.468985,0,545,645,-100,100,123500,122900,30201,244199,219599
412.468985,1,531,631,-100,100,123500,122900,29501,91299,66699
412.468985,2,3689,3740,-51,51,123500,122900,16878,-351378,-363924
412.468985,3,471,564,-93,93,123500,122900,16177,143123,120245
412.468985,4,110,50,60,-60,123500,122900,-2017,-23583,-8823
412.468985,5,2404,2411,-7,7,123500,122900,9391,-239591,-241313
412.468985,6,0,0,0,0,123500,122900,0,0,0
412.765876,0,545,645,-100,100,123600,123200,30201,244199,219599
412.765876,1,531,631,-100,100,123600,123200,29501,91299,66699
412.765876,2,3699,3740,-41,41,123600,123200,17125,-357625,-367711
412.765876,3,471,564,-93,93,123600,123200,16177,143123,120245
412.765876,4,110,50,60,-60,123600,123200,-2017,-23583,-8823
412.765876,5,2404,2411,-7,7,123600,123200,9391,-239591,-241313
412.765876,6,0,0,0,0,123600,123200,0,0,0
412.963155,0,545,645,-100,100,123800,123200,30201,244199,219599
412.963155,1,531,631,-100,100,123800,123200,29501,91299,66699
412.963155,2,3699,3750,-51,51,123800,123200,17001,-352501,-365047
412.963155,3,471,564,-93,93,123800,123200,16177,143123,120245
412.963155,4,110,50,60,-60,123800,123200,-2017,-23583,-8823
412.963155,5,2404,2411,-7,7,123800,123200,9391,-239591,-241313
412.963155,6,0,0,0,0,123800,123200,0,0,0
413.297111,0,545,645,-100,100,123600,123200,30201,244199,219599
413.297111,1,531,631,-100,100,123600,123200,29501,91299,66699
413.297111,2,3709,3750,-41,41,123600,123200,16877,-358377,-368463
413.297111,3,471,564,-93,93,123600,123200,16177,143123,120245
413.297111,4,110,50,60,-60,123600,123200,-2017,-23583,-8823
413.297111,5,2404,2411,-7,7,123600,123200,9391,-239591,-241313
413.297111,6,0,0,0,0,123600,123200,0,0,0
413.486501,0,545,645,-100,100,123600,123200,30201,244199,219599
413.486501,1,531,631,-100,100,123600,123200,29501,91299,66699
413.486501,2,3709,3750,-41,41,123600,123200,16877,-358377,-368463
413.486501,3,471,564,-93,93,123600,123200,16177,143123,120245
413.486501,4,110,50,60,-60,123600,123200,-2017,-23583,-8823
413.486501,5,2404,2411,-7,7,123600,123200,9391,-239591,-241313
413.486501,6,0,0,0,0,123600,123200,0,0,0
413.765653,0,545,645,-100,100,123500,123000,30201,244199,219599
413.765653,1,531,631,-100,100,123500,123000,29501,91299,66699
413.765653,2,3709,3760,-51,51,123500,123000,17124,-353624,-366170
413.765653,3,471,564,-93,93,123500,123000,16177,143123,120245
413.765653,4,110,50,60,-60,123500,123000,-2017,-23583,-8823
413.765653,5,2404,2411,-7,7,123500,123000,9391,-239591,-241313
413.765653,6,0,0,0,0,123500,123000,0,0,0
413.995629,0,545,645,-100,100,123600,123000,30201,244199,219599
413.995629,1,531,631,-100,100,123600,123000,29501,91299,66699
413.995629,2,3719,3760,-41,41,123600,123000,17371,-358871,-368957
413.995629,3,471,564,-93,93,123600,123000,16177,143123,120245
413.995629,4,110,50,60,-60,123600,123000,-2017,-23583,-8823
413.995629,5,2404,2411,-7,7,123600,123000,9391,-239591,-241313
413.995629,6,0,0,0,0,123600,123000,0,0,0
414.200187,0,545,645,-100,100,123600,123200,30201,244199,219599
414.200187,1,531,631,-100,100,123600,123200,29501,91299,66699
414.200187,2,3719,3760,-41,41,123600,123200,17371,-358871,-368957
414.200187,3,471,564,-93,93,123600,123200,16177,143123,120245
414.200187,4,110,50,60,-60,123600,123200,-2017,-23583,-8823
414.200187,5,2404,2411,-7,7,123600,123200,9391,-239591,-241313
414.200187,6,0,0,0,0,123600,123200,0,0,0
414.469317,0,545,645,-100,100,123500,123200,30201,244199,219599
414.469317,1,531,631,-100,100,123500,123200,29501,91299,66699
414.469317,2,3729,3760,-31,31,123500,123200,17618,-364118,-371744
414.469317,3,471,564,-93,93,123500,123200,16177,143123,120245
414.469317,4,110,50,60,-60,123500,123200,-2017,-23583,-8823
414.469317,5,2404,2421,-17,17,123500,123200,9638,-237838,-242020
414.469317,6,0,0,0,0,123500,123200,0,0,0
414.766026,0,545,645,-100,100,123600,123200,30201,244199,219599
414.766026,1,531,631,-100,100,123600,123200,29501,91299,66699
414.766026,2,3739,3760,-21,21,123600,123200,17865,-368365,-373531
414.766026,3,471,564,-93,93,123600,123200,16177,143123,120245
414.766026,4,110,50,60,-60,123600,123200,-2017,-23583,-8823
414.766026,5,2404,2431,-27,27,123600,123200,9514,-234714,-241356
414.766026,6,0,0,0,0,123600,123200,0,0,0
414.994484,0,545,645,-100,100,123500,123200,30201,244199,219599
414.994484,1,531,631,-100,100,123500,123200,29501,91299,66699
414.994484,2,3739,3770,-31,31,123500,123200,18112,-365612,-373238
414.994484,3,471,564,-93,93,123500,123200,16177,143123,120245
414.994484,4,110,50,60,-60,123500,123200,-2017,-23583,-8823
414.994484,5,2404,2441,-37,37,123500,123200,9761,-231961,-241063
414.994484,6,0,0,0,0,123500,123200,0,0,0
415.242127,0,545,645,-100,100,123500,123200,30201,244199,219599
415.242127,1,531,631,-100,100,123500,123200,29501,91299,66699
415.242127,2,3739,3780,-41,41,123500,123200,18359,-361859,-371945
415.242127,3,471,564,-93,93,123500,123200,16177,143123,120245
415.242127,4,110,50,60,-60,123500,123200,-2017,-23583,-8823
415.242127,5,2404,2441,-37,37,123500,123200,9761,-231961,-241063
415.242127,6,0,0,0,0,123500,123200,0,0,0
415.52154,0,545,645,-100,100,123600,123200,30201,244199,219599
415.52154,1,531,631,-100,100,123600,123200,29501,91299,66699
415.52154,2,3749,3780,-31,31,123600,123200,18235,-366735,-374361
415.52154,3,471,564,-93,93,123600,123200,16177,143123,120245
415.52154,4,110,50,60,-60,123600,123200,-2017,-23583,-8823
415.52154,5,2404,2451,-47,47,123600,123200,10008,-229208,-240770
415.52154,6,0,0,0,0,123600,123200,0,0,0
415.790696,0,545,645,-100,100,123700,123400,30201,244199,219499
415.790696,1,531,631,-100,100,123700,123400,29501,91299,66599
415.790696,2,3749,3790,-41,41,123700,123400,18482,-362982,-373109
415.790696,3,471,564,-93,93,123700,123400,16177,143123,120152
415.790696,4,110,50,60,-60,123700,123400,-2017,-23583,-8763
415.790696,5,2414,2451,-37,37,123700,123400,9884,-234084,-243223
415.790696,6,0,0,0,0,123700,123400,0,0,0
415.987864,0,545,645,-100,100,123700,123400,30201,244199,219499
415.987864,1,531,631,-100,100,123700,123400,29501,91299,66599
415.987864,2,3749,3790,-41,41,123700,123400,18482,-362982,-373109
415.987864,3,471,564,-93,93,123700,123400,16177,143123,120152
415.987864,4,110,50,60,-60,123700,123400,-2017,-23583,-8763
415.987864,5,2414,2451,-37,37,123700,123400,9884,-234084,-243223
415.987864,6,0,0,0,0,123700,123400,0,0,0
416.29819,0,545,645,-100,100,123800,123400,30201,244199,219499
416.29819,1,531,631,-100,100,123800,123400,29501,91299,66599
416.29819,2,3769,3800,-31,31,123800,123400,18110,-369610,-377267
416.29819,3,471,564,-93,93,123800,123400,16177,143123,120152
416.29819,4,110,50,60,-60,123800,123400,-2017,-23583,-8763
416.29819,5,2414,2461,-47,47,123800,123400,10132,-229332,-240941
416.29819,6,0,0,0,0,123800,123400,0,0,0
416.453119,0,545,645,-100,100,123700,123400,30201,244199,219499
416.453119,1,531,631,-100,100,123700,123400,29501,91299,66599
416.453119,2,3769,3810,-41,41,123700,123400,18357,-365857,-375984
416.453119,3,471,564,-93,93,123700,123400,16177,143123,120152
416.453119,4,110,50,60,-60,123700,123400,-2017,-23583,-8763
416.453119,5,2424,2461,-37,37,123700,123400,10008,-234208,-243347
416.453119,6,0,0,0,0,123700,123400,0,0,0
416.756584,0,545,645,-100,100,123700,123400,30201,244199,219499
416.756584,1,531,631,-100,100,123700,123400,29501,91299,66599
416.756584,2,3779,3810,-31,31,123700,123400,18604,-371104,-378761
416.756584,3,471,564,-93,93,123700,123400,16177,143123,120152
416.756584,4,110,50,60,-60,123700,123400,-2017,-23583,-8763
416.756584,5,2424,2471,-47,47,123700,123400,9884,-230084,-241693
416.756584,6,0,0,0,0,123700,123400,0,0,0
417.037639,0,545,645,-100,100,123700,123400,30201,244199,219499
417.037639,1,531,631,-100,100,123700,123400,29501,91299,66599
417.037639,2,3779,3810,-31,31,123700,123400,18604,-371104,-378761
417.037639,3,471,564,-93,93,123700,123400,16177,143123,120152
417.037639,4,110,50,60,-60,123700,123400,-2017,-23583,-8763
417.037639,5,2424,2471,-47,47,123700,123400,9884,-230084,-241693
417.037639,6,0,0,0,0,123700,123400,0,0,0
417.253811,0,545,645,-100,100,123900,123400,30201,244199,219499
417.253811,1,531,631,-100,100,123900,123400,29501,91299,66599
417.253811,2,3779,3822,-43,43,123900,123400,18455,-366355,-376976
417.253811,3,471,564,-93,93,123900,123400,16177,143123,120152
417.253811,4,110,50,60,-60,123900,123400,-2017,-23583,-8763
417.253811,5,2434,2471,-37,37,123900,123400,10132,-235332,-244471
417.253811,6,0,0,0,0,123900,123400,0,0,0
417.451916,0,545,645,-100,100,123900,123400,30201,244199,219499
417.451916,1,531,631,-100,100,123900,123400,29501,91299,66599
417.451916,2,3779,3822,-43,43,123900,123400,18455,-366355,-376976
417.451916,3,471,564,-93,93,123900,123400,16177,143123,120152
417.451916,4,110,50,60,-60,123900,123400,-2017,-23583,-8763
417.451916,5,2434,2471,-37,37,123900,123400,10132,-235332,-244471
417.451916,6,0,0,0,0,123900,123400,0,0,0
417.753155,0,545,645,-100,100,123700,123400,30201,244199,219499
417.753155,1,531,631,-100,100,123700,123400,29501,91299,66599
417.753155,2,3789,3822,-33,33,123700,123400,18331,-369231,-377382
417.753155,3,471,564,-93,93,123700,123400,16177,143123,120152
417.753155,4,110,50,60,-60,123700,123400,-2017,-23583,-8763
417.753155,5,2441,2471,-30,30,123700,123400,10045,-235945,-243355
417.753155,6,0,0,0,0,123700,123400,0,0,0
418.033064,0,545,645,-100,100,124000,123600,30201,244199,219499
418.033064,1,531,631,-100,100,124000,123600,29501,91299,66599
418.033064,2,3799,3822,-23,23,124000,123600,18579,-373479,-379160
418.033064,3,471,564,-93,93,124000,123600,16177,143123,120152
418.033064,4,110,50,60,-60,124000,123600,-2017,-23583,-8763
418.033064,5,2441,2481,-40,40,124000,123600,9921,-232821,-242701
418.033064,6,0,0,0,0,124000,123600,0,0,0
418.252995,0,545,645,-100,100,124000,123600,30201,244199,219499
418.252995,1,531,631,-100,100,124000,123600,29501,91299,66599
418.252995,2,3799,3822,-23,23,124000,123600,18579,-373479,-379160
418.252995,3,471,564,-93,93,124000,123600,16177,143123,120152
418.252995,4,110,50,60,-60,124000,123600,-2017,-23583,-8763
418.252995,5,2441,2481,-40,40,124000,123600,9921,-232821,-242701
418.252995,6,0,0,0,0,124000,123600,0,0,0
418.490534,0,545,645,-100,100,124000,123600,30201,244199,219499
418.490534,1,531,631,-100,100,124000,123600,29501,91299,66599
418.490534,2,3799,3822,-23,23,124000,123600,18579,-373479,-379160
418.490534,3,471,564,-93,93,124000,123600,16177,143123,120152
418.490534,4,110,50,60,-60,124000,123600,-2017,-23583,-8763
418.490534,5,2441,2481,-40,40,124000,123600,9921,-232821,-242701
418.490534,6,0,0,0,0,124000,123600,0,0,0
418.71021,0,545,645,-100,100,124000,123600,30201,244199,219499
418.71021,1,531,631,-100,100,124000,123600,29501,91299,66599
418.71021,2,3799,3822,-23,23,124000,123600,18579,-373479,-379160
418.71021,3,471,564,-93,93,124000,123600,16177,143123,120152
418.71021,4,110,50,60,-60,124000,123600,-2017,-23583,-8763
418.71021,5,2441,2481,-40,40,124000,123600,9921,-232821,-242701
418.71021,6,0,0,0,0,124000,123600,0,0,0
418.976173,0,545,645,-100,100,124000,123600,30201,244199,219499
418.976173,1,531,631,-100,100,124000,123600,29501,91299,66599
418.976173,2,3799,3822,-23,23,124000,123600,18579,-373479,-379160
418.976173,3,471,564,-93,93,124000,123600,16177,143123,120152
418.976173,4,110,50,60,-60,124000,123600,-2017,-23583,-8763
418.976173,5,2441,2481,-40,40,124000,123600,9921,-232821,-242701
418.976173,6,0,0,0,0,124000,123600,0,0,0
419.220208,0,545,645,-100,100,124000,123600,30201,244199,219499
419.220208,1,531,631,-100,100,124000,123600,29501,91299,66599
419.220208,2,3799,3822,-23,23,124000,123600,18579,-373479,-379160
419.220208,3,471,564,-93,93,124000,123600,16177,143123,120152
419.220208,4,110,50,60,-60,124000,123600,-2017,-23583,-8763
419.220208,5,2441,2481,-40,40,124000,123600,9921,-232821,-242701
419.220208,6,0,0,0,0,124000,123600,0,0,0
419.467981,0,545,645,-100,100,123500,123600,30201,244199,254199
419.467981,1,531,631,-100,100,123500,123600,29501,91299,101299
419.467981,2,3809,3832,-23,23,123500,123600,18331,-373231,-370931
419.467981,3,471,564,-93,93,123500,123600,16177,143123,152423
419.467981,4,110,50,60,-60,123500,123600,-2017,-23583,-29583
419.467981,5,2451,2481,-30,30,123500,123600,10169,-238069,-235069
419.467981,6,0,0,0,0,123500,123600,0,0,0
419.794007,0,545,645,-100,100,123500,123800,30201,244199,268999
419.794007,1,531,631,-100,100,123500,123800,29501,91299,116099
419.794007,2,3809,3832,-23,23,123500,123800,18331,-373231,-367527
419.794007,3,471,564,-93,93,123500,123800,16177,143123,166187
419.794007,4,110,50,60,-60,123500,123800,-2017,-23583,-38463
419.794007,5,2451,2481,-30,30,123500,123800,10169,-238069,-230629
419.794007,6,0,0,0,0,123500,123800,0,0,0
420.024672,0,545,645,-100,100,124100,123800,30201,244199,219399
420.024672,1,531,631,-100,100,124100,123800,29501,91299,66499
420.024672,2,3819,3842,-23,23,124100,123800,18455,-374355,-380059
420.024672,3,471,564,-93,93,124100,123800,16177,143123,120059
420.024672,4,110,50,60,-60,124100,123800,-2017,-23583,-8703
420.024672,5,2461,2491,-30,30,124100,123800,10293,-239193,-246633
420.024672,6,0,0,0,0,124100,123800,0,0,0
420.202095,0,545,645,-100,100,124100,123800,30201,244199,219399
420.202095,1,531,631,-100,100,124100,123800,29501,91299,66499
420.202095,2,3819,3842,-23,23,124100,123800,18455,-374355,-380059
420.202095,3,471,564,-93,93,124100,123800,16177,143123,120059
420.202095,4,110,50,60,-60,124100,123800,-2017,-23583,-8703
420.202095,5,2461,2491,-30,30,124100,123800,10293,-239193,-246633
420.202095,6,0,0,0,0,124100,123800,0,0,0
420.52535,0,545,645,-100,100,124100,123800,30201,244199,219399
420.52535,1,531,631,-100,100,124100,123800,29501,91299,66499
420.52535,2,3819,3842,-23,23,124100,123800,18455,-374355,-380059
420.52535,3,471,564,-93,93,124100,123800,16177,143123,120059
420.52535,4,110,50,60,-60,124100,123800,-2017,-23583,-8703
420.52535,5,2461,2491,-30,30,124100,123800,10293,-239193,-246633
420.52535,6,0,0,0,0,124100,123800,0,0,0
420.722772,0,545,645,-100,100,124100,123800,30201,244199,219399
420.722772,1,531,631,-100,100,124100,123800,29501,91299,66499
420.722772,2,3819,3842,-23,23,124100,123800,18455,-374355,-380059
420.722772,3,471,564,-93,93,124100,123800,16177,143123,120059
420.722772,4,110,50,60,-60,124100,123800,-2017,-23583,-8703
420.722772,5,2461,2491,-30,30,124100,123800,10293,-239193,-246633
420.722772,6,0,0,0,0,124100,123800,0,0,0
421.000082,0,545,645,-100,100,124100,123800,30201,244199,219399
421.000082,1,531,631,-100,100,124100,123800,29501,91299,66499
421.000082,2,3819,3852,-33,33,124100,123800,18703,-371603,-379787
421.000082,3,471,564,-93,93,124100,123800,16177,143123,120059
421.000082,4,110,50,60,-60,124100,123800,-2017,-23583,-8703
421.000082,5,2471,2491,-20,20,124100,123800,10169,-243069,-248029
421.000082,6,0,0,0,0,124100,123800,0,0,0
421.21743,0,545,645,-100,100,124100,123900,30201,244199,224199
421.21743,1,531,631,-100,100,124100,123900,29501,91299,71299
421.21743,2,3819,3852,-33,33,124100,123900,18703,-371603,-378203
421.21743,3,471,564,-93,93,124100,123900,16177,143123,124523
421.21743,4,110,50,60,-60,124100,123900,-2017,-23583,-11583
421.21743,5,2471,2491,-20,20,124100,123900,10169,-243069,-247069
421.21743,6,0,0,0,0,124100,123900,0,0,0
421.474201,0,545,645,-100,100,124100,124000,30201,244199,234199
421.474201,1,531,631,-100,100,124100,124000,29501,91299,81299
421.474201,2,3819,3852,-33,33,124100,124000,18703,-371603,-374903
421.474201,3,471,564,-93,93,124100,124000,16177,143123,133823
421.474201,4,110,50,60,-60,124100,124000,-2017,-23583,-17583
421.474201,5,2471,2491,-20,20,124100,124000,10169,-243069,-245069
421.474201,6,0,0,0,0,124100,124000,0,0,0
421.70507,0,545,645,-100,100,124400,124000,30201,244199,219399
421.70507,1,531,631,-100,100,124400,124000,29501,91299,66499
421.70507,2,3829,3852,-23,23,124400,124000,18952,-375852,-381556
421.70507,3,471,564,-93,93,124400,124000,16177,143123,120059
421.70507,4,110,50,60,-60,124400,124000,-2017,-23583,-8703
421.70507,5,2471,2491,-20,20,124400,124000,10169,-243069,-248029
421.70507,6,0,0,0,0,124400,124000,0,0,0
421.973367,0,545,645,-100,100,123500,123800,30201,244199,268999
421.973367,1,531,631,-100,100,123500,123800,29501,91299,116099
421.973367,2,3839,3852,-13,13,123500,123800,18828,-381728,-378504
421.973367,3,473,564,-91,91,123500,123800,16152,143148,165716
421.973367,4,110,50,60,-60,123500,123800,-2017,-23583,-38463
421.973367,5,2481,2491,-10,10,123500,123800,10045,-246945,-244465
421.973367,6,0,0,0,0,123500,123800,0,0,0
422.228059,0,545,645,-100,100,123500,123600,30201,244199,254199
422.228059,1,531,631,-100,100,123500,123600,29501,91299,101299
422.228059,2,3839,3852,-13,13,123500,123600,18828,-381728,-380428
422.228059,3,473,564,-91,91,123500,123600,16152,143148,152248
422.228059,4,110,50,60,-60,123500,123600,-2017,-23583,-29583
422.228059,5,2481,2491,-10,10,123500,123600,10045,-246945,-245945
422.228059,6,0,0,0,0,123500,123600,0,0,0
422.544006,0,545,645,-100,100,123500,123600,30201,244199,254199
422.544006,1,531,631,-100,100,123500,123600,29501,91299,101299
422.544006,2,3839,3852,-13,13,123500,123600,18828,-381728,-380428
422.544006,3,473,564,-91,91,123500,123600,16152,143148,152248
422.544006,4,110,50,60,-60,123500,123600,-2017,-23583,-29583
422.544006,5,2481,2491,-10,10,123500,123600,10045,-246945,-245945
422.544006,6,0,0,0,0,123500,123600,0,0,0
422.776724,0,545,645,-100,100,123500,123600,30201,244199,254199
422.776724,1,531,631,-100,100,123500,123600,29501,91299,101299
422.776724,2,3839,3852,-13,13,123500,123600,18828,-381728,-380428
422.776724,3,473,564,-91,91,123500,123600,16152,143148,152248
422.776724,4,110,50,60,-60,123500,123600,-2017,-23583,-29583
422.776724,5,2481,2491,-10,10,123500,123600,10045,-246945,-245945
422.776724,6,0,0,0,0,123500,123600,0,0,0
423.032822,0,545,645,-100,100,123500,123600,30201,244199,254199
423.032822,1,531,631,-100,100,123500,123600,29501,91299,101299
423.032822,2,3839,3852,-13,13,123500,123600,18828,-381728,-380428
423.032822,3,473,564,-91,91,123500,123600,16152,143148,152248
423.032822,4,110,50,60,-60,123500,123600,-2017,-23583,-29583
423.032822,5,2481,2491,-10,10,123500,123600,10045,-246945,-245945
423.032822,6,0,0,0,0,123500,123600,0,0,0
423.208833,0,545,645,-100,100,123500,123600,30201,244199,254199
423.208833,1,531,631,-100,100,123500,123600,29501,91299,101299
423.208833,2,3839,3852,-13,13,123500,123600,18828,-381728,-380428
423.208833,3,473,564,-91,91,123500,123600,16152,143148,152248
423.208833,4,110,50,60,-60,123500,123600,-2017,-23583,-29583
423.208833,5,2481,2491,-10,10,123500,123600,10045,-246945,-245945
423.208833,6,0,0,0,0,123500,123600,0,0,0
423.530129,0,545,645,-100,100,123500,123600,30201,244199,254199
423.530129,1,531,631,-100,100,123500,123600,29501,91299,101299
423.530129,2,3839,3852,-13,13,123500,123600,18828,-381728,-380428
423.530129,3,473,564,-91,91,123500,123600,16152,143148,152248
423.530129,4,110,50,60,-60,123500,123600,-2017,-23583,-29583
423.530129,5,2481,2491,-10,10,123500,123600,10045,-246945,-245945
423.530129,6,0,0,0,0,123500,123600,0,0,0
423.783364,0,545,645,-100,100,123500,123600,30201,244199,254199
423.783364,1,531,631,-100,100,123500,123600,29501,91299,101299
423.783364,2,3839,3852,-13,13,123500,123600,18828,-381728,-380428
423.783364,3,473,564,-91,91,123500,123600,16152,143148,152248
423.783364,4,110,50,60,-60,123500,123600,-2017,-23583,-29583
423.783364,5,2481,2491,-10,10,123500,123600,10045,-246945,-245945
423.783364,6,0,0,0,0,123500,123600,0,0,0
423.976372,0,545,645,-100,100,123500,123600,30201,244199,254199
423.976372,1,531,631,-100,100,123500,123600,29501,91299,101299
423.976372,2,3839,3852,-13,13,123500,123600,18828,-381728,-380428
423.976372,3,473,564,-91,91,123500,123600,16152,143148,152248
423.976372,4,110,50,60,-60,123500,123600,-2017,-23583,-29583
423.976372,5,2481,2491,-10,10,123500,123600,10045,-246945,-245945
423.976372,6,0,0,0,0,123500,123600,0,0,0
424.228946,0,545,645,-100,100,123500,123600,30201,244199,254199
424.228946,1,531,631,-100,100,123500,123600,29501,91299,101299
424.228946,2,3839,3852,-13,13,123500,123600,18828,-381728,-380428
424.228946,3,473,564,-91,91,123500,123600,16152,143148,152248
424.228946,4,110,50,60,-60,123500,123600,-2017,-23583,-29583
424.228946,5,2481,2491,-10,10,123500,123600,10045,-246945,-245945
424.228946,6,0,0,0,0,123500,123600,0,0,0
424.527021,0,545,645,-100,100,123500,123600,30201,244199,254199
424.527021,1,531,631,-100,100,123500,123600,29501,91299,101299
424.527021,2,3839,3852,-13,13,123500,123600,18828,-381728,-380428
424.527021,3,473,564,-91,91,123500,123600,16152,143148,152248
424.527021,4,110,50,60,-60,123500,123600,-2017,-23583,-29583
424.527021,5,2481,2491,-10,10,123500,123600,10045,-246945,-245945
424.527021,6,0,0,0,0,123500,123600,0,0,0
424.751005,0,545,645,-100,100,123500,123600,30201,244199,254199
424.751005,1,531,631,-100,100,123500,123600,29501,91299,101299
424.751005,2,3839,3852,-13,13,123500,123600,18828,-381728,-380428
424.751005,3,473,564,-91,91,123500,123600,16152,143148,152248
424.751005,4,110,50,60,-60,123500,123600,-2017,-23583,-29583
424.751005,5,2481,2491,-10,10,123500,123600,10045,-246945,-245945
424.751005,6,0,0,0,0,123500,123600,0,0,0
424.964006,0,545,645,-100,100,123500,123900,30201,244199,268999
424.964006,1,531,631,-100,100,123500,123900,29501,91299,116099
424.964006,2,3839,3852,-13,13,123500,123900,18828,-381728,-378504
424.964006,3,473,564,-91,91,123500,123900,16152,143148,165716
424.964006,4,110,50,60,-60,123500,123900,-2017,-23583,-38463
424.964006,5,2481,2491,-10,10,123500,123900,10045,-246945,-244465
424.964006,6,0,0,0,0,123500,123900,0,0,0
425.210972,0,545,645,-100,100,124400,123900,30201,244199,219399
425.210972,1,531,631,-100,100,124400,123900,29501,91299,66499
425.210972,2,3839,3852,-13,13,124400,123900,18828,-381728,-384952
425.210972,3,473,564,-91,91,124400,123900,16152,143148,120580
425.210972,4,110,50,60,-60,124400,123900,-2017,-23583,-8703
425.210972,5,2481,2491,-10,10,124400,123900,10045,-246945,-249425
425.210972,6,0,0,0,0,124400,123900,0,0,0
425.506604,0,545,645,-100,100,124400,123900,30201,244199,219399
425.506604,1,531,631,-100,100,124400,123900,29501,91299,66499
425.506604,2,3839,3852,-13,13,124400,123900,18828,-381728,-384952
425.506604,3,473,564,-91,91,124400,123900,16152,143148,120580
425.506604,4,110,50,60,-60,124400,123900,-2017,-23583,-8703
425.506604,5,2481,2491,-10,10,124400,123900,10045,-246945,-249425
425.506604,6,0,0,0,0,124400,123900,0,0,0
425.781827,0,545,645,-100,100,124400,123900,30201,244199,219399
425.781827,1,531,631,-100,100,124400,123900,29501,91299,66499
425.781827,2,3839,3852,-13,13,124400,123900,18828,-381728,-384952
425.781827,3,473,564,-91,91,124400,123900,16152,143148,120580
425.781827,4,110,50,60,-60,124400,123900,-2017,-23583,-8703
425.781827,5,2481,2491,-10,10,124400,123900,10045,-246945,-249425
425.781827,6,0,0,0,0,124400,123900,0,0,0
426.027888,0,545,645,-100,100,124400,123900,30201,244199,219399
426.027888,1,531,631,-100,100,124400,123900,29501,91299,66499
426.027888,2,3839,3852,-13,13,124400,123900,18828,-381728,-384952
426.027888,3,473,564,-91,91,124400,123900,16152,143148,120580
426.027888,4,110,50,60,-60,124400,123900,-2017,-23583,-8703
426.027888,5,2481,2491,-10,10,124400,123900,10045,-246945,-249425
426.027888,6,0,0,0,0,124400,123900,0,0,0
426.237565,0,545,645,-100,100,124400,124300,30201,244199,234199
426.237565,1,531,631,-100,100,124400,124300,29501,91299,81299
426.237565,2,3839,3852,-13,13,124400,124300,18828,-381728,-383028
426.237565,3,473,564,-91,91,124400,124300,16152,143148,134048
426.237565,4,110,50,60,-60,124400,124300,-2017,-23583,-17583
426.237565,5,2481,2491,-10,10,124400,124300,10045,-246945,-247945
426.237565,6,0,0,0,0,124400,124300,0,0,0
426.524752,0,545,645,-100,100,124700,124300,30201,244199,219299
426.524752,1,531,631,-100,100,124700,124300,29501,91299,66399
426.524752,2,3845,3870,-25,25,124700,124300,18753,-382653,-388878
426.524752,3,481,564,-83,83,124700,124300,16352,139748,119081
426.524752,4,110,50,60,-60,124700,124300,-2017,-23583,-8643
426.524752,5,2491,2491,0,0,124700,124300,10294,-247194,-247194
426.524752,6,0,0,0,0,124700,124300,0,0,0
426.736635,0,545,645,-100,100,124600,124300,30201,244199,219299
426.736635,1,531,631,-100,100,124600,124300,29501,91299,66399
426.736635,2,3855,3870,-15,15,124600,124300,19002,-385902,-389637
426.736635,3,481,564,-83,83,124600,124300,16352,139748,119081
426.736635,4,110,50,60,-60,124600,124300,-2017,-23583,-8643
426.736635,5,2491,2501,-10,10,124600,124300,10169,-245069,-247559
426.736635,6,0,0,0,0,124600,124300,0,0,0
426.968817,0,545,645,-100,100,124600,124500,30201,244199,234199
426.968817,1,531,631,-100,100,124600,124500,29501,91299,81299
426.968817,2,3855,3870,-15,15,124600,124500,19002,-385902,-387402
426.968817,3,481,564,-83,83,124600,124500,16352,139748,131448
426.968817,4,110,50,60,-60,124600,124500,-2017,-23583,-17583
426.968817,5,2491,2501,-10,10,124600,124500,10169,-245069,-246069
426.968817,6,0,0,0,0,124600,124500,0,0,0
427.203504,0,545,645,-100,100,123900,124400,30201,244199,269099
427.203504,1,531,631,-100,100,123900,124400,29501,91299,116199
427.203504,2,3865,3870,-5,5,123900,124400,18877,-387777,-386532
427.203504,3,483,564,-81,81,123900,124400,16327,140373,160542
427.203504,4,110,50,60,-60,123900,124400,-2017,-23583,-38523
427.203504,5,2501,2501,0,0,123900,124400,10045,-244945,-244945
427.203504,6,0,0,0,0,123900,124400,0,0,0
427.468605,0,545,645,-100,100,124700,124400,30201,244199,219299
427.468605,1,531,631,-100,100,124700,124400,29501,91299,66399
427.468605,2,3865,3870,-5,5,124700,124400,18877,-387777,-389022
427.468605,3,483,564,-81,81,124700,124400,16327,140373,120204
427.468605,4,110,50,60,-60,124700,124400,-2017,-23583,-8643
427.468605,5,2501,2501,0,0,124700,124400,10045,-244945,-244945
427.468605,6,0,0,0,0,124700,124400,0,0,0
427.713691,0,545,645,-100,100,124700,124400,30201,244199,219299
427.713691,1,531,631,-100,100,124700,124400,29501,91299,66399
427.713691,2,3865,3870,-5,5,124700,124400,18877,-387777,-389022
427.713691,3,483,564,-81,81,124700,124400,16327,140373,120204
427.713691,4,110,50,60,-60,124700,124400,-2017,-23583,-8643
427.713691,5,2501,2501,0,0,124700,124400,10045,-244945,-244945
427.713691,6,0,0,0,0,124700,124400,0,0,0
427.952395,0,545,645,-100,100,124500,124400,30201,244199,234199
427.952395,1,531,631,-100,100,124500,124400,29501,91299,81299
427.952395,2,3875,3870,5,-5,124500,124400,19126,-390026,-389526
427.952395,3,483,564,-81,81,124500,124400,16327,140373,132273
427.952395,4,110,50,60,-60,124500,124400,-2017,-23583,-17583
427.952395,5,2501,2511,-10,10,124500,124400,9921,-244821,-245821
427.952395,6,0,0,0,0,124500,124400,0,0,0
428.284186,0,545,645,-100,100,124500,124400,30201,244199,234199
428.284186,1,531,631,-100,100,124500,124400,29501,91299,81299
428.284186,2,3875,3870,5,-5,124500,124400,19126,-390026,-389526
428.284186,3,483,564,-81,81,124500,124400,16327,140373,132273
428.284186,4,110,50,60,-60,124500,124400,-2017,-23583,-17583
428.284186,5,2501,2511,-10,10,124500,124400,9921,-244821,-245821
428.284186,6,0,0,0,0,124500,124400,0,0,0
428.543618,0,545,645,-100,100,124700,124400,30201,244199,219299
428.543618,1,531,631,-100,100,124700,124400,29501,91299,66399
428.543618,2,3875,3880,-5,5,124700,124400,19375,-390275,-391520
428.543618,3,483,566,-83,83,124700,124400,16302,140998,120331
428.543618,4,110,50,60,-60,124700,124400,-2017,-23583,-8643
428.543618,5,2511,2511,0,0,124700,124400,9797,-245697,-245697
428.543618,6,0,0,0,0,124700,124400,0,0,0
428.75392,0,545,645,-100,100,124700,124400,30201,244199,219299
428.75392,1,531,631,-100,100,124700,124400,29501,91299,66399
428.75392,2,3875,3880,-5,5,124700,124400,19375,-390275,-391520
428.75392,3,483,566,-83,83,124700,124400,16302,140998,120331
428.75392,4,110,50,60,-60,124700,124400,-2017,-23583,-8643
428.75392,5,2511,2511,0,0,124700,124400,9797,-245697,-245697
428.75392,6,0,0,0,0,124700,124400,0,0,0
428.963658,0,545,645,-100,100,124700,124400,30201,244199,219299
428.963658,1,531,631,-100,100,124700,124400,29501,91299,66399
428.963658,2,3875,3880,-5,5,124700,124400,19375,-390275,-391520
428.963658,3,483,566,-83,83,124700,124400,16302,140998,120331
428.963658,4,110,50,60,-60,124700,124400,-2017,-23583,-8643
428.963658,5,2511,2511,0,0,124700,124400,9797,-245697,-245697
428.963658,6,0,0,0,0,124700,124400,0,0,0
429.270516,0,545,645,-100,100,124700,124100,30201,244199,219399
429.270516,1,531,631,-100,100,124700,124100,29501,91299,66499
429.270516,2,3875,3890,-15,15,124700,124100,19251,-389151,-392871
429.270516,3,483,568,-85,85,124700,124100,16277,141623,120543
429.270516,4,110,50,60,-60,124700,124100,-2017,-23583,-8703
429.270516,5,2511,2511,0,0,124700,124100,9797,-245697,-245697
429.270516,6,0,0,0,0,124700,124100,0,0,0
429.47288,0,545,645,-100,100,124700,124100,30201,244199,219399
429.47288,1,531,631,-100,100,124700,124100,29501,91299,66499
429.47288,2,3875,3890,-15,15,124700,124100,19251,-389151,-392871
429.47288,3,483,568,-85,85,124700,124100,16277,141623,120543
429.47288,4,110,50,60,-60,124700,124100,-2017,-23583,-8703
429.47288,5,2511,2511,0,0,124700,124100,9797,-245697,-245697
429.47288,6,0,0,0,0,124700,124100,0,0,0
429.748614,0,545,645,-100,100,124200,124100,30201,244199,234199
429.748614,1,531,631,-100,100,124200,124100,29501,91299,81299
429.748614,2,3885,3900,-15,15,124200,124100,19003,-387903,-389403
429.748614,3,483,570,-87,87,124200,124100,16252,142448,133748
429.748614,4,110,50,60,-60,124200,124100,-2017,-23583,-17583
429.748614,5,2511,2521,-10,10,124200,124100,10045,-244945,-245945
429.748614,6,0,0,0,0,124200,124100,0,0,0
430.040112,0,545,645,-100,100,124200,124100,30201,244199,234199
430.040112,1,531,631,-100,100,124200,124100,29501,91299,81299
430.040112,2,3885,3900,-15,15,124200,124100,19003,-387903,-389403
430.040112,3,483,570,-87,87,124200,124100,16252,142448,133748
430.040112,4,110,50,60,-60,124200,124100,-2017,-23583,-17583
430.040112,5,2511,2521,-10,10,124200,124100,10045,-244945,-245945
430.040112,6,0,0,0,0,124200,124100,0,0,0
430.266764,0,545,645,-100,100,124200,124100,30201,244199,234199
430.266764,1,531,631,-100,100,124200,124100,29501,91299,81299
430.266764,2,3885,3900,-15,15,124200,124100,19003,-387903,-389403
430.266764,3,483,570,-87,87,124200,124100,16252,142448,133748
430.266764,4,110,50,60,-60,124200,124100,-2017,-23583,-17583
430.266764,5,2511,2521,-10,10,124200,124100,10045,-244945,-245945
430.266764,6,0,0,0,0,124200,124100,0,0,0
430.487047,0,545,645,-100,100,124200,124100,30201,244199,234199
430.487047,1,531,631,-100,100,124200,124100,29501,91299,81299
430.487047,2,3885,3900,-15,15,124200,124100,19003,-387903,-389403
430.487047,3,483,570,-87,87,124200,124100,16252,142448,133748
430.487047,4,110,50,60,-60,124200,124100,-2017,-23583,-17583
430.487047,5,2511,2521,-10,10,124200,124100,10045,-244945,-245945
430.487047,6,0,0,0,0,124200,124100,0,0,0
430.784564,0,545,645,-100,100,124300,124100,30201,244199,224199
430.784564,1,531,631,-100,100,124300,124100,29501,91299,71299
430.784564,2,3885,3903,-18,18,124300,124100,18966,-387266,-390866
430.784564,3,483,570,-87,87,124300,124100,16252,142448,125048
430.784564,4,110,50,60,-60,124300,124100,-2017,-23583,-11583
430.784564,5,2511,2521,-10,10,124300,124100,10045,-244945,-246945
430.784564,6,0,0,0,0,124300,124100,0,0,0
431.03832,0,545,645,-100,100,124000,124100,30201,244199,254199
431.03832,1,531,631,-100,100,124000,124100,29501,91299,101299
431.03832,2,3895,3903,-8,8,124000,124100,18842,-389142,-388342
431.03832,3,483,570,-87,87,124000,124100,16252,142448,151148
431.03832,4,110,50,60,-60,124000,124100,-2017,-23583,-29583
431.03832,5,2521,2521,0,0,124000,124100,9921,-246821,-246821
431.03832,6,0,0,0,0,124000,124100,0,0,0
431.291532,0,545,645,-100,100,123500,124100,30201,244199,268999
431.291532,1,531,631,-100,100,123500,124100,29501,91299,116099
431.291532,2,3905,3903,2,-2,123500,124100,18718,-390018,-390514
431.291532,3,485,570,-85,85,123500,124100,16227,143073,164153
431.291532,4,110,50,60,-60,123500,124100,-2017,-23583,-38463
431.291532,5,2531,2521,10,-10,123500,124100,9797,-247697,-250177
431.291532,6,0,0,0,0,123500,124100,0,0,0
431.547531,0,545,645,-100,100,123500,124100,30201,244199,268999
431.547531,1,531,631,-100,100,123500,124100,29501,91299,116099
431.547531,2,3905,3903,2,-2,123500,124100,18718,-390018,-390514
431.547531,3,485,570,-85,85,123500,124100,16227,143073,164153
431.547531,4,110,50,60,-60,123500,124100,-2017,-23583,-38463
431.547531,5,2531,2521,10,-10,123500,124100,9797,-247697,-250177
431.547531,6,0,0,0,0,123500,124100,0,0,0
431.701189,0,545,645,-100,100,124800,124100,30201,244199,219399
431.701189,1,531,631,-100,100,124800,124100,29501,91299,66499
431.701189,2,3905,3913,-8,8,124800,124100,18594,-389894,-391878
431.701189,3,485,572,-87,87,124800,124100,16202,143698,122122
431.701189,4,110,50,60,-60,124800,124100,-2017,-23583,-8703
431.701189,5,2531,2531,0,0,124800,124100,9673,-247573,-247573
431.701189,6,0,0,0,0,124800,124100,0,0,0
432.02524,0,545,645,-100,100,123500,124100,30201,244199,268999
432.02524,1,531,631,-100,100,123500,124100,29501,91299,116099
432.02524,2,3915,3913,2,-2,123500,124100,18470,-390770,-391266
432.02524,3,487,572,-85,85,123500,124100,16177,144323,165403
432.02524,4,110,50,60,-60,123500,124100,-2017,-23583,-38463
432.02524,5,2541,2531,10,-10,123500,124100,9549,-246449,-248929
432.02524,6,0,0,0,0,123500,124100,0,0,0
432.235706,0,545,645,-100,100,123500,124100,30201,244199,268999
432.235706,1,531,631,-100,100,123500,124100,29501,91299,116099
432.235706,2,3915,3913,2,-2,123500,124100,18470,-390770,-391266
432.235706,3,487,572,-85,85,123500,124100,16177,144323,165403
432.235706,4,110,50,60,-60,123500,124100,-2017,-23583,-38463
432.235706,5,2541,2531,10,-10,123500,124100,9549,-246449,-248929
432.235706,6,0,0,0,0,123500,124100,0,0,0
432.464247,0,545,645,-100,100,124400,124000,30201,244199,219399
432.464247,1,531,631,-100,100,124400,124000,29501,91299,66499
432.464247,2,3923,3923,0,0,124400,124000,18247,-390547,-390547
432.464247,3,487,574,-87,87,124400,124000,16152,145748,124172
432.464247,4,110,50,60,-60,124400,124000,-2017,-23583,-8703
432.464247,5,2541,2531,10,-10,124400,124000,9549,-246449,-243969
432.464247,6,0,0,0,0,124400,124000,0,0,0
432.790543,0,545,645,-100,100,123700,124000,30201,244199,268999
432.790543,1,531,631,-100,100,123700,124000,29501,91299,116099
432.790543,2,3923,3933,-10,10,123700,124000,18496,-382796,-380316
432.790543,3,487,576,-89,89,123700,124000,16202,147298,169370
432.790543,4,110,50,60,-60,123700,124000,-2017,-23583,-38463
432.790543,5,2541,2531,10,-10,123700,124000,9549,-246449,-248929
432.790543,6,0,0,0,0,123700,124000,0,0,0
432.993026,0,545,645,-100,100,123700,124000,30201,244199,268999
432.993026,1,531,631,-100,100,123700,124000,29501,91299,116099
432.993026,2,3924,3933,-9,9,123700,124000,18521,-382921,-380689
432.993026,3,487,576,-89,89,123700,124000,16202,147298,169370
432.993026,4,110,50,60,-60,123700,124000,-2017,-23583,-38463
432.993026,5,2541,2531,10,-10,123700,124000,9549,-246449,-248929
432.993026,6,0,0,0,0,123700,124000,0,0,0
433.299248,0,545,645,-100,100,123900,123600,30201,244199,219499
433.299248,1,531,631,-100,100,123900,123600,29501,91299,66599
433.299248,2,3924,3941,-17,17,123900,123600,18422,-382022,-386221
433.299248,3,495,576,-81,81,123900,123600,16400,144700,124693
433.299248,4,110,50,60,-60,123900,123600,-2017,-23583,-8763
433.299248,5,2541,2531,10,-10,123900,123600,9549,-246449,-243979
433.299248,6,0,0,0,0,123900,123600,0,0,0
433.520775,0,545,645,-100,100,123900,123600,30201,244199,219499
433.520775,1,531,631,-100,100,123900,123600,29501,91299,66599
433.520775,2,3924,3941,-17,17,123900,123600,18422,-382022,-386221
433.520775,3,495,576,-81,81,123900,123600,16400,144700,124693
433.520775,4,110,50,60,-60,123900,123600,-2017,-23583,-8763
433.520775,5,2541,2531,10,-10,123900,123600,9549,-246449,-243979
433.520775,6,0,0,0,0,123900,123600,0,0,0
433.709302,0,545,645,-100,100,123900,123600,30201,244199,219499
433.709302,1,531,631,-100,100,123900,123600,29501,91299,66599
433.709302,2,3924,3941,-17,17,123900,123600,18422,-382022,-386221
433.709302,3,495,576,-81,81,123900,123600,16400,144700,124693
433.709302,4,110,50,60,-60,123900,123600,-2017,-23583,-8763
433.709302,5,2541,2531,10,-10,123900,123600,9549,-246449,-243979
433.709302,6,0,0,0,0,123900,123600,0,0,0
433.952797,0,545,645,-100,100,123900,123600,30201,244199,219499
433.952797,1,531,631,-100,100,123900,123600,29501,91299,66599
433.952797,2,3924,3941,-17,17,123900,123600,18422,-382022,-386221
433.952797,3,495,576,-81,81,123900,123600,16400,144700,124693
433.952797,4,110,50,60,-60,123900,123600,-2017,-23583,-8763
433.952797,5,2541,2531,10,-10,123900,123600,9549,-246449,-243979
433.952797,6,0,0,0,0,123900,123600,0,0,0
434.223153,0,545,645,-100,100,123900,123600,30201,244199,219499
434.223153,1,531,631,-100,100,123900,123600,29501,91299,66599
434.223153,2,3924,3941,-17,17,123900,123600,18422,-382022,-386221
434.223153,3,495,576,-81,81,123900,123600,16400,144700,124693
434.223153,4,110,50,60,-60,123900,123600,-2017,-23583,-8763
434.223153,5,2541,2531,10,-10,123900,123600,9549,-246449,-243979
434.223153,6,0,0,0,0,123900,123600,0,0,0
434.526926,0,545,645,-100,100,123700,123600,30201,244199,234199
434.526926,1,531,631,-100,100,123700,123600,29501,91299,81299
434.526926,2,3934,3941,-7,7,123700,123600,18298,-383898,-384598
434.526926,3,495,576,-81,81,123700,123600,16400,144700,136600
434.526926,4,110,50,60,-60,123700,123600,-2017,-23583,-17583
434.526926,5,2541,2541,0,0,123700,123600,9796,-246696,-246696
434.526926,6,0,0,0,0,123700,123600,0,0,0
434.72826,0,545,645,-100,100,123700,123600,30201,244199,234199
434.72826,1,531,631,-100,100,123700,123600,29501,91299,81299
434.72826,2,3934,3941,-7,7,123700,123600,18298,-383898,-384598
434.72826,3,495,576,-81,81,123700,123600,16400,144700,136600
434.72826,4,110,50,60,-60,123700,123600,-2017,-23583,-17583
434.72826,5,2541,2541,0,0,123700,123600,9796,-246696,-246696
434.72826,6,0,0,0,0,123700,123600,0,0,0
435.032381,0,545,645,-100,100,123700,123700,30201,244199,244199
435.032381,1,531,631,-100,100,123700,123700,29501,91299,91299
435.032381,2,3934,3941,-7,7,123700,123700,18298,-383898,-383898
435.032381,3,495,576,-81,81,123700,123700,16400,144700,144700
435.032381,4,110,50,60,-60,123700,123700,-2017,-23583,-23583
435.032381,5,2541,2541,0,0,123700,123700,9796,-246696,-246696
435.032381,6,0,0,0,0,123700,123700,0,0,0
435.202867,0,545,645,-100,100,123700,123700,30201,244199,244199
435.202867,1,531,631,-100,100,123700,123700,29501,91299,91299
435.202867,2,3934,3941,-7,7,123700,123700,18298,-383898,-383898
435.202867,3,495,576,-81,81,123700,123700,16400,144700,144700
435.202867,4,110,50,60,-60,123700,123700,-2017,-23583,-23583
435.202867,5,2541,2541,0,0,123700,123700,9796,-246696,-246696
435.202867,6,0,0,0,0,123700,123700,0,0,0
435.475887,0,545,645,-100,100,123700,123700,30201,244199,244199
435.475887,1,531,631,-100,100,123700,123700,29501,91299,91299
435.475887,2,3934,3941,-7,7,123700,123700,18298,-383898,-383898
435.475887,3,495,576,-81,81,123700,123700,16400,144700,144700
435.475887,4,110,50,60,-60,123700,123700,-2017,-23583,-23583
435.475887,5,2541,2541,0,0,123700,123700,9796,-246696,-246696
435.475887,6,0,0,0,0,123700,123700,0,0,0
435.747674,0,545,645,-100,100,123500,123700,30201,244199,264199
435.747674,1,531,631,-100,100,123500,123700,29501,91299,111299
435.747674,2,3944,3941,3,-3,123500,123700,18174,-384774,-385374
435.747674,3,503,576,-73,73,123500,123700,16562,143438,158038
435.747674,4,110,50,60,-60,123500,123700,-2017,-23583,-35583
435.747674,5,2551,2548,3,-3,123500,123700,9585,-245785,-246385
435.747674,6,0,0,0,0,123500,123700,0,0,0
436.040221,0,545,645,-100,100,123500,123700,30201,244199,264199
436.040221,1,531,631,-100,100,123500,123700,29501,91299,111299
436.040221,2,3944,3941,3,-3,123500,123700,18174,-384774,-385374
436.040221,3,503,576,-73,73,123500,123700,16562,143438,158038
436.040221,4,110,50,60,-60,123500,123700,-2017,-23583,-35583
436.040221,5,2551,2548,3,-3,123500,123700,9585,-245785,-246385
436.040221,6,0,0,0,0,123500,123700,0,0,0
436.231957,0,545,645,-100,100,123400,123700,30201,244199,268899
436.231957,1,531,631,-100,100,123400,123700,29501,91299,115999
436.231957,2,3954,3941,13,-13,123400,123700,18050,-384650,-387861
436.231957,3,503,576,-73,73,123400,123700,16562,143438,161469
436.231957,4,110,50,60,-60,123400,123700,-2017,-23583,-38403
436.231957,5,2561,2548,13,-13,123400,123700,9461,-245661,-248872
436.231957,6,0,0,0,0,123400,123700,0,0,0
436.520081,0,545,645,-100,100,123600,123600,30201,244199,244199
436.520081,1,531,631,-100,100,123600,123600,29501,91299,91299
436.520081,2,3964,3951,13,-13,123600,123600,17802,-384402,-384402
436.520081,3,503,576,-73,73,123600,123600,16562,143438,143438
436.520081,4,110,50,60,-60,123600,123600,-2017,-23583,-23583
436.520081,5,2571,2558,13,-13,123600,123600,9955,-248155,-248155
436.520081,6,0,0,0,0,123600,123600,0,0,0
436.707707,0,545,645,-100,100,123600,123600,30201,244199,244199
436.707707,1,531,631,-100,100,123600,123600,29501,91299,91299
436.707707,2,3964,3951,13,-13,123600,123600,17802,-384402,-384402
436.707707,3,503,576,-73,73,123600,123600,16562,143438,143438
436.707707,4,110,50,60,-60,123600,123600,-2017,-23583,-23583
436.707707,5,2571,2558,13,-13,123600,123600,9955,-248155,-248155
436.707707,6,0,0,0,0,123600,123600,0,0,0
436.977574,0,545,645,-100,100,123600,123600,30201,244199,244199
436.977574,1,531,631,-100,100,123600,123600,29501,91299,91299
436.977574,2,3964,3951,13,-13,123600,123600,17802,-384402,-384402
436.977574,3,503,576,-73,73,123600,123600,16562,143438,143438
436.977574,4,110,50,60,-60,123600,123600,-2017,-23583,-23583
436.977574,5,2571,2558,13,-13,123600,123600,9955,-248155,-248155
436.977574,6,0,0,0,0,123600,123600,0,0,0
437.283573,0,545,645,-100,100,123500,123500,30201,244199,244199
437.283573,1,531,631,-100,100,123500,123500,29501,91299,91299
437.283573,2,3964,3958,6,-6,123500,123500,17716,-384316,-384316
437.283573,3,510,576,-66,66,123500,123500,16735,142565,142565
437.283573,4,110,50,60,-60,123500,123500,-2017,-23583,-23583
437.283573,5,2571,2558,13,-13,123500,123500,9955,-248155,-248155
437.283573,6,0,0,0,0,123500,123500,0,0,0
437.478901,0,545,645,-100,100,123500,123500,30201,244199,244199
437.478901,1,531,631,-100,100,123500,123500,29501,91299,91299
437.478901,2,3964,3958,6,-6,123500,123500,17716,-384316,-384316
437.478901,3,510,576,-66,66,123500,123500,16735,142565,142565
437.478901,4,110,50,60,-60,123500,123500,-2017,-23583,-23583
437.478901,5,2571,2558,13,-13,123500,123500,9955,-248155,-248155
437.478901,6,0,0,0,0,123500,123500,0,0,0
437.725749,0,545,645,-100,100,123500,123500,30201,244199,244199
437.725749,1,531,631,-100,100,123500,123500,29501,91299,91299
437.725749,2,3964,3958,6,-6,123500,123500,17716,-384316,-384316
437.725749,3,510,576,-66,66,123500,123500,16735,142565,142565
437.725749,4,110,50,60,-60,123500,123500,-2017,-23583,-23583
437.725749,5,2571,2558,13,-13,123500,123500,9955,-248155,-248155
437.725749,6,0,0,0,0,123500,123500,0,0,0
438.009248,0,545,645,-100,100,123500,123500,30201,244199,244199
438.009248,1,531,631,-100,100,123500,123500,29501,91299,91299
438.009248,2,3964,3958,6,-6,123500,123500,17716,-384316,-384316
438.009248,3,510,576,-66,66,123500,123500,16735,142565,142565
438.009248,4,110,50,60,-60,123500,123500,-2017,-23583,-23583
438.009248,5,2571,2558,13,-13,123500,123500,9955,-248155,-248155
438.009248,6,0,0,0,0,123500,123500,0,0,0
438.263762,0,545,645,-100,100,123500,123500,30201,244199,244199
438.263762,1,531,631,-100,100,123500,123500,29501,91299,91299
438.263762,2,3964,3958,6,-6,123500,123500,17716,-384316,-384316
438.263762,3,510,576,-66,66,123500,123500,16735,142565,142565
438.263762,4,110,50,60,-60,123500,123500,-2017,-23583,-23583
438.263762,5,2571,2558,13,-13,123500,123500,9955,-248155,-248155
438.263762,6,0,0,0,0,123500,123500,0,0,0
438.504414,0,545,645,-100,100,123500,123300,30201,244199,224199
438.504414,1,531,631,-100,100,123500,123300,29501,91299,71299
438.504414,2,3964,3958,6,-6,123500,123300,17716,-384316,-383116
438.504414,3,510,576,-66,66,123500,123300,16735,142565,129365
438.504414,4,110,50,60,-60,123500,123300,-2017,-23583,-11583
438.504414,5,2571,2558,13,-13,123500,123300,9955,-248155,-245555
438.504414,6,0,0,0,0,123500,123300,0,0,0
438.743356,0,545,645,-100,100,123400,123300,30201,244199,234199
438.743356,1,531,631,-100,100,123400,123300,29501,91299,81299
438.743356,2,3964,3968,-4,4,123400,123300,17963,-384563,-384963
438.743356,3,510,576,-66,66,123400,123300,16735,142565,135965
438.743356,4,110,50,60,-60,123400,123300,-2017,-23583,-17583
438.743356,5,2571,2558,13,-13,123400,123300,9955,-248155,-246855
438.743356,6,0,0,0,0,123400,123300,0,0,0
439.025531,0,545,645,-100,100,124000,123300,30201,244199,219499
439.025531,1,531,631,-100,100,124000,123300,29501,91299,66599
439.025531,2,3964,3978,-14,14,124000,123300,17839,-383439,-386897
439.025531,3,510,578,-68,68,124000,123300,16710,143190,126394
439.025531,4,110,50,60,-60,124000,123300,-2017,-23583,-8763
439.025531,5,2571,2558,13,-13,124000,123300,9955,-248155,-244944
439.025531,6,0,0,0,0,124000,123300,0,0,0
439.291404,0,545,645,-100,100,124000,123300,30201,244199,219499
439.291404,1,531,631,-100,100,124000,123300,29501,91299,66599
439.291404,2,3964,3978,-14,14,124000,123300,17839,-383439,-386897
439.291404,3,510,578,-68,68,124000,123300,16710,143190,126394
439.291404,4,110,50,60,-60,124000,123300,-2017,-23583,-8763
439.291404,5,2571,2558,13,-13,124000,123300,9955,-248155,-244944
439.291404,6,0,0,0,0,124000,123300,0,0,0
439.533486,0,545,645,-100,100,123400,123300,30201,244199,234199
439.533486,1,531,631,-100,100,123400,123300,29501,91299,81299
439.533486,2,3974,3978,-4,4,123400,123300,17715,-386315,-386715
439.533486,3,510,578,-68,68,123400,123300,16710,143190,136390
439.533486,4,110,50,60,-60,123400,123300,-2017,-23583,-17583
439.533486,5,2571,2558,13,-13,123400,123300,9955,-248155,-246855
439.533486,6,0,0,0,0,123400,123300,0,0,0
439.768409,0,545,645,-100,100,123300,123300,30201,244199,244199
439.768409,1,531,631,-100,100,123300,123300,29501,91299,91299
439.768409,2,3974,3978,-4,4,123300,123300,17715,-386315,-386315
439.768409,3,510,578,-68,68,123300,123300,16710,143190,143190
439.768409,4,110,50,60,-60,123300,123300,-2017,-23583,-23583
439.768409,5,2571,2558,13,-13,123300,123300,9955,-248155,-248155
439.768409,6,0,0,0,0,123300,123300,0,0,0
439.984081,0,545,645,-100,100,123300,123300,30201,244199,244199
439.984081,1,531,631,-100,100,123300,123300,29501,91299,91299
439.984081,2,3974,3978,-4,4,123300,123300,17715,-386315,-386315
439.984081,3,510,578,-68,68,123300,123300,16710,143190,143190
439.984081,4,110,50,60,-60,123300,123300,-2017,-23583,-23583
439.984081,5,2571,2558,13,-13,123300,123300,9955,-248155,-248155
439.984081,6,0,0,0,0,123300,123300,0,0,0
440.20386,0,545,645,-100,100,123300,123300,30201,244199,244199
440.20386,1,531,631,-100,100,123300,123300,29501,91299,91299
440.20386,2,3974,3978,-4,4,123300,123300,17715,-386315,-386315
440.20386,3,510,578,-68,68,123300,123300,16710,143190,143190
440.20386,4,110,50,60,-60,123300,123300,-2017,-23583,-23583
440.20386,5,2571,2558,13,-13,123300,123300,9955,-248155,-248155
440.20386,6,0,0,0,0,123300,123300,0,0,0
440.548592,0,545,645,-100,100,123300,123000,30201,244199,219599
440.548592,1,531,631,-100,100,123300,123000,29501,91299,66699
440.548592,2,3974,3978,-4,4,123300,123000,17715,-386315,-387299
440.548592,3,510,578,-68,68,123300,123000,16710,143190,126462
440.548592,4,110,50,60,-60,123300,123000,-2017,-23583,-8823
440.548592,5,2571,2558,13,-13,123300,123000,9955,-248155,-244957
440.548592,6,0,0,0,0,123300,123000,0,0,0
440.765907,0,545,645,-100,100,123300,123000,30201,244199,219599
440.765907,1,531,631,-100,100,123300,123000,29501,91299,66699
440.765907,2,3978,3988,-10,10,123300,123000,17912,-385912,-388372
440.765907,3,510,582,-72,72,123300,123000,16808,144692,126980
440.765907,4,110,50,60,-60,123300,123000,-2017,-23583,-8823
440.765907,5,2571,2558,13,-13,123300,123000,9955,-248155,-244957
440.765907,6,0,0,0,0,123300,123000,0,0,0
440.990125,0,545,645,-100,100,123300,123000,30201,244199,219599
440.990125,1,531,631,-100,100,123300,123000,29501,91299,66699
440.990125,2,3978,3998,-20,20,123300,123000,18159,-383159,-388079
440.990125,3,510,584,-74,74,123300,123000,16857,145243,127039
440.990125,4,110,50,60,-60,123300,123000,-2017,-23583,-8823
440.990125,5,2571,2558,13,-13,123300,123000,9955,-248155,-244957
440.990125,6,0,0,0,0,123300,123000,0,0,0
441.234158,0,545,645,-100,100,123300,123000,30201,244199,219599
441.234158,1,531,631,-100,100,123300,123000,29501,91299,66699
441.234158,2,3978,4008,-30,30,123300,123000,18406,-380406,-387786
441.234158,3,510,586,-76,76,123300,123000,16906,145794,127098
441.234158,4,110,50,60,-60,123300,123000,-2017,-23583,-8823
441.234158,5,2571,2558,13,-13,123300,123000,9955,-248155,-244957
441.234158,6,0,0,0,0,123300,123000,0,0,0
441.456687,0,545,645,-100,100,123300,122800,30201,244199,219599
441.456687,1,531,631,-100,100,123300,122800,29501,91299,66699
441.456687,2,3978,4018,-40,40,123300,122800,18653,-377653,-387493
441.456687,3,510,588,-78,78,123300,122800,16955,146345,127157
441.456687,4,110,50,60,-60,123300,122800,-2017,-23583,-8823
441.456687,5,2571,2558,13,-13,123300,122800,9955,-248155,-244957
441.456687,6,0,0,0,0,123300,122800,0,0,0
441.722575,0,545,645,-100,100,123200,122800,30201,244199,219599
441.722575,1,531,631,-100,100,123200,122800,29501,91299,66699
441.722575,2,3978,4028,-50,50,123200,122800,18900,-373200,-385500
441.722575,3,510,590,-80,80,123200,122800,17004,147096,127416
441.722575,4,110,50,60,-60,123200,122800,-2017,-23583,-8823
441.722575,5,2571,2558,13,-13,123200,122800,9955,-248155,-244957
441.722575,6,0,0,0,0,123200,122800,0,0,0
442.00313,0,545,645,-100,100,123300,122800,30201,244199,219599
442.00313,1,531,631,-100,100,123300,122800,29501,91299,66699
442.00313,2,3982,4028,-46,46,123300,122800,18850,-375150,-386466
442.00313,3,510,594,-84,84,123300,122800,17102,148598,127934
442.00313,4,110,50,60,-60,123300,122800,-2017,-23583,-8823
442.00313,5,2571,2558,13,-13,123300,122800,9955,-248155,-244957
442.00313,6,0,0,0,0,123300,122800,0,0,0
442.250864,0,545,645,-100,100,123200,122800,30201,244199,219599
442.250864,1,531,631,-100,100,123200,122800,29501,91299,66699
442.250864,2,3984,4038,-54,54,123200,122800,19071,-371771,-385055
442.250864,3,510,596,-86,86,123200,122800,17151,149749,128593
442.250864,4,110,50,60,-60,123200,122800,-2017,-23583,-8823
442.250864,5,2571,2558,13,-13,123200,122800,9955,-248155,-244957
442.250864,6,0,0,0,0,123200,122800,0,0,0
442.46611,0,545,645,-100,100,123200,122400,30201,244199,219699
442.46611,1,531,631,-100,100,123200,122400,29501,91299,66799
442.46611,2,3994,4038,-44,44,123200,122400,18948,-380648,-391428
442.46611,3,510,598,-88,88,123200,122400,17200,150700,129140
442.46611,4,110,50,60,-60,123200,122400,-2017,-23583,-8883
442.46611,5,2571,2558,13,-13,123200,122400,9955,-248155,-244970
442.46611,6,0,0,0,0,123200,122400,0,0,0
442.754812,0,545,645,-100,100,123000,122300,30201,244199,219699
442.754812,1,531,631,-100,100,123000,122300,29501,91299,66799
442.754812,2,3994,4048,-54,54,123000,122300,19194,-374894,-388124
442.754812,3,510,598,-88,88,123000,122300,17200,150700,129140
442.754812,4,110,50,60,-60,123000,122300,-2017,-23583,-8883
442.754812,5,2571,2558,13,-13,123000,122300,9955,-248155,-244970
442.754812,6,0,0,0,0,123000,122300,0,0,0
442.996473,0,545,645,-100,100,123000,122600,30201,244199,219699
442.996473,1,531,631,-100,100,123000,122600,29501,91299,66799
442.996473,2,4004,4048,-44,44,123000,122600,19440,-381140,-391920
442.996473,3,510,598,-88,88,123000,122600,17200,150700,129140
442.996473,4,110,50,60,-60,123000,122600,-2017,-23583,-8883
442.996473,5,2571,2558,13,-13,123000,122600,9955,-248155,-244970
442.996473,6,0,0,0,0,123000,122600,0,0,0
443.289193,0,545,645,-100,100,123000,122600,30201,244199,219699
443.289193,1,531,631,-100,100,123000,122600,29501,91299,66799
443.289193,2,4006,4048,-42,42,123000,122600,19415,-382115,-392405
443.289193,3,510,600,-90,90,123000,122600,17249,151251,129201
443.289193,4,110,50,60,-60,123000,122600,-2017,-23583,-8883
443.289193,5,2571,2558,13,-13,123000,122600,9955,-248155,-244970
443.289193,6,0,0,0,0,123000,122600,0,0,0
443.504844,0,545,645,-100,100,122900,122800,30201,244199,234199
443.504844,1,531,631,-100,100,122900,122800,29501,91299,81299
443.504844,2,4014,4048,-34,34,122900,122800,19317,-385217,-388617
443.504844,3,510,600,-90,90,122900,122800,17249,151251,142251
443.504844,4,110,50,60,-60,122900,122800,-2017,-23583,-17583
443.504844,5,2571,2568,3,-3,122900,122800,10201,-246601,-246301
443.504844,6,0,0,0,0,122900,122800,0,0,0
443.735989,0,545,645,-100,100,123300,122800,30201,244199,219599
443.735989,1,531,631,-100,100,123300,122800,29501,91299,66699
443.735989,2,4024,4058,-34,34,123300,122800,19071,-384971,-393335
443.735989,3,510,600,-90,90,123300,122800,17249,151251,129111
443.735989,4,110,50,60,-60,123300,122800,-2017,-23583,-8823
443.735989,5,2571,2578,-7,7,123300,122800,10447,-244847,-246569
443.735989,6,0,0,0,0,123300,122800,0,0,0
444.040051,0,545,645,-100,100,123100,122900,30201,244199,224199
444.040051,1,531,631,-100,100,123100,122900,29501,91299,71299
444.040051,2,4031,4058,-27,27,123100,122900,19243,-387243,-392643
444.040051,3,510,600,-90,90,123100,122900,17249,151251,133251
444.040051,4,110,50,60,-60,123100,122900,-2017,-23583,-11583
444.040051,5,2571,2588,-17,17,123100,122900,10435,-242235,-245635
444.040051,6,0,0,0,0,123100,122900,0,0,0
444.223799,0,545,645,-100,100,123100,122900,30201,244199,224199
444.223799,1,531,631,-100,100,123100,122900,29501,91299,71299
444.223799,2,4031,4058,-27,27,123100,122900,19243,-387243,-392643
444.223799,3,510,600,-90,90,123100,122900,17249,151251,133251
444.223799,4,110,50,60,-60,123100,122900,-2017,-23583,-11583
444.223799,5,2571,2588,-17,17,123100,122900,10435,-242235,-245635
444.223799,6,0,0,0,0,123100,122900,0,0,0
444.548977,0,545,645,-100,100,123200,122900,30201,244199,219599
444.548977,1,531,631,-100,100,123200,122900,29501,91299,66699
444.548977,2,4033,4058,-25,25,123200,122900,19218,-387818,-393968
444.548977,3,510,602,-92,92,123200,122900,17298,151602,128970
444.548977,4,110,50,60,-60,123200,122900,-2017,-23583,-8823
444.548977,5,2571,2588,-17,17,123200,122900,10435,-242235,-246417
444.548977,6,0,0,0,0,123200,122900,0,0,0
444.70612,0,545,645,-100,100,123200,122900,30201,244199,219599
444.70612,1,531,631,-100,100,123200,122900,29501,91299,66699
444.70612,2,4033,4058,-25,25,123200,122900,19218,-387818,-393968
444.70612,3,510,602,-92,92,123200,122900,17298,151602,128970
444.70612,4,110,50,60,-60,123200,122900,-2017,-23583,-8823
444.70612,5,2571,2588,-17,17,123200,122900,10435,-242235,-246417
444.70612,6,0,0,0,0,123200,122900,0,0,0
445.023069,0,545,645,-100,100,123600,122900,30201,244199,219599
445.023069,1,531,631,-100,100,123600,122900,29501,91299,66699
445.023069,2,4034,4068,-34,34,123600,122900,19083,-386083,-394447
445.023069,3,510,602,-92,92,123600,122900,17298,151602,128970
445.023069,4,110,50,60,-60,123600,122900,-2017,-23583,-8823
445.023069,5,2571,2598,-27,27,123600,122900,10349,-240049,-246691
445.023069,6,0,0,0,0,123600,122900,0,0,0
445.236344,0,545,645,-100,100,123600,122900,30201,244199,219599
445.236344,1,531,631,-100,100,123600,122900,29501,91299,66699
445.236344,2,4034,4068,-34,34,123600,122900,19083,-386083,-394447
445.236344,3,510,602,-92,92,123600,122900,17298,151602,128970
445.236344,4,110,50,60,-60,123600,122900,-2017,-23583,-8823
445.236344,5,2571,2598,-27,27,123600,122900,10349,-240049,-246691
445.236344,6,0,0,0,0,123600,122900,0,0,0
445.460698,0,545,645,-100,100,123400,122900,30201,244199,219599
445.460698,1,531,631,-100,100,123400,122900,29501,91299,66699
445.460698,2,4034,4078,-44,44,123400,122900,18960,-381960,-392784
445.460698,3,510,602,-92,92,123400,122900,17298,151602,128970
445.460698,4,110,50,60,-60,123400,122900,-2017,-23583,-8823
445.460698,5,2571,2608,-37,37,123400,122900,10226,-235926,-245028
445.460698,6,0,0,0,0,123400,122900,0,0,0
445.702796,0,545,645,-100,100,123400,123000,30201,244199,219599
445.702796,1,531,631,-100,100,123400,123000,29501,91299,66699
445.702796,2,4034,4078,-44,44,123400,123000,18960,-381960,-392784
445.702796,3,510,602,-92,92,123400,123000,17298,151602,128970
445.702796,4,110,50,60,-60,123400,123000,-2017,-23583,-8823
445.702796,5,2571,2608,-37,37,123400,123000,10226,-235926,-245028
445.702796,6,0,0,0,0,123400,123000,0,0,0
446.003723,0,545,645,-100,100,123500,123000,30201,244199,219599
446.003723,1,531,631,-100,100,123500,123000,29501,91299,66699
446.003723,2,4044,4078,-34,34,123500,123000,19207,-387207,-395571
446.003723,3,510,602,-92,92,123500,123000,17298,151602,128970
446.003723,4,110,50,60,-60,123500,123000,-2017,-23583,-8823
446.003723,5,2571,2618,-47,47,123500,123000,10102,-232802,-244364
446.003723,6,0,0,0,0,123500,123000,0,0,0
446.295764,0,545,645,-100,100,123500,123000,30201,244199,219599
446.295764,1,531,631,-100,100,123500,123000,29501,91299,66699
446.295764,2,4044,4078,-34,34,123500,123000,19207,-387207,-395571
446.295764,3,510,602,-92,92,123500,123000,17298,151602,128970
446.295764,4,110,50,60,-60,123500,123000,-2017,-23583,-8823
446.295764,5,2571,2618,-47,47,123500,123000,10102,-232802,-244364
446.295764,6,0,0,0,0,123500,123000,0,0,0
446.458834,0,545,645,-100,100,123500,123000,30201,244199,219599
446.458834,1,531,631,-100,100,123500,123000,29501,91299,66699
446.458834,2,4044,4078,-34,34,123500,123000,19207,-387207,-395571
446.458834,3,510,602,-92,92,123500,123000,17298,151602,128970
446.458834,4,110,50,60,-60,123500,123000,-2017,-23583,-8823
446.458834,5,2571,2618,-47,47,123500,123000,10102,-232802,-244364
446.458834,6,0,0,0,0,123500,123000,0,0,0
446.709462,0,545,645,-100,100,123700,123000,30201,244199,219599
446.709462,1,531,631,-100,100,123700,123000,29501,91299,66699
446.709462,2,4054,4078,-24,24,123700,123000,19454,-391454,-397358
446.709462,3,510,602,-92,92,123700,123000,17298,151602,128970
446.709462,4,110,50,60,-60,123700,123000,-2017,-23583,-8823
446.709462,5,2581,2618,-37,37,123700,123000,10349,-237049,-246151
446.709462,6,0,0,0,0,123700,123000,0,0,0
447.016296,0,545,645,-100,100,123700,123000,30201,244199,219599
447.016296,1,531,631,-100,100,123700,123000,29501,91299,66699
447.016296,2,4054,4078,-24,24,123700,123000,19454,-391454,-397358
447.016296,3,510,602,-92,92,123700,123000,17298,151602,128970
447.016296,4,110,50,60,-60,123700,123000,-2017,-23583,-8823
447.016296,5,2581,2618,-37,37,123700,123000,10349,-237049,-246151
447.016296,6,0,0,0,0,123700,123000,0,0,0
447.29535,0,545,645,-100,100,123700,123000,30201,244199,219599
447.29535,1,531,631,-100,100,123700,123000,29501,91299,66699
447.29535,2,4054,4078,-24,24,123700,123000,19454,-391454,-397358
447.29535,3,510,602,-92,92,123700,123000,17298,151602,128970
447.29535,4,110,50,60,-60,123700,123000,-2017,-23583,-8823
447.29535,5,2581,2618,-37,37,123700,123000,10349,-237049,-246151
447.29535,6,0,0,0,0,123700,123000,0,0,0
447.479132,0,545,645,-100,100,123400,123000,30201,244199,219599
447.479132,1,531,631,-100,100,123400,123000,29501,91299,66699
447.479132,2,4054,4088,-34,34,123400,123000,19701,-388701,-397065
447.479132,3,510,602,-92,92,123400,123000,17298,151602,128970
447.479132,4,110,50,60,-60,123400,123000,-2017,-23583,-8823
447.479132,5,2591,2618,-27,27,123400,123000,10225,-241925,-248567
447.479132,6,0,0,0,0,123400,123000,0,0,0
447.772998,0,545,645,-100,100,123400,123000,30201,244199,219599
447.772998,1,531,631,-100,100,123400,123000,29501,91299,66699
447.772998,2,4054,4088,-34,34,123400,123000,19701,-388701,-397065
447.772998,3,510,602,-92,92,123400,123000,17298,151602,128970
447.772998,4,110,50,60,-60,123400,123000,-2017,-23583,-8823
447.772998,5,2591,2618,-27,27,123400,123000,10225,-241925,-248567
447.772998,6,0,0,0,0,123400,123000,0,0,0
447.989209,0,545,645,-100,100,123400,123000,30201,244199,219599
447.989209,1,531,631,-100,100,123400,123000,29501,91299,66699
447.989209,2,4054,4088,-34,34,123400,123000,19701,-388701,-397065
447.989209,3,510,602,-92,92,123400,123000,17298,151602,128970
447.989209,4,110,50,60,-60,123400,123000,-2017,-23583,-8823
447.989209,5,2591,2618,-27,27,123400,123000,10225,-241925,-248567
447.989209,6,0,0,0,0,123400,123000,0,0,0
448.203419,0,545,645,-100,100,123400,123000,30201,244199,219599
448.203419,1,531,631,-100,100,123400,123000,29501,91299,66699
448.203419,2,4054,4088,-34,34,123400,123000,19701,-388701,-397065
448.203419,3,510,602,-92,92,123400,123000,17298,151602,128970
448.203419,4,110,50,60,-60,123400,123000,-2017,-23583,-8823
448.203419,5,2591,2618,-27,27,123400,123000,10225,-241925,-248567
448.203419,6,0,0,0,0,123400,123000,0,0,0
448.496213,0,545,645,-100,100,123100,123300,30201,244199,264199
448.496213,1,531,631,-100,100,123100,123300,29501,91299,111299
448.496213,2,4064,4088,-24,24,123100,123300,19948,-392948,-388148
448.496213,3,510,602,-92,92,123100,123300,17298,151602,170002
448.496213,4,110,50,60,-60,123100,123300,-2017,-23583,-35583
448.496213,5,2601,2628,-27,27,123100,123300,9978,-240678,-235278
448.496213,6,0,0,0,0,123100,123300,0,0,0
448.707544,0,545,645,-100,100,123100,123400,30201,244199,268899
448.707544,1,531,631,-100,100,123100,123400,29501,91299,115999
448.707544,2,4064,4088,-24,24,123100,123400,19948,-392948,-387020
448.707544,3,510,602,-92,92,123100,123400,17298,151602,174326
448.707544,4,110,50,60,-60,123100,123400,-2017,-23583,-38403
448.707544,5,2601,2628,-27,27,123100,123400,9978,-240678,-234009
448.707544,6,0,0,0,0,123100,123400,0,0,0
449.034743,0,545,645,-100,100,123700,123400,30201,244199,219499
449.034743,1,531,631,-100,100,123700,123400,29501,91299,66599
449.034743,2,4074,4088,-14,14,123700,123400,20195,-396195,-399653
449.034743,3,510,602,-92,92,123700,123400,17298,151602,128878
449.034743,4,110,50,60,-60,123700,123400,-2017,-23583,-8763
449.034743,5,2601,2628,-27,27,123700,123400,9978,-240678,-247347
449.034743,6,0,0,0,0,123700,123400,0,0,0
449.292082,0,545,645,-100,100,123700,123400,30201,244199,219499
449.292082,1,531,631,-100,100,123700,123400,29501,91299,66599
449.292082,2,4074,4088,-14,14,123700,123400,20195,-396195,-399653
449.292082,3,510,602,-92,92,123700,123400,17298,151602,128878
449.292082,4,110,50,60,-60,123700,123400,-2017,-23583,-8763
449.292082,5,2601,2628,-27,27,123700,123400,9978,-240678,-247347
449.292082,6,0,0,0,0,123700,123400,0,0,0
449.492496,0,545,645,-100,100,123600,123400,30201,244199,224199
449.492496,1,531,631,-100,100,123600,123400,29501,91299,71299
449.492496,2,4074,4098,-24,24,123600,123400,20442,-395442,-400242
449.492496,3,510,602,-92,92,123600,123400,17298,151602,133202
449.492496,4,110,50,60,-60,123600,123400,-2017,-23583,-11583
449.492496,5,2611,2628,-17,17,123600,123400,9854,-243554,-246954
449.492496,6,0,0,0,0,123600,123400,0,0,0
449.799874,0,545,645,-100,100,123600,123400,30201,244199,224199
449.799874,1,531,631,-100,100,123600,123400,29501,91299,71299
449.799874,2,4074,4098,-24,24,123600,123400,20442,-395442,-400242
449.799874,3,510,602,-92,92,123600,123400,17298,151602,133202
449.799874,4,110,50,60,-60,123600,123400,-2017,-23583,-11583
449.799874,5,2611,2628,-17,17,123600,123400,9854,-243554,-246954
449.799874,6,0,0,0,0,123600,123400,0,0,0
450.042709,0,545,645,-100,100,123600,123400,30201,244199,224199
450.042709,1,531,631,-100,100,123600,123400,29501,91299,71299
450.042709,2,4074,4098,-24,24,123600,123400,20442,-395442,-400242
450.042709,3,510,602,-92,92,123600,123400,17298,151602,133202
450.042709,4,110,50,60,-60,123600,123400,-2017,-23583,-11583
450.042709,5,2611,2628,-17,17,123600,123400,9854,-243554,-246954
450.042709,6,0,0,0,0,123600,123400,0,0,0
450.201471,0,545,645,-100,100,123600,123400,30201,244199,224199
450.201471,1,531,631,-100,100,123600,123400,29501,91299,71299
450.201471,2,4074,4098,-24,24,123600,123400,20442,-395442,-400242
450.201471,3,510,602,-92,92,123600,123400,17298,151602,133202
450.201471,4,110,50,60,-60,123600,123400,-2017,-23583,-11583
450.201471,5,2611,2628,-17,17,123600,123400,9854,-243554,-246954
450.201471,6,0,0,0,0,123600,123400,0,0,0
450.490541,0,545,645,-100,100,123500,123300,30201,244199,224199
450.490541,1,531,631,-100,100,123500,123300,29501,91299,71299
450.490541,2,4076,4098,-22,22,123500,123300,20417,-396017,-400417
450.490541,3,510,602,-92,92,123500,123300,17298,151602,133202
450.490541,4,110,50,60,-60,123500,123300,-2017,-23583,-11583
450.490541,5,2611,2628,-17,17,123500,123300,9854,-243554,-246954
450.490541,6,0,0,0,0,123500,123300,0,0,0
450.705301,0,545,645,-100,100,123500,123300,30201,244199,224199
450.705301,1,531,631,-100,100,123500,123300,29501,91299,71299
450.705301,2,4076,4098,-22,22,123500,123300,20417,-396017,-400417
450.705301,3,510,602,-92,92,123500,123300,17298,151602,133202
450.705301,4,110,50,60,-60,123500,123300,-2017,-23583,-11583
450.705301,5,2611,2628,-17,17,123500,123300,9854,-243554,-246954
450.705301,6,0,0,0,0,123500,123300,0,0,0
450.952859,0,545,645,-100,100,123500,123300,30201,244199,224199
450.952859,1,531,631,-100,100,123500,123300,29501,91299,71299
450.952859,2,4076,4098,-22,22,123500,123300,20417,-396017,-400417
450.952859,3,510,602,-92,92,123500,123300,17298,151602,133202
450.952859,4,110,50,60,-60,123500,123300,-2017,-23583,-11583
450.952859,5,2611,2628,-17,17,123500,123300,9854,-243554,-246954
450.952859,6,0,0,0,0,123500,123300,0,0,0
451.201961,0,545,645,-100,100,123500,123300,30201,244199,224199
451.201961,1,531,631,-100,100,123500,123300,29501,91299,71299
451.201961,2,4076,4098,-22,22,123500,123300,20417,-396017,-400417
451.201961,3,510,602,-92,92,123500,123300,17298,151602,133202
451.201961,4,110,50,60,-60,123500,123300,-2017,-23583,-11583
451.201961,5,2611,2628,-17,17,123500,123300,9854,-243554,-246954
451.201961,6,0,0,0,0,123500,123300,0,0,0
451.529218,0,545,645,-100,100,123500,123300,30201,244199,224199
451.529218,1,531,631,-100,100,123500,123300,29501,91299,71299
451.529218,2,4076,4098,-22,22,123500,123300,20417,-396017,-400417
451.529218,3,510,602,-92,92,123500,123300,17298,151602,133202
451.529218,4,110,50,60,-60,123500,123300,-2017,-23583,-11583
451.529218,5,2611,2628,-17,17,123500,123300,9854,-243554,-246954
451.529218,6,0,0,0,0,123500,123300,0,0,0
451.765809,0,545,645,-100,100,123500,123300,30201,244199,224199
451.765809,1,531,631,-100,100,123500,123300,29501,91299,71299
451.765809,2,4076,4098,-22,22,123500,123300,20417,-396017,-400417
451.765809,3,510,602,-92,92,123500,123300,17298,151602,133202
451.765809,4,110,50,60,-60,123500,123300,-2017,-23583,-11583
451.765809,5,2611,2628,-17,17,123500,123300,9854,-243554,-246954
451.765809,6,0,0,0,0,123500,123300,0,0,0
451.972782,0,545,645,-100,100,123500,123300,30201,244199,224199
451.972782,1,531,631,-100,100,123500,123300,29501,91299,71299
451.972782,2,4076,4098,-22,22,123500,123300,20417,-396017,-400417
451.972782,3,510,602,-92,92,123500,123300,17298,151602,133202
451.972782,4,110,50,60,-60,123500,123300,-2017,-23583,-11583
451.972782,5,2611,2628,-17,17,123500,123300,9854,-243554,-246954
451.972782,6,0,0,0,0,123500,123300,0,0,0
452.225976,0,545,645,-100,100,123500,123300,30201,244199,224199
452.225976,1,531,631,-100,100,123500,123300,29501,91299,71299
452.225976,2,4076,4098,-22,22,123500,123300,20417,-396017,-400417
452.225976,3,510,602,-92,92,123500,123300,17298,151602,133202
452.225976,4,110,50,60,-60,123500,123300,-2017,-23583,-11583
452.225976,5,2611,2628,-17,17,123500,123300,9854,-243554,-246954
452.225976,6,0,0,0,0,123500,123300,0,0,0
452.482322,0,545,645,-100,100,123500,123300,30201,244199,224199
452.482322,1,531,631,-100,100,123500,123300,29501,91299,71299
452.482322,2,4076,4098,-22,22,123500,123300,20417,-396017,-400417
452.482322,3,510,602,-92,92,123500,123300,17298,151602,133202
452.482322,4,110,50,60,-60,123500,123300,-2017,-23583,-11583
452.482322,5,2611,2628,-17,17,123500,123300,9854,-243554,-246954
452.482322,6,0,0,0,0,123500,123300,0,0,0
452.760671,0,545,645,-100,100,123700,123600,30201,244199,234199
452.760671,1,531,631,-100,100,123700,123600,29501,91299,81299
452.760671,2,4086,4098,-12,12,123700,123600,20664,-399264,-400464
452.760671,3,510,602,-92,92,123700,123600,17298,151602,142402
452.760671,4,110,50,60,-60,123700,123600,-2017,-23583,-17583
452.760671,5,2611,2628,-17,17,123700,123600,9854,-243554,-245254
452.760671,6,0,0,0,0,123700,123600,0,0,0
453.040289,0,545,645,-100,100,123700,123600,30201,244199,234199
453.040289,1,531,631,-100,100,123700,123600,29501,91299,81299
453.040289,2,4093,4098,-5,5,123700,123600,20837,-400837,-401337
453.040289,3,510,602,-92,92,123700,123600,17298,151602,142402
453.040289,4,110,50,60,-60,123700,123600,-2017,-23583,-17583
453.040289,5,2611,2628,-17,17,123700,123600,9854,-243554,-245254
453.040289,6,0,0,0,0,123700,123600,0,0,0
453.237532,0,545,645,-100,100,123700,123600,30201,244199,234199
453.237532,1,531,631,-100,100,123700,123600,29501,91299,81299
453.237532,2,4093,4098,-5,5,123700,123600,20837,-400837,-401337
453.237532,3,510,602,-92,92,123700,123600,17298,151602,142402
453.237532,4,110,50,60,-60,123700,123600,-2017,-23583,-17583
453.237532,5,2611,2628,-17,17,123700,123600,9854,-243554,-245254
453.237532,6,0,0,0,0,123700,123600,0,0,0
453.504331,0,545,645,-100,100,123700,123600,30201,244199,234199
453.504331,1,531,631,-100,100,123700,123600,29501,91299,81299
453.504331,2,4093,4098,-5,5,123700,123600,20837,-400837,-401337
453.504331,3,510,602,-92,92,123700,123600,17298,151602,142402
453.504331,4,110,50,60,-60,123700,123600,-2017,-23583,-17583
453.504331,5,2611,2628,-17,17,123700,123600,9854,-243554,-245254
453.504331,6,0,0,0,0,123700,123600,0,0,0
453.797766,0,545,645,-100,100,123700,123600,30201,244199,234199
453.797766,1,531,631,-100,100,123700,123600,29501,91299,81299
453.797766,2,4093,4098,-5,5,123700,123600,20837,-400837,-401337
453.797766,3,510,602,-92,92,123700,123600,17298,151602,142402
453.797766,4,110,50,60,-60,123700,123600,-2017,-23583,-17583
453.797766,5,2611,2628,-17,17,123700,123600,9854,-243554,-245254
453.797766,6,0,0,0,0,123700,123600,0,0,0
454.003079,0,545,645,-100,100,123700,123400,30201,244199,219499
454.003079,1,531,631,-100,100,123700,123400,29501,91299,66599
454.003079,2,4093,4098,-5,5,123700,123400,20837,-400837,-402072
454.003079,3,510,602,-92,92,123700,123400,17298,151602,128878
454.003079,4,110,50,60,-60,123700,123400,-2017,-23583,-8763
454.003079,5,2611,2628,-17,17,123700,123400,9854,-243554,-247753
454.003079,6,0,0,0,0,123700,123400,0,0,0
454.243252,0,545,645,-100,100,123600,123400,30201,244199,224199
454.243252,1,531,631,-100,100,123600,123400,29501,91299,71299
454.243252,2,4093,4108,-15,15,123600,123400,21084,-398084,-401084
454.243252,3,510,602,-92,92,123600,123400,17298,151602,133202
454.243252,4,110,50,60,-60,123600,123400,-2017,-23583,-11583
454.243252,5,2621,2628,-7,7,123600,123400,9730,-247430,-248830
454.243252,6,0,0,0,0,123600,123400,0,0,0
454.481929,0,545,645,-100,100,123600,123400,30201,244199,224199
454.481929,1,531,631,-100,100,123600,123400,29501,91299,71299
454.481929,2,4093,4108,-15,15,123600,123400,21084,-398084,-401084
454.481929,3,510,602,-92,92,123600,123400,17298,151602,133202
454.481929,4,110,50,60,-60,123600,123400,-2017,-23583,-11583
454.481929,5,2621,2628,-7,7,123600,123400,9730,-247430,-248830
454.481929,6,0,0,0,0,123600,123400,0,0,0
454.767279,0,545,645,-100,100,123600,123300,30201,244199,219499
454.767279,1,531,631,-100,100,123600,123300,29501,91299,66599
454.767279,2,4093,4108,-15,15,123600,123300,21084,-398084,-401789
454.767279,3,510,602,-92,92,123600,123300,17298,151602,128878
454.767279,4,110,50,60,-60,123600,123300,-2017,-23583,-8763
454.767279,5,2621,2628,-7,7,123600,123300,9730,-247430,-249159
454.767279,6,0,0,0,0,123600,123300,0,0,0
455.021882,0,545,645,-100,100,123500,123400,30201,244199,234199
455.021882,1,531,631,-100,100,123500,123400,29501,91299,81299
455.021882,2,4103,4108,-5,5,123500,123400,21331,-400331,-400831
455.021882,3,510,602,-92,92,123500,123400,17298,151602,142402
455.021882,4,110,50,60,-60,123500,123400,-2017,-23583,-17583
455.021882,5,2621,2638,-17,17,123500,123400,9606,-246306,-248006
455.021882,6,0,0,0,0,123500,123400,0,0,0
455.295836,0,545,645,-100,100,123500,123400,30201,244199,234199
455.295836,1,531,631,-100,100,123500,123400,29501,91299,81299
455.295836,2,4103,4108,-5,5,123500,123400,21331,-400331,-400831
455.295836,3,510,602,-92,92,123500,123400,17298,151602,142402
455.295836,4,110,50,60,-60,123500,123400,-2017,-23583,-17583
455.295836,5,2621,2638,-17,17,123500,123400,9606,-246306,-248006
455.295836,6,0,0,0,0,123500,123400,0,0,0
455.537957,0,545,645,-100,100,123500,123400,30201,244199,234199
455.537957,1,531,631,-100,100,123500,123400,29501,91299,81299
455.537957,2,4113,4118,-5,5,123500,123400,21084,-401084,-401584
455.537957,3,510,602,-92,92,123500,123400,17298,151602,142402
455.537957,4,110,50,60,-60,123500,123400,-2017,-23583,-17583
455.537957,5,2641,2638,3,-3,123500,123400,9730,-249430,-249130
455.537957,6,0,0,0,0,123500,123400,0,0,0
455.763055,0,545,645,-100,100,123500,123400,30201,244199,234199
455.763055,1,531,631,-100,100,123500,123400,29501,91299,81299
455.763055,2,4113,4118,-5,5,123500,123400,21084,-401084,-401584
455.763055,3,510,602,-92,92,123500,123400,17298,151602,142402
455.763055,4,110,50,60,-60,123500,123400,-2017,-23583,-17583
455.763055,5,2641,2638,3,-3,123500,123400,9730,-249430,-249130
455.763055,6,0,0,0,0,123500,123400,0,0,0
455.951162,0,545,645,-100,100,123500,123400,30201,244199,234199
455.951162,1,531,631,-100,100,123500,123400,29501,91299,81299
455.951162,2,4113,4118,-5,5,123500,123400,21084,-401084,-401584
455.951162,3,510,602,-92,92,123500,123400,17298,151602,142402
455.951162,4,110,50,60,-60,123500,123400,-2017,-23583,-17583
455.951162,5,2641,2638,3,-3,123500,123400,9730,-249430,-249130
455.951162,6,0,0,0,0,123500,123400,0,0,0
456.276525,0,545,645,-100,100,122900,123400,30201,244199,268899
456.276525,1,531,631,-100,100,122900,123400,29501,91299,115999
456.276525,2,4123,4128,-5,5,122900,123400,20837,-400837,-399602
456.276525,3,510,602,-92,92,122900,123400,17298,151602,174326
456.276525,4,110,50,60,-60,122900,123400,-2017,-23583,-38403
456.276525,5,2651,2648,3,-3,122900,123400,9854,-250554,-251295
456.276525,6,0,0,0,0,122900,123400,0,0,0
456.458462,0,545,645,-100,100,123900,123400,30201,244199,219499
456.458462,1,531,631,-100,100,123900,123400,29501,91299,66599
456.458462,2,4123,4138,-15,15,123900,123400,20713,-399713,-403418
456.458462,3,510,602,-92,92,123900,123400,17298,151602,128878
456.458462,4,110,50,60,-60,123900,123400,-2017,-23583,-8763
456.458462,5,2651,2648,3,-3,123900,123400,9854,-250554,-249813
456.458462,6,0,0,0,0,123900,123400,0,0,0
456.800067,0,545,645,-100,100,123900,123400,30201,244199,219499
456.800067,1,531,631,-100,100,123900,123400,29501,91299,66599
456.800067,2,4123,4138,-15,15,123900,123400,20713,-399713,-403418
456.800067,3,510,602,-92,92,123900,123400,17298,151602,128878
456.800067,4,110,50,60,-60,123900,123400,-2017,-23583,-8763
456.800067,5,2651,2648,3,-3,123900,123400,9854,-250554,-249813
456.800067,6,0,0,0,0,123900,123400,0,0,0
456.982398,0,545,645,-100,100,123900,123400,30201,244199,219499
456.982398,1,531,631,-100,100,123900,123400,29501,91299,66599
456.982398,2,4123,4138,-15,15,123900,123400,20713,-399713,-403418
456.982398,3,510,602,-92,92,123900,123400,17298,151602,128878
456.982398,4,110,50,60,-60,123900,123400,-2017,-23583,-8763
456.982398,5,2651,2648,3,-3,123900,123400,9854,-250554,-249813
456.982398,6,0,0,0,0,123900,123400,0,0,0
457.231803,0,545,645,-100,100,123900,123200,30201,244199,219599
457.231803,1,531,631,-100,100,123900,123200,29501,91299,66699
457.231803,2,4123,4138,-15,15,123900,123200,20713,-399713,-403403
457.231803,3,510,602,-92,92,123900,123200,17298,151602,128970
457.231803,4,110,50,60,-60,123900,123200,-2017,-23583,-8823
457.231803,5,2651,2648,3,-3,123900,123200,9854,-250554,-249816
457.231803,6,0,0,0,0,123900,123200,0,0,0
457.460669,0,545,645,-100,100,123300,123100,30201,244199,224199
457.460669,1,531,631,-100,100,123300,123100,29501,91299,71299
457.460669,2,4133,4138,-5,5,123300,123100,20590,-404590,-405590
457.460669,3,510,602,-92,92,123300,123100,17298,151602,133202
457.460669,4,110,50,60,-60,123300,123100,-2017,-23583,-11583
457.460669,5,2659,2648,11,-11,123300,123100,9755,-253655,-251455
457.460669,6,0,0,0,0,123300,123100,0,0,0
457.70934,0,545,645,-100,100,123600,123100,30201,244199,219599
457.70934,1,531,631,-100,100,123600,123100,29501,91299,66699
457.70934,2,4133,4148,-15,15,123600,123100,20836,-402836,-406526
457.70934,3,510,602,-92,92,123600,123100,17298,151602,128970
457.70934,4,110,50,60,-60,123600,123100,-2017,-23583,-8823
457.70934,5,2659,2648,11,-11,123600,123100,9755,-253655,-250949
457.70934,6,0,0,0,0,123600,123100,0,0,0
458.00432,0,545,645,-100,100,123200,123100,30201,244199,234199
458.00432,1,531,631,-100,100,123200,123100,29501,91299,81299
458.00432,2,4133,4148,-15,15,123200,123100,20836,-402836,-404336
458.00432,3,510,602,-92,92,123200,123100,17298,151602,142402
458.00432,4,110,50,60,-60,123200,123100,-2017,-23583,-17583
458.00432,5,2659,2658,1,-1,123200,123100,10001,-252901,-252801
458.00432,6,0,0,0,0,123200,123100,0,0,0
458.207604,0,545,645,-100,100,123200,123100,30201,244199,234199
458.207604,1,531,631,-100,100,123200,123100,29501,91299,81299
458.207604,2,4133,4148,-15,15,123200,123100,20836,-402836,-404336
458.207604,3,510,602,-92,92,123200,123100,17298,151602,142402
458.207604,4,110,50,60,-60,123200,123100,-2017,-23583,-17583
458.207604,5,2659,2658,1,-1,123200,123100,10001,-252901,-252801
458.207604,6,0,0,0,0,123200,123100,0,0,0
458.455495,0,545,645,-100,100,123200,123100,30201,244199,234199
458.455495,1,531,631,-100,100,123200,123100,29501,91299,81299
458.455495,2,4133,4148,-15,15,123200,123100,20836,-402836,-404336
458.455495,3,510,602,-92,92,123200,123100,17298,151602,142402
458.455495,4,110,50,60,-60,123200,123100,-2017,-23583,-17583
458.455495,5,2659,2658,1,-1,123200,123100,10001,-252901,-252801
458.455495,6,0,0,0,0,123200,123100,0,0,0
458.717473,0,545,645,-100,100,123400,123300,30201,244199,234199
458.717473,1,531,631,-100,100,123400,123300,29501,91299,81299
458.717473,2,4143,4148,-5,5,123400,123300,21083,-405083,-405583
458.717473,3,510,602,-92,92,123400,123300,17298,151602,142402
458.717473,4,110,50,60,-60,123400,123300,-2017,-23583,-17583
458.717473,5,2659,2668,-9,9,123400,123300,9878,-251778,-252678
458.717473,6,0,0,0,0,123400,123300,0,0,0
458.960876,0,545,645,-100,100,123400,123300,30201,244199,234199
458.960876,1,531,631,-100,100,123400,123300,29501,91299,81299
458.960876,2,4143,4148,-5,5,123400,123300,21083,-405083,-405583
458.960876,3,510,602,-92,92,123400,123300,17298,151602,142402
458.960876,4,110,50,60,-60,123400,123300,-2017,-23583,-17583
458.960876,5,2659,2668,-9,9,123400,123300,9878,-251778,-252678
458.960876,6,0,0,0,0,123400,123300,0,0,0
459.29302,0,545,645,-100,100,123900,123300,30201,244199,219499
459.29302,1,531,631,-100,100,123900,123300,29501,91299,66599
459.29302,2,4143,4158,-15,15,123900,123300,20960,-403960,-407665
459.29302,3,510,602,-92,92,123900,123300,17298,151602,128878
459.29302,4,110,50,60,-60,123900,123300,-2017,-23583,-8763
459.29302,5,2659,2678,-19,19,123900,123300,9754,-249654,-254347
459.29302,6,0,0,0,0,123900,123300,0,0,0
459.455109,0,545,645,-100,100,123700,123300,30201,244199,219499
459.455109,1,531,631,-100,100,123700,123300,29501,91299,66599
459.455109,2,4143,4168,-25,25,123700,123300,21207,-400207,-406382
459.455109,3,510,602,-92,92,123700,123300,17298,151602,128878
459.455109,4,110,50,60,-60,123700,123300,-2017,-23583,-8763
459.455109,5,2659,2688,-29,29,123700,123300,10001,-245901,-253064
459.455109,6,0,0,0,0,123700,123300,0,0,0
459.783915,0,545,645,-100,100,123700,123300,30201,244199,219499
459.783915,1,531,631,-100,100,123700,123300,29501,91299,66599
459.783915,2,4143,4178,-35,35,123700,123300,21454,-396454,-405099
459.783915,3,510,602,-92,92,123700,123300,17298,151602,128878
459.783915,4,110,50,60,-60,123700,123300,-2017,-23583,-8763
459.783915,5,2659,2698,-39,39,123700,123300,10248,-242148,-251781
459.783915,6,0,0,0,0,123700,123300,0,0,0
460.014805,0,545,645,-100,100,123700,123300,30201,244199,219499
460.014805,1,531,631,-100,100,123700,123300,29501,91299,66599
460.014805,2,4143,4188,-45,45,123700,123300,21701,-392701,-403816
460.014805,3,510,602,-92,92,123700,123300,17298,151602,128878
460.014805,4,110,50,60,-60,123700,123300,-2017,-23583,-8763
460.014805,5,2659,2698,-39,39,123700,123300,10248,-242148,-251781
460.014805,6,0,0,0,0,123700,123300,0,0,0
460.200432,0,545,645,-100,100,123500,123300,30201,244199,224199
460.200432,1,531,631,-100,100,123500,123300,29501,91299,71299
460.200432,2,4153,4188,-35,35,123500,123300,21577,-398577,-405577
460.200432,3,510,602,-92,92,123500,123300,17298,151602,133202
460.200432,4,110,50,60,-60,123500,123300,-2017,-23583,-11583
460.200432,5,2668,2698,-30,30,123500,123300,10137,-245637,-251637
460.200432,6,0,0,0,0,123500,123300,0,0,0
460.531023,0,545,645,-100,100,123500,123300,30201,244199,224199
460.531023,1,531,631,-100,100,123500,123300,29501,91299,71299
460.531023,2,4153,4188,-35,35,123500,123300,21577,-398577,-405577
460.531023,3,510,602,-92,92,123500,123300,17298,151602,133202
460.531023,4,110,50,60,-60,123500,123300,-2017,-23583,-11583
460.531023,5,2668,2698,-30,30,123500,123300,10137,-245637,-251637
460.531023,6,0,0,0,0,123500,123300,0,0,0
460.768142,0,545,645,-100,100,123500,123200,30201,244199,219599
460.768142,1,531,631,-100,100,123500,123200,29501,91299,66699
460.768142,2,4153,4188,-35,35,123500,123200,21577,-398577,-407187
460.768142,3,510,602,-92,92,123500,123200,17298,151602,128970
460.768142,4,110,50,60,-60,123500,123200,-2017,-23583,-8823
460.768142,5,2668,2698,-30,30,123500,123200,10137,-245637,-253017
460.768142,6,0,0,0,0,123500,123200,0,0,0
461.017177,0,545,645,-100,100,123600,123300,30201,244199,219499
461.017177,1,531,631,-100,100,123600,123300,29501,91299,66599
461.017177,2,4163,4188,-25,25,123600,123300,21824,-402824,-408999
461.017177,3,510,602,-92,92,123600,123300,17298,151602,128878
461.017177,4,110,50,60,-60,123600,123300,-2017,-23583,-8763
461.017177,5,2668,2708,-40,40,123600,123300,10013,-242513,-252393
461.017177,6,0,0,0,0,123600,123300,0,0,0
461.263154,0,545,645,-100,100,123600,123300,30201,244199,219499
461.263154,1,531,631,-100,100,123600,123300,29501,91299,66599
461.263154,2,4163,4188,-25,25,123600,123300,21824,-402824,-408999
461.263154,3,510,602,-92,92,123600,123300,17298,151602,128878
461.263154,4,110,50,60,-60,123600,123300,-2017,-23583,-8763
461.263154,5,2668,2708,-40,40,123600,123300,10013,-242513,-252393
461.263154,6,0,0,0,0,123600,123300,0,0,0
461.487507,0,545,645,-100,100,123600,123400,30201,244199,224199
461.487507,1,531,631,-100,100,123600,123400,29501,91299,71299
461.487507,2,4163,4188,-25,25,123600,123400,21824,-402824,-407824
461.487507,3,510,602,-92,92,123600,123400,17298,151602,133202
461.487507,4,110,50,60,-60,123600,123400,-2017,-23583,-11583
461.487507,5,2668,2708,-40,40,123600,123400,10013,-242513,-250513
461.487507,6,0,0,0,0,123600,123400,0,0,0
461.791912,0,545,645,-100,100,123600,123400,30201,244199,224199
461.791912,1,531,631,-100,100,123600,123400,29501,91299,71299
461.791912,2,4163,4188,-25,25,123600,123400,21824,-402824,-407824
461.791912,3,510,602,-92,92,123600,123400,17298,151602,133202
461.791912,4,110,50,60,-60,123600,123400,-2017,-23583,-11583
461.791912,5,2668,2708,-40,40,123600,123400,10013,-242513,-250513
461.791912,6,0,0,0,0,123600,123400,0,0,0
462.005793,0,545,645,-100,100,123600,123400,30201,244199,224199
462.005793,1,531,631,-100,100,123600,123400,29501,91299,71299
462.005793,2,4163,4188,-25,25,123600,123400,21824,-402824,-407824
462.005793,3,510,602,-92,92,123600,123400,17298,151602,133202
462.005793,4,110,50,60,-60,123600,123400,-2017,-23583,-11583
462.005793,5,2668,2708,-40,40,123600,123400,10013,-242513,-250513
462.005793,6,0,0,0,0,123600,123400,0,0,0
462.240069,0,545,645,-100,100,123600,123400,30201,244199,224199
462.240069,1,531,631,-100,100,123600,123400,29501,91299,71299
462.240069,2,4163,4188,-25,25,123600,123400,21824,-402824,-407824
462.240069,3,510,602,-92,92,123600,123400,17298,151602,133202
462.240069,4,110,50,60,-60,123600,123400,-2017,-23583,-11583
462.240069,5,2668,2708,-40,40,123600,123400,10013,-242513,-250513
462.240069,6,0,0,0,0,123600,123400,0,0,0
462.487701,0,545,645,-100,100,123200,123400,30201,244199,264199
462.487701,1,531,631,-100,100,123200,123400,29501,91299,111299
462.487701,2,4173,4188,-15,15,123200,123400,21700,-405700,-402700
462.487701,3,510,602,-92,92,123200,123400,17298,151602,170002
462.487701,4,110,50,60,-60,123200,123400,-2017,-23583,-35583
462.487701,5,2678,2708,-30,30,123200,123400,9889,-245389,-239389
462.487701,6,0,0,0,0,123200,123400,0,0,0
462.78213,0,545,645,-100,100,123200,123400,30201,244199,264199
462.78213,1,531,631,-100,100,123200,123400,29501,91299,111299
462.78213,2,4183,4188,-5,5,123200,123400,21576,-407576,-406576
462.78213,3,510,602,-92,92,123200,123400,17298,151602,170002
462.78213,4,110,50,60,-60,123200,123400,-2017,-23583,-35583
462.78213,5,2688,2708,-20,20,123200,123400,9765,-247265,-243265
462.78213,6,0,0,0,0,123200,123400,0,0,0
463.0103,0,545,645,-100,100,123200,123400,30201,244199,264199
463.0103,1,531,631,-100,100,123200,123400,29501,91299,111299
463.0103,2,4183,4188,-5,5,123200,123400,21576,-407576,-406576
463.0103,3,510,602,-92,92,123200,123400,17298,151602,170002
463.0103,4,110,50,60,-60,123200,123400,-2017,-23583,-35583
463.0103,5,2688,2708,-20,20,123200,123400,9765,-247265,-243265
463.0103,6,0,0,0,0,123200,123400,0,0,0
463.256712,0,545,645,-100,100,124000,123400,30201,244199,219499
463.256712,1,531,631,-100,100,124000,123400,29501,91299,66599
463.256712,2,4183,4198,-15,15,124000,123400,21452,-406452,-410157
463.256712,3,510,602,-92,92,124000,123400,17298,151602,128878
463.256712,4,110,50,60,-60,124000,123400,-2017,-23583,-8763
463.256712,5,2688,2718,-30,30,124000,123400,9641,-244141,-251551
463.256712,6,0,0,0,0,124000,123400,0,0,0
463.542713,0,545,645,-100,100,124000,123400,30201,244199,219499
463.542713,1,531,631,-100,100,124000,123400,29501,91299,66599
463.542713,2,4183,4198,-15,15,124000,123400,21452,-406452,-410157
463.542713,3,510,602,-92,92,124000,123400,17298,151602,128878
463.542713,4,110,50,60,-60,124000,123400,-2017,-23583,-8763
463.542713,5,2688,2718,-30,30,124000,123400,9641,-244141,-251551
463.542713,6,0,0,0,0,124000,123400,0,0,0
463.765064,0,545,645,-100,100,124000,123400,30201,244199,219499
463.765064,1,531,631,-100,100,124000,123400,29501,91299,66599
463.765064,2,4183,4208,-25,25,124000,123400,21328,-404328,-410503
463.765064,3,510,602,-92,92,124000,123400,17298,151602,128878
463.765064,4,110,50,60,-60,124000,123400,-2017,-23583,-8763
463.765064,5,2688,2728,-40,40,124000,123400,9517,-241017,-250897
463.765064,6,0,0,0,0,124000,123400,0,0,0
464.040876,0,545,645,-100,100,124000,123400,30201,244199,219499
464.040876,1,531,631,-100,100,124000,123400,29501,91299,66599
464.040876,2,4183,4208,-25,25,124000,123400,21328,-404328,-410503
464.040876,3,510,602,-92,92,124000,123400,17298,151602,128878
464.040876,4,110,50,60,-60,124000,123400,-2017,-23583,-8763
464.040876,5,2688,2728,-40,40,124000,123400,9517,-241017,-250897
464.040876,6,0,0,0,0,124000,123400,0,0,0
464.204871,0,545,645,-100,100,124000,123400,30201,244199,219499
464.204871,1,531,631,-100,100,124000,123400,29501,91299,66599
464.204871,2,4183,4208,-25,25,124000,123400,21328,-404328,-410503
464.204871,3,510,602,-92,92,124000,123400,17298,151602,128878
464.204871,4,110,50,60,-60,124000,123400,-2017,-23583,-8763
464.204871,5,2688,2728,-40,40,124000,123400,9517,-241017,-250897
464.204871,6,0,0,0,0,124000,123400,0,0,0
464.518258,0,545,645,-100,100,124000,123400,30201,244199,219499
464.518258,1,531,631,-100,100,124000,123400,29501,91299,66599
464.518258,2,4183,4208,-25,25,124000,123400,21328,-404328,-410503
464.518258,3,510,602,-92,92,124000,123400,17298,151602,128878
464.518258,4,110,50,60,-60,124000,123400,-2017,-23583,-8763
464.518258,5,2688,2728,-40,40,124000,123400,9517,-241017,-250897
464.518258,6,0,0,0,0,124000,123400,0,0,0
464.718139,0,545,645,-100,100,124000,123400,30201,244199,219499
464.718139,1,531,631,-100,100,124000,123400,29501,91299,66599
464.718139,2,4183,4208,-25,25,124000,123400,21328,-404328,-410503
464.718139,3,510,602,-92,92,124000,123400,17298,151602,128878
464.718139,4,110,50,60,-60,124000,123400,-2017,-23583,-8763
464.718139,5,2688,2728,-40,40,124000,123400,9517,-241017,-250897
464.718139,6,0,0,0,0,124000,123400,0,0,0
464.991559,0,545,645,-100,100,124000,123400,30201,244199,219499
464.991559,1,531,631,-100,100,124000,123400,29501,91299,66599
464.991559,2,4183,4218,-35,35,124000,123400,21204,-401204,-409849
464.991559,3,510,602,-92,92,124000,123400,17298,151602,128878
464.991559,4,110,50,60,-60,124000,123400,-2017,-23583,-8763
464.991559,5,2688,2733,-45,45,124000,123400,9455,-238955,-250070
464.991559,6,0,0,0,0,124000,123400,0,0,0
465.286394,0,545,645,-100,100,124000,123400,30201,244199,219499
465.286394,1,531,631,-100,100,124000,123400,29501,91299,66599
465.286394,2,4183,4218,-35,35,124000,123400,21204,-401204,-409849
465.286394,3,510,602,-92,92,124000,123400,17298,151602,128878
465.286394,4,110,50,60,-60,124000,123400,-2017,-23583,-8763
465.286394,5,2688,2733,-45,45,124000,123400,9455,-238955,-250070
465.286394,6,0,0,0,0,124000,123400,0,0,0
465.466321,0,545,645,-100,100,123800,123400,30201,244199,219499
465.466321,1,531,631,-100,100,123800,123400,29501,91299,66599
465.466321,2,4183,4228,-45,45,123800,123400,21452,-398452,-409567
465.466321,3,510,602,-92,92,123800,123400,17298,151602,128878
465.466321,4,110,50,60,-60,123800,123400,-2017,-23583,-8763
465.466321,5,2698,2733,-35,35,123800,123400,9331,-243831,-252476
465.466321,6,0,0,0,0,123800,123400,0,0,0
465.752558,0,545,645,-100,100,124000,123400,30201,244199,219499
465.752558,1,531,631,-100,100,124000,123400,29501,91299,66599
465.752558,2,4183,4228,-45,45,124000,123400,21452,-398452,-409567
465.752558,3,510,602,-92,92,124000,123400,17298,151602,128878
465.752558,4,110,50,60,-60,124000,123400,-2017,-23583,-8763
465.752558,5,2698,2733,-35,35,124000,123400,9331,-243831,-252476
465.752558,6,0,0,0,0,124000,123400,0,0,0
465.97383,0,545,645,-100,100,124000,123400,30201,244199,219499
465.97383,1,531,631,-100,100,124000,123400,29501,91299,66599
465.97383,2,4183,4228,-45,45,124000,123400,21452,-398452,-409567
465.97383,3,510,602,-92,92,124000,123400,17298,151602,128878
465.97383,4,110,50,60,-60,124000,123400,-2017,-23583,-8763
465.97383,5,2698,2733,-35,35,124000,123400,9331,-243831,-252476
465.97383,6,0,0,0,0,124000,123400,0,0,0
466.212953,0,545,645,-100,100,124000,123400,30201,244199,219499
466.212953,1,531,631,-100,100,124000,123400,29501,91299,66599
466.212953,2,4183,4228,-45,45,124000,123400,21452,-398452,-409567
466.212953,3,510,602,-92,92,124000,123400,17298,151602,128878
466.212953,4,110,50,60,-60,124000,123400,-2017,-23583,-8763
466.212953,5,2698,2733,-35,35,124000,123400,9331,-243831,-252476
466.212953,6,0,0,0,0,124000,123400,0,0,0
466.474356,0,545,645,-100,100,124000,123400,30201,244199,219499
466.474356,1,531,631,-100,100,124000,123400,29501,91299,66599
466.474356,2,4183,4228,-45,45,124000,123400,21452,-398452,-409567
466.474356,3,510,602,-92,92,124000,123400,17298,151602,128878
466.474356,4,110,50,60,-60,124000,123400,-2017,-23583,-8763
466.474356,5,2698,2733,-35,35,124000,123400,9331,-243831,-252476
466.474356,6,0,0,0,0,124000,123400,0,0,0
466.794729,0,545,645,-100,100,124100,123400,30201,244199,219499
466.794729,1,531,631,-100,100,124100,123400,29501,91299,66599
466.794729,2,4193,4228,-35,35,124100,123400,21328,-403328,-411973
466.794729,3,510,602,-92,92,124100,123400,17298,151602,128878
466.794729,4,110,50,60,-60,124100,123400,-2017,-23583,-8763
466.794729,5,2703,2743,-40,40,124100,123400,9145,-242145,-252025
466.794729,6,0,0,0,0,124100,123400,0,0,0
466.998604,0,545,645,-100,100,124100,123400,30201,244199,219499
466.998604,1,531,631,-100,100,124100,123400,29501,91299,66599
466.998604,2,4193,4228,-35,35,124100,123400,21328,-403328,-411973
466.998604,3,510,602,-92,92,124100,123400,17298,151602,128878
466.998604,4,110,50,60,-60,124100,123400,-2017,-23583,-8763
466.998604,5,2703,2743,-40,40,124100,123400,9145,-242145,-252025
466.998604,6,0,0,0,0,124100,123400,0,0,0
467.214722,0,545,645,-100,100,124100,123400,30201,244199,219499
467.214722,1,531,631,-100,100,124100,123400,29501,91299,66599
467.214722,2,4193,4228,-35,35,124100,123400,21328,-403328,-411973
467.214722,3,510,602,-92,92,124100,123400,17298,151602,128878
467.214722,4,110,50,60,-60,124100,123400,-2017,-23583,-8763
467.214722,5,2703,2743,-40,40,124100,123400,9145,-242145,-252025
467.214722,6,0,0,0,0,124100,123400,0,0,0
467.518139,0,545,645,-100,100,124100,123500,30201,244199,219499
467.518139,1,531,631,-100,100,124100,123500,29501,91299,66599
467.518139,2,4193,4228,-35,35,124100,123500,21328,-403328,-411973
467.518139,3,510,602,-92,92,124100,123500,17298,151602,128878
467.518139,4,110,50,60,-60,124100,123500,-2017,-23583,-8763
467.518139,5,2703,2743,-40,40,124100,123500,9145,-242145,-252025
467.518139,6,0,0,0,0,124100,123500,0,0,0
467.77156,0,545,645,-100,100,124100,123500,30201,244199,219499
467.77156,1,531,631,-100,100,124100,123500,29501,91299,66599
467.77156,2,4193,4228,-35,35,124100,123500,21328,-403328,-411973
467.77156,3,510,602,-92,92,124100,123500,17298,151602,128878
467.77156,4,110,50,60,-60,124100,123500,-2017,-23583,-8763
467.77156,5,2703,2743,-40,40,124100,123500,9145,-242145,-252025
467.77156,6,0,0,0,0,124100,123500,0,0,0
467.998795,0,545,645,-100,100,122900,123300,30201,244199,268899
467.998795,1,531,631,-100,100,122900,123300,29501,91299,115999
467.998795,2,4203,4228,-25,25,122900,123300,21204,-407504,-401329
467.998795,3,512,602,-90,90,122900,123300,17273,152027,174257
467.998795,4,110,50,60,-60,122900,123300,-2017,-23583,-38403
467.998795,5,2713,2743,-30,30,122900,123300,9021,-246021,-238611
467.998795,6,0,0,0,0,122900,123300,0,0,0
468.263719,0,545,645,-100,100,122900,123300,30201,244199,268899
468.263719,1,531,631,-100,100,122900,123300,29501,91299,115999
468.263719,2,4203,4228,-25,25,122900,123300,21204,-407504,-401329
468.263719,3,512,602,-90,90,122900,123300,17273,152027,174257
468.263719,4,110,50,60,-60,122900,123300,-2017,-23583,-38403
468.263719,5,2713,2743,-30,30,122900,123300,9021,-246021,-238611
468.263719,6,0,0,0,0,122900,123300,0,0,0
468.543526,0,545,645,-100,100,123100,123300,30201,244199,264199
468.543526,1,531,631,-100,100,123100,123300,29501,91299,111299
468.543526,2,4213,4228,-15,15,123100,123300,21081,-410381,-407381
468.543526,3,512,602,-90,90,123100,123300,17273,152027,170027
468.543526,4,110,50,60,-60,123100,123300,-2017,-23583,-35583
468.543526,5,2733,2743,-10,10,123100,123300,9144,-251144,-249144
468.543526,6,0,0,0,0,123100,123300,0,0,0
468.750165,0,545,645,-100,100,122900,123300,30201,244199,268899
468.750165,1,531,631,-100,100,122900,123300,29501,91299,115999
468.750165,2,4223,4228,-5,5,122900,123300,21327,-412627,-411392
468.750165,3,512,602,-90,90,122900,123300,17273,152027,174257
468.750165,4,110,50,60,-60,122900,123300,-2017,-23583,-38403
468.750165,5,2743,2743,0,0,122900,123300,9390,-253390,-253390
468.750165,6,0,0,0,0,122900,123300,0,0,0
468.988127,0,545,645,-100,100,123400,123300,30201,244199,234199
468.988127,1,531,631,-100,100,123400,123300,29501,91299,81299
468.988127,2,4229,4228,1,-1,123400,123300,21475,-412775,-412675
468.988127,3,520,602,-82,82,123400,123300,17470,149430,141230
468.988127,4,110,50,60,-60,123400,123300,-2017,-23583,-17583
468.988127,5,2743,2751,-8,8,123400,123300,9291,-252491,-253291
468.988127,6,0,0,0,0,123400,123300,0,0,0
469.241288,0,545,645,-100,100,123700,123300,30201,244199,219499
469.241288,1,531,631,-100,100,123700,123300,29501,91299,66599
469.241288,2,4229,4238,-9,9,123700,123300,21352,-412352,-414575
469.241288,3,527,602,-75,75,123700,123300,17643,147857,129332
469.241288,4,110,50,60,-60,123700,123300,-2017,-23583,-8763
469.241288,5,2743,2760,-17,17,123700,123300,9180,-249680,-253879
469.241288,6,0,0,0,0,123700,123300,0,0,0
469.498516,0,545,645,-100,100,123400,123300,30201,244199,234199
469.498516,1,531,631,-100,100,123400,123300,29501,91299,81299
469.498516,2,4239,4238,1,-1,123400,123300,21229,-413229,-413129
469.498516,3,527,602,-75,75,123400,123300,17643,147857,140357
469.498516,4,110,50,60,-60,123400,123300,-2017,-23583,-17583
469.498516,5,2753,2760,-7,7,123400,123300,9057,-250557,-251257
469.498516,6,0,0,0,0,123400,123300,0,0,0
469.73484,0,545,645,-100,100,123100,123300,30201,244199,264199
469.73484,1,539,631,-92,92,123100,123300,29698,91902,110302
469.73484,2,4249,4238,11,-11,123100,123300,21475,-412475,-414675
469.73484,3,534,602,-68,68,123100,123300,17815,148385,161985
469.73484,4,110,50,60,-60,123100,123300,-2017,-23583,-35583
469.73484,5,2763,2760,3,-3,123100,123300,9303,-249803,-250403
469.73484,6,0,0,0,0,123100,123300,0,0,0
470.01558,0,545,645,-100,100,123400,123300,30201,244199,234199
470.01558,1,539,631,-92,92,123400,123300,29698,91902,82702
470.01558,2,4249,4244,5,-5,123400,123300,21401,-413001,-412501
470.01558,3,540,602,-62,62,123400,123300,17963,147637,141437
470.01558,4,110,50,60,-60,123400,123300,-2017,-23583,-17583
470.01558,5,2763,2760,3,-3,123400,123300,9303,-249803,-249503
470.01558,6,0,0,0,0,123400,123300,0,0,0
470.294892,0,545,645,-100,100,122800,123300,30201,244199,268899
470.294892,1,539,631,-92,92,122800,123300,29698,91902,114626
470.294892,2,4259,4244,15,-15,122800,123300,21278,-412878,-416583
470.294892,3,542,602,-60,60,122800,123300,17938,148262,163082
470.294892,4,110,50,60,-60,122800,123300,-2017,-23583,-38403
470.294892,5,2773,2760,13,-13,122800,123300,9180,-248680,-251891
470.294892,6,0,0,0,0,122800,123300,0,0,0
470.496079,0,545,645,-100,100,122800,123300,30201,244199,268899
470.496079,1,539,631,-92,92,122800,123300,29698,91902,114626
470.496079,2,4259,4244,15,-15,122800,123300,21278,-412878,-416583
470.496079,3,542,602,-60,60,122800,123300,17938,148262,163082
470.496079,4,110,50,60,-60,122800,123300,-2017,-23583,-38403
470.496079,5,2773,2760,13,-13,122800,123300,9180,-248680,-251891
470.496079,6,0,0,0,0,122800,123300,0,0,0
470.744348,0,545,645,-100,100,122800,123300,30201,244199,268899
470.744348,1,539,631,-92,92,122800,123300,29698,91902,114626
470.744348,2,4259,4244,15,-15,122800,123300,21278,-412878,-416583
470.744348,3,542,602,-60,60,122800,123300,17938,148262,163082
470.744348,4,110,50,60,-60,122800,123300,-2017,-23583,-38403
470.744348,5,2773,2760,13,-13,122800,123300,9180,-248680,-251891
470.744348,6,0,0,0,0,122800,123300,0,0,0
471.018227,0,545,645,-100,100,123500,123300,30201,244199,224199
471.018227,1,539,631,-92,92,123500,123300,29698,91902,73502
471.018227,2,4259,4254,5,-5,123500,123300,21155,-414755,-413755
471.018227,3,542,604,-62,62,123500,123300,17913,148687,136287
471.018227,4,110,50,60,-60,123500,123300,-2017,-23583,-11583
471.018227,5,2773,2760,13,-13,123500,123300,9180,-248680,-246080
471.018227,6,0,0,0,0,123500,123300,0,0,0
471.261872,0,545,645,-100,100,123100,123300,30201,244199,264199
471.261872,1,539,631,-92,92,123100,123300,29698,91902,110302
471.261872,2,4262,4254,8,-8,123100,123300,21229,-414529,-416129
471.261872,3,542,604,-62,62,123100,123300,17913,148687,161087
471.261872,4,110,50,60,-60,123100,123300,-2017,-23583,-35583
471.261872,5,2773,2770,3,-3,123100,123300,9316,-246616,-247216
471.261872,6,0,0,0,0,123100,123300,0,0,0
471.546886,0,545,645,-100,100,123800,123300,30201,244199,219499
471.546886,1,539,631,-92,92,123800,123300,29698,91902,69178
471.546886,2,4262,4264,-2,2,123800,123300,21106,-414406,-414900
471.546886,3,542,606,-64,64,123800,123300,17888,149312,133504
471.546886,4,110,50,60,-60,123800,123300,-2017,-23583,-8763
471.546886,5,2773,2780,-7,7,123800,123300,9193,-245493,-247222
471.546886,6,0,0,0,0,123800,123300,0,0,0
471.747579,0,545,645,-100,100,123600,123300,30201,244199,219499
471.747579,1,539,631,-92,92,123600,123300,29698,91902,69178
471.747579,2,4262,4274,-12,12,123600,123300,20983,-413283,-416247
471.747579,3,542,608,-66,66,123600,123300,17863,149937,133635
471.747579,4,110,50,60,-60,123600,123300,-2017,-23583,-8763
471.747579,5,2773,2780,-7,7,123600,123300,9193,-245493,-247222
471.747579,6,0,0,0,0,123600,123300,0,0,0
471.975105,0,545,645,-100,100,123600,123300,30201,244199,219499
471.975105,1,539,631,-92,92,123600,123300,29698,91902,69178
471.975105,2,4262,4282,-20,20,123600,123300,21181,-411081,-416021
471.975105,3,542,608,-66,66,123600,123300,17863,149937,133635
471.975105,4,110,50,60,-60,123600,123300,-2017,-23583,-8763
471.975105,5,2773,2780,-7,7,123600,123300,9193,-245493,-247222
471.975105,6,0,0,0,0,123600,123300,0,0,0
472.282285,0,545,645,-100,100,123600,123300,30201,244199,219499
472.282285,1,539,631,-92,92,123600,123300,29698,91902,69178
472.282285,2,4262,4282,-20,20,123600,123300,21181,-411081,-416021
472.282285,3,542,608,-66,66,123600,123300,17863,149937,133635
472.282285,4,110,50,60,-60,123600,123300,-2017,-23583,-8763
472.282285,5,2773,2780,-7,7,123600,123300,9193,-245493,-247222
472.282285,6,0,0,0,0,123600,123300,0,0,0
472.489913,0,545,645,-100,100,123600,123300,30201,244199,219499
472.489913,1,539,631,-92,92,123600,123300,29698,91902,69178
472.489913,2,4262,4282,-20,20,123600,123300,21181,-411081,-416021
472.489913,3,542,608,-66,66,123600,123300,17863,149937,133635
472.489913,4,110,50,60,-60,123600,123300,-2017,-23583,-8763
472.489913,5,2773,2780,-7,7,123600,123300,9193,-245493,-247222
472.489913,6,0,0,0,0,123600,123300,0,0,0
472.760517,0,545,645,-100,100,123300,123300,30201,244199,244199
472.760517,1,539,631,-92,92,123300,123300,29698,91902,91902
472.760517,2,4272,4282,-10,10,123300,123300,21058,-413958,-413958
472.760517,3,542,608,-66,66,123300,123300,17863,149937,149937
472.760517,4,110,50,60,-60,123300,123300,-2017,-23583,-23583
472.760517,5,2773,2790,-17,17,123300,123300,9440,-244740,-244740
472.760517,6,0,0,0,0,123300,123300,0,0,0
472.972387,0,545,645,-100,100,123300,123300,30201,244199,244199
472.972387,1,539,631,-92,92,123300,123300,29698,91902,91902
472.972387,2,4272,4282,-10,10,123300,123300,21058,-413958,-413958
472.972387,3,542,608,-66,66,123300,123300,17863,149937,149937
472.972387,4,110,50,60,-60,123300,123300,-2017,-23583,-23583
472.972387,5,2773,2790,-17,17,123300,123300,9440,-244740,-244740
472.972387,6,0,0,0,0,123300,123300,0,0,0
473.269397,0,545,645,-100,100,123300,123300,30201,244199,244199
473.269397,1,539,631,-92,92,123300,123300,29698,91902,91902
473.269397,2,4279,4282,-3,3,123300,123300,20972,-414572,-414572
473.269397,3,542,608,-66,66,123300,123300,17863,149937,149937
473.269397,4,110,50,60,-60,123300,123300,-2017,-23583,-23583
473.269397,5,2783,2790,-7,7,123300,123300,9317,-245617,-245617
473.269397,6,0,0,0,0,123300,123300,0,0,0
473.516265,0,545,645,-100,100,123300,123300,30201,244199,244199
473.516265,1,539,631,-92,92,123300,123300,29698,91902,91902
473.516265,2,4279,4282,-3,3,123300,123300,20972,-414572,-414572
473.516265,3,542,608,-66,66,123300,123300,17863,149937,149937
473.516265,4,110,50,60,-60,123300,123300,-2017,-23583,-23583
473.516265,5,2783,2790,-7,7,123300,123300,9317,-245617,-245617
473.516265,6,0,0,0,0,123300,123300,0,0,0
473.781168,0,545,645,-100,100,123300,123300,30201,244199,244199
473.781168,1,539,631,-92,92,123300,123300,29698,91902,91902
473.781168,2,4279,4282,-3,3,123300,123300,20972,-414572,-414572
473.781168,3,542,608,-66,66,123300,123300,17863,149937,149937
473.781168,4,110,50,60,-60,123300,123300,-2017,-23583,-23583
473.781168,5,2783,2790,-7,7,123300,123300,9317,-245617,-245617
473.781168,6,0,0,0,0,123300,123300,0,0,0
473.959962,0,545,645,-100,100,123300,123300,30201,244199,244199
473.959962,1,539,631,-92,92,123300,123300,29698,91902,91902
473.959962,2,4279,4282,-3,3,123300,123300,20972,-414572,-414572
473.959962,3,542,608,-66,66,123300,123300,17863,149937,149937
473.959962,4,110,50,60,-60,123300,123300,-2017,-23583,-23583
473.959962,5,2783,2790,-7,7,123300,123300,9317,-245617,-245617
473.959962,6,0,0,0,0,123300,123300,0,0,0
474.245007,0,545,645,-100,100,123300,123300,30201,244199,244199
474.245007,1,539,631,-92,92,123300,123300,29698,91902,91902
474.245007,2,4279,4282,-3,3,123300,123300,20972,-414572,-414572
474.245007,3,542,608,-66,66,123300,123300,17863,149937,149937
474.245007,4,110,50,60,-60,123300,123300,-2017,-23583,-23583
474.245007,5,2783,2790,-7,7,123300,123300,9317,-245617,-245617
474.245007,6,0,0,0,0,123300,123300,0,0,0
474.520071,0,545,645,-100,100,123300,123300,30201,244199,244199
474.520071,1,539,631,-92,92,123300,123300,29698,91902,91902
474.520071,2,4279,4282,-3,3,123300,123300,20972,-414572,-414572
474.520071,3,542,608,-66,66,123300,123300,17863,149937,149937
474.520071,4,110,50,60,-60,123300,123300,-2017,-23583,-23583
474.520071,5,2783,2790,-7,7,123300,123300,9317,-245617,-245617
474.520071,6,0,0,0,0,123300,123300,0,0,0
474.763853,0,545,645,-100,100,123300,123300,30201,244199,244199
474.763853,1,539,631,-92,92,123300,123300,29698,91902,91902
474.763853,2,4279,4282,-3,3,123300,123300,20972,-414572,-414572
474.763853,3,542,608,-66,66,123300,123300,17863,149937,149937
474.763853,4,110,50,60,-60,123300,123300,-2017,-23583,-23583
474.763853,5,2783,2790,-7,7,123300,123300,9317,-245617,-245617
474.763853,6,0,0,0,0,123300,123300,0,0,0
475.000028,0,545,645,-100,100,123300,123300,30201,244199,244199
475.000028,1,539,631,-92,92,123300,123300,29698,91902,91902
475.000028,2,4279,4282,-3,3,123300,123300,20972,-414572,-414572
475.000028,3,542,608,-66,66,123300,123300,17863,149937,149937
475.000028,4,110,50,60,-60,123300,123300,-2017,-23583,-23583
475.000028,5,2783,2790,-7,7,123300,123300,9317,-245617,-245617
475.000028,6,0,0,0,0,123300,123300,0,0,0
475.236107,0,545,645,-100,100,123300,123300,30201,244199,244199
475.236107,1,539,631,-92,92,123300,123300,29698,91902,91902
475.236107,2,4279,4282,-3,3,123300,123300,20972,-414572,-414572
475.236107,3,542,608,-66,66,123300,123300,17863,149937,149937
475.236107,4,110,50,60,-60,123300,123300,-2017,-23583,-23583
475.236107,5,2783,2790,-7,7,123300,123300,9317,-245617,-245617
475.236107,6,0,0,0,0,123300,123300,0,0,0
475.46818,0,545,645,-100,100,123300,123300,30201,244199,244199
475.46818,1,539,631,-92,92,123300,123300,29698,91902,91902
475.46818,2,4279,4282,-3,3,123300,123300,20972,-414572,-414572
475.46818,3,542,608,-66,66,123300,123300,17863,149937,149937
475.46818,4,110,50,60,-60,123300,123300,-2017,-23583,-23583
475.46818,5,2783,2790,-7,7,123300,123300,9317,-245617,-245617
475.46818,6,0,0,0,0,123300,123300,0,0,0
475.75943,0,545,645,-100,100,123300,123300,30201,244199,244199
475.75943,1,539,631,-92,92,123300,123300,29698,91902,91902
475.75943,2,4279,4282,-3,3,123300,123300,20972,-414572,-414572
475.75943,3,542,608,-66,66,123300,123300,17863,149937,149937
475.75943,4,110,50,60,-60,123300,123300,-2017,-23583,-23583
475.75943,5,2783,2790,-7,7,123300,123300,9317,-245617,-245617
475.75943,6,0,0,0,0,123300,123300,0,0,0
476.024394,0,545,645,-100,100,123300,123300,30201,244199,244199
476.024394,1,539,631,-92,92,123300,123300,29698,91902,91902
476.024394,2,4279,4282,-3,3,123300,123300,20972,-414572,-414572
476.024394,3,542,608,-66,66,123300,123300,17863,149937,149937
476.024394,4,110,50,60,-60,123300,123300,-2017,-23583,-23583
476.024394,5,2783,2790,-7,7,123300,123300,9317,-245617,-245617
476.024394,6,0,0,0,0,123300,123300,0,0,0
476.206735,0,545,645,-100,100,123200,123300,30201,244199,254199
476.206735,1,539,631,-92,92,123200,123300,29698,91902,101102
476.206735,2,4279,4292,-13,13,123200,123300,20849,-416449,-415149
476.206735,3,542,608,-66,66,123200,123300,17863,149937,156537
476.206735,4,110,50,60,-60,123200,123300,-2017,-23583,-29583
476.206735,5,2793,2790,3,-3,123200,123300,9563,-245863,-246163
476.206735,6,0,0,0,0,123200,123300,0,0,0
476.528165,0,545,645,-100,100,123500,123300,30201,244199,224199
476.528165,1,539,631,-92,92,123500,123300,29698,91902,73502
476.528165,2,4289,4298,-9,9,123500,123300,21022,-416422,-418222
476.528165,3,548,608,-60,60,123500,123300,18011,147989,135989
476.528165,4,110,50,60,-60,123500,123300,-2017,-23583,-11583
476.528165,5,2793,2800,-7,7,123500,123300,9440,-245740,-247140
476.528165,6,0,0,0,0,123500,123300,0,0,0
476.777188,0,545,645,-100,100,123500,123300,30201,244199,224199
476.777188,1,539,631,-92,92,123500,123300,29698,91902,73502
476.777188,2,4289,4298,-9,9,123500,123300,21022,-416422,-418222
476.777188,3,548,608,-60,60,123500,123300,18011,147989,135989
476.777188,4,110,50,60,-60,123500,123300,-2017,-23583,-11583
476.777188,5,2793,2800,-7,7,123500,123300,9440,-245740,-247140
476.777188,6,0,0,0,0,123500,123300,0,0,0
476.977117,0,545,645,-100,100,123000,123300,30201,244199,268899
476.977117,1,539,631,-92,92,123000,123300,29698,91902,114626
476.977117,2,4299,4298,1,-1,123000,123300,20899,-416299,-416546
476.977117,3,548,608,-60,60,123000,123300,18011,147989,162809
476.977117,4,110,50,60,-60,123000,123300,-2017,-23583,-38403
476.977117,5,2803,2800,3,-3,123000,123300,9317,-245617,-246358
476.977117,6,0,0,0,0,123000,123300,0,0,0
477.258238,0,545,645,-100,100,123000,123300,30201,244199,268899
477.258238,1,539,631,-92,92,123000,123300,29698,91902,114626
477.258238,2,4299,4298,1,-1,123000,123300,20899,-416299,-416546
477.258238,3,548,608,-60,60,123000,123300,18011,147989,162809
477.258238,4,110,50,60,-60,123000,123300,-2017,-23583,-38403
477.258238,5,2803,2800,3,-3,123000,123300,9317,-245617,-246358
477.258238,6,0,0,0,0,123000,123300,0,0,0
477.499278,0,545,645,-100,100,123000,123200,30201,244199,264199
477.499278,1,539,631,-92,92,123000,123200,29698,91902,110302
477.499278,2,4299,4298,1,-1,123000,123200,20899,-416299,-416499
477.499278,3,548,608,-60,60,123000,123200,18011,147989,159989
477.499278,4,110,50,60,-60,123000,123200,-2017,-23583,-35583
477.499278,5,2803,2800,3,-3,123000,123200,9317,-245617,-246217
477.499278,6,0,0,0,0,123000,123200,0,0,0
477.778594,0,545,645,-100,100,123300,123200,30201,244199,234199
477.778594,1,539,631,-92,92,123300,123200,29698,91902,82702
477.778594,2,4299,4303,-4,4,123300,123200,20837,-416237,-416637
477.778594,3,553,608,-55,55,123300,123200,18134,147366,141866
477.778594,4,110,50,60,-60,123300,123200,-2017,-23583,-17583
477.778594,5,2803,2800,3,-3,123300,123200,9317,-245617,-245317
477.778594,6,0,0,0,0,123300,123200,0,0,0
478.005522,0,545,645,-100,100,123300,123200,30201,244199,234199
478.005522,1,539,631,-92,92,123300,123200,29698,91902,82702
478.005522,2,4299,4303,-4,4,123300,123200,20837,-416237,-416637
478.005522,3,553,608,-55,55,123300,123200,18134,147366,141866
478.005522,4,110,50,60,-60,123300,123200,-2017,-23583,-17583
478.005522,5,2803,2800,3,-3,123300,123200,9317,-245617,-245317
478.005522,6,0,0,0,0,123300,123200,0,0,0
478.247554,0,545,645,-100,100,123300,123200,30201,244199,234199
478.247554,1,539,631,-92,92,123300,123200,29698,91902,82702
478.247554,2,4299,4303,-4,4,123300,123200,20837,-416237,-416637
478.247554,3,553,608,-55,55,123300,123200,18134,147366,141866
478.247554,4,110,50,60,-60,123300,123200,-2017,-23583,-17583
478.247554,5,2803,2800,3,-3,123300,123200,9317,-245617,-245317
478.247554,6,0,0,0,0,123300,123200,0,0,0
478.494741,0,545,645,-100,100,123300,123200,30201,244199,234199
478.494741,1,539,631,-92,92,123300,123200,29698,91902,82702
478.494741,2,4299,4303,-4,4,123300,123200,20837,-416237,-416637
478.494741,3,553,608,-55,55,123300,123200,18134,147366,141866
478.494741,4,110,50,60,-60,123300,123200,-2017,-23583,-17583
478.494741,5,2803,2800,3,-3,123300,123200,9317,-245617,-245317
478.494741,6,0,0,0,0,123300,123200,0,0,0
478.700882,0,545,645,-100,100,123300,123200,30201,244199,234199
478.700882,1,539,631,-92,92,123300,123200,29698,91902,82702
478.700882,2,4299,4303,-4,4,123300,123200,20837,-416237,-416637
478.700882,3,553,608,-55,55,123300,123200,18134,147366,141866
478.700882,4,110,50,60,-60,123300,123200,-2017,-23583,-17583
478.700882,5,2803,2800,3,-3,123300,123200,9317,-245617,-245317
478.700882,6,0,0,0,0,123300,123200,0,0,0
478.981554,0,545,645,-100,100,123300,123200,30201,244199,234199
478.981554,1,539,631,-92,92,123300,123200,29698,91902,82702
478.981554,2,4299,4303,-4,4,123300,123200,20837,-416237,-416637
478.981554,3,553,608,-55,55,123300,123200,18134,147366,141866
478.981554,4,110,50,60,-60,123300,123200,-2017,-23583,-17583
478.981554,5,2803,2800,3,-3,123300,123200,9317,-245617,-245317
478.981554,6,0,0,0,0,123300,123200,0,0,0
479.230941,0,545,645,-100,100,123200,123200,30201,244199,244199
479.230941,1,539,631,-92,92,123200,123200,29698,91902,91902
479.230941,2,4309,4303,6,-6,123200,123200,20714,-417114,-417114
479.230941,3,553,608,-55,55,123200,123200,18134,147366,147366
479.230941,4,110,50,60,-60,123200,123200,-2017,-23583,-23583
479.230941,5,2803,2810,-7,7,123200,123200,9563,-246863,-246863
479.230941,6,0,0,0,0,123200,123200,0,0,0
479.471781,0,545,645,-100,100,123400,123200,30201,244199,224199
479.471781,1,539,631,-92,92,123400,123200,29698,91902,73502
479.471781,2,4309,4313,-4,4,123400,123200,20591,-415991,-416791
479.471781,3,553,608,-55,55,123400,123200,18134,147366,136366
479.471781,4,110,50,60,-60,123400,123200,-2017,-23583,-11583
479.471781,5,2813,2810,3,-3,123400,123200,9810,-249110,-248510
479.471781,6,0,0,0,0,123400,123200,0,0,0
479.727256,0,545,645,-100,100,123400,123200,30201,244199,224199
479.727256,1,539,631,-92,92,123400,123200,29698,91902,73502
479.727256,2,4309,4313,-4,4,123400,123200,20591,-415991,-416791
479.727256,3,553,608,-55,55,123400,123200,18134,147366,136366
479.727256,4,110,50,60,-60,123400,123200,-2017,-23583,-11583
479.727256,5,2813,2810,3,-3,123400,123200,9810,-249110,-248510
479.727256,6,0,0,0,0,123400,123200,0,0,0
479.977329,0,545,645,-100,100,123600,123300,30201,244199,219499
479.977329,1,539,631,-92,92,123600,123300,29698,91902,69178
479.977329,2,4319,4323,-4,4,123600,123300,20345,-415745,-416733
479.977329,3,553,610,-57,57,123600,123300,18109,147791,133712
479.977329,4,110,50,60,-60,123600,123300,-2017,-23583,-8763
479.977329,5,2823,2820,3,-3,123600,123300,9564,-248864,-248123
479.977329,6,0,0,0,0,123600,123300,0,0,0
480.259578,0,545,645,-100,100,123700,123300,30201,244199,219499
480.259578,1,539,631,-92,92,123700,123300,29698,91902,69178
480.259578,2,4319,4333,-14,14,123700,123300,20592,-412992,-416450
480.259578,3,553,612,-59,59,123700,123300,18158,148342,133769
480.259578,4,110,50,60,-60,123700,123300,-2017,-23583,-8763
480.259578,5,2823,2830,-7,7,123700,123300,9811,-246111,-247840
480.259578,6,0,0,0,0,123700,123300,0,0,0
480.472558,0,545,645,-100,100,123700,123300,30201,244199,219499
480.472558,1,539,631,-92,92,123700,123300,29698,91902,69178
480.472558,2,4319,4343,-24,24,123700,123300,20839,-409239,-415167
480.472558,3,553,614,-61,61,123700,123300,18207,149093,134026
480.472558,4,110,50,60,-60,123700,123300,-2017,-23583,-8763
480.472558,5,2823,2840,-17,17,123700,123300,10058,-242358,-246557
480.472558,6,0,0,0,0,123700,123300,0,0,0
480.726963,0,545,645,-100,100,123700,123300,30201,244199,219499
480.726963,1,539,631,-92,92,123700,123300,29698,91902,69178
480.726963,2,4319,4343,-24,24,123700,123300,20839,-409239,-415167
480.726963,3,553,614,-61,61,123700,123300,18207,149093,134026
480.726963,4,110,50,60,-60,123700,123300,-2017,-23583,-8763
480.726963,5,2823,2844,-21,21,123700,123300,10157,-240857,-246044
480.726963,6,0,0,0,0,123700,123300,0,0,0
481.027624,0,545,645,-100,100,123700,123300,30201,244199,219499
481.027624,1,539,631,-92,92,123700,123300,29698,91902,69178
481.027624,2,4319,4343,-24,24,123700,123300,20839,-409239,-415167
481.027624,3,553,614,-61,61,123700,123300,18207,149093,134026
481.027624,4,110,50,60,-60,123700,123300,-2017,-23583,-8763
481.027624,5,2823,2844,-21,21,123700,123300,10157,-240857,-246044
481.027624,6,0,0,0,0,123700,123300,0,0,0
481.216011,0,545,645,-100,100,123400,123300,30201,244199,234199
481.216011,1,539,631,-92,92,123400,123300,29698,91902,82702
481.216011,2,4319,4353,-34,34,123400,123300,21086,-405486,-408886
481.216011,3,553,614,-61,61,123400,123300,18207,149093,142993
481.216011,4,110,50,60,-60,123400,123300,-2017,-23583,-17583
481.216011,5,2833,2844,-11,11,123400,123300,10034,-246734,-247834
481.216011,6,0,0,0,0,123400,123300,0,0,0
481.492079,0,545,645,-100,100,123000,123300,30201,244199,268899
481.492079,1,539,631,-92,92,123000,123300,29698,91902,114626
481.492079,2,4319,4363,-44,44,123000,123300,21332,-400732,-389864
481.492079,3,553,616,-63,63,123000,123300,18256,149644,165205
481.492079,4,110,50,60,-60,123000,123300,-2017,-23583,-38403
481.492079,5,2843,2844,-1,1,123000,123300,9911,-252611,-252364
481.492079,6,0,0,0,0,123000,123300,0,0,0
481.788604,0,545,645,-100,100,123100,123300,30201,244199,264199
481.788604,1,539,631,-92,92,123100,123300,29698,91902,110302
481.788604,2,4321,4363,-42,42,123100,123300,21307,-401707,-393307
481.788604,3,553,618,-65,65,123100,123300,18305,150395,163395
481.788604,4,110,50,60,-60,123100,123300,-2017,-23583,-35583
481.788604,5,2843,2844,-1,1,123100,123300,9911,-252611,-252411
481.788604,6,0,0,0,0,123100,123300,0,0,0
481.988237,0,545,645,-100,100,123400,123300,30201,244199,234199
481.988237,1,539,631,-92,92,123400,123300,29698,91902,82702
481.988237,2,4331,4363,-32,32,123400,123300,21184,-406584,-409784
481.988237,3,553,618,-65,65,123400,123300,18305,150395,143895
481.988237,4,110,50,60,-60,123400,123300,-2017,-23583,-17583
481.988237,5,2843,2854,-11,11,123400,123300,10158,-248858,-249958
481.988237,6,0,0,0,0,123400,123300,0,0,0
482.224661,0,545,645,-100,100,123400,123300,30201,244199,234199
482.224661,1,539,631,-92,92,123400,123300,29698,91902,82702
482.224661,2,4331,4363,-32,32,123400,123300,21184,-406584,-409784
482.224661,3,553,618,-65,65,123400,123300,18305,150395,143895
482.224661,4,110,50,60,-60,123400,123300,-2017,-23583,-17583
482.224661,5,2843,2854,-11,11,123400,123300,10158,-248858,-249958
482.224661,6,0,0,0,0,123400,123300,0,0,0
482.52904,0,545,645,-100,100,123100,123300,30201,244199,264199
482.52904,1,539,631,-92,92,123100,123300,29698,91902,110302
482.52904,2,4333,4363,-30,30,123100,123300,21159,-407359,-401359
482.52904,3,553,620,-67,67,123100,123300,18354,150746,164146
482.52904,4,110,50,60,-60,123100,123300,-2017,-23583,-35583
482.52904,5,2843,2854,-11,11,123100,123300,10158,-248858,-246658
482.52904,6,0,0,0,0,123100,123300,0,0,0
482.717106,0,545,645,-100,100,123100,123300,30201,244199,264199
482.717106,1,539,631,-92,92,123100,123300,29698,91902,110302
482.717106,2,4333,4363,-30,30,123100,123300,21159,-407359,-401359
482.717106,3,553,620,-67,67,123100,123300,18354,150746,164146
482.717106,4,110,50,60,-60,123100,123300,-2017,-23583,-35583
482.717106,5,2843,2854,-11,11,123100,123300,10158,-248858,-246658
482.717106,6,0,0,0,0,123100,123300,0,0,0
482.952672,0,545,645,-100,100,123500,123300,30201,244199,224199
482.952672,1,539,631,-92,92,123500,123300,29698,91902,73502
482.952672,2,4335,4373,-38,38,123500,123300,21084,-404684,-412284
482.952672,3,553,624,-71,71,123500,123300,18304,151596,137396
482.952672,4,110,50,60,-60,123500,123300,-2017,-23583,-11583
482.952672,5,2843,2864,-21,21,123500,123300,10034,-245734,-249934
482.952672,6,0,0,0,0,123500,123300,0,0,0
483.246696,0,545,645,-100,100,123600,123300,30201,244199,219499
483.246696,1,539,631,-92,92,123600,123300,29698,91902,69178
483.246696,2,4335,4380,-45,45,123600,123300,21257,-402057,-413172
483.246696,3,553,626,-73,73,123600,123300,18353,152347,134316
483.246696,4,110,50,60,-60,123600,123300,-2017,-23583,-8763
483.246696,5,2843,2874,-31,31,123600,123300,10281,-241981,-249638
483.246696,6,0,0,0,0,123600,123300,0,0,0
483.523375,0,545,645,-100,100,123800,123300,30201,244199,219499
483.523375,1,539,631,-92,92,123800,123300,29698,91902,69178
483.523375,2,4345,4383,-38,38,123800,123300,21468,-406668,-416054
483.523375,3,553,626,-73,73,123800,123300,18353,152347,134316
483.523375,4,110,50,60,-60,123800,123300,-2017,-23583,-8763
483.523375,5,2846,2874,-28,28,123800,123300,10355,-242955,-249871
483.523375,6,0,0,0,0,123800,123300,0,0,0
483.746828,0,545,645,-100,100,123700,123300,30201,244199,219499
483.746828,1,539,631,-92,92,123700,123300,29698,91902,69178
483.746828,2,4349,4383,-34,34,123700,123300,21492,-408692,-417090
483.746828,3,553,630,-77,77,123700,123300,18377,153923,134904
483.746828,4,110,50,60,-60,123700,123300,-2017,-23583,-8763
483.746828,5,2846,2874,-28,28,123700,123300,10355,-242955,-249871
483.746828,6,0,0,0,0,123700,123300,0,0,0
484.050279,0,545,645,-100,100,123800,123300,30201,244199,219499
484.050279,1,539,631,-92,92,123800,123300,29698,91902,69178
484.050279,2,4349,4393,-44,44,123800,123300,21368,-406568,-417436
484.050279,3,553,632,-79,79,123800,123300,18426,154274,134761
484.050279,4,110,50,60,-60,123800,123300,-2017,-23583,-8763
484.050279,5,2848,2874,-26,26,123800,123300,10330,-243730,-250152
484.050279,6,0,0,0,0,123800,123300,0,0,0
484.222613,0,545,645,-100,100,123800,123300,30201,244199,219499
484.222613,1,539,631,-92,92,123800,123300,29698,91902,69178
484.222613,2,4359,4393,-34,34,123800,123300,21616,-412816,-421214
484.222613,3,553,632,-79,79,123800,123300,18426,154274,134761
484.222613,4,110,50,60,-60,123800,123300,-2017,-23583,-8763
484.222613,5,2848,2874,-26,26,123800,123300,10330,-243730,-250152
484.222613,6,0,0,0,0,123800,123300,0,0,0
484.525052,0,545,645,-100,100,123800,123400,30201,244199,219499
484.525052,1,539,631,-92,92,123800,123400,29698,91902,69178
484.525052,2,4369,4403,-34,34,123800,123400,21368,-414568,-422966
484.525052,3,553,636,-83,83,123800,123400,18524,155376,134875
484.525052,4,110,50,60,-60,123800,123400,-2017,-23583,-8763
484.525052,5,2848,2884,-36,36,123800,123400,10206,-241606,-250498
484.525052,6,0,0,0,0,123800,123400,0,0,0
484.704573,0,545,645,-100,100,123800,123400,30201,244199,219499
484.704573,1,539,631,-92,92,123800,123400,29698,91902,69178
484.704573,2,4379,4403,-24,24,123800,123400,21616,-418816,-424744
484.704573,3,553,636,-83,83,123800,123400,18524,155376,134875
484.704573,4,110,50,60,-60,123800,123400,-2017,-23583,-8763
484.704573,5,2848,2884,-36,36,123800,123400,10206,-241606,-250498
484.704573,6,0,0,0,0,123800,123400,0,0,0
484.964595,0,545,645,-100,100,123200,123400,30201,244199,264199
484.964595,1,539,631,-92,92,123200,123400,29698,91902,110302
484.964595,2,4389,4403,-14,14,123200,123400,21492,-422692,-419892
484.964595,3,553,638,-85,85,123200,123400,18573,155927,172927
484.964595,4,110,50,60,-60,123200,123400,-2017,-23583,-35583
484.964595,5,2858,2884,-26,26,123200,123400,10082,-245482,-240282
484.964595,6,0,0,0,0,123200,123400,0,0,0
485.209207,0,545,645,-100,100,123400,123400,30201,244199,244199
485.209207,1,539,631,-92,92,123400,123400,29698,91902,91902
485.209207,2,4399,4403,-4,4,123400,123400,21738,-422938,-422938
485.209207,3,561,638,-77,77,123400,123400,18770,154130,154130
485.209207,4,110,50,60,-60,123400,123400,-2017,-23583,-23583
485.209207,5,2868,2884,-16,16,123400,123400,10329,-245929,-245929
485.209207,6,0,0,0,0,123400,123400,0,0,0
485.544412,0,545,645,-100,100,123400,123400,30201,244199,244199
485.544412,1,539,631,-92,92,123400,123400,29698,91902,91902
485.544412,2,4409,4403,6,-6,123400,123400,21985,-424185,-424185
485.544412,3,561,638,-77,77,123400,123400,18770,154130,154130
485.544412,4,110,50,60,-60,123400,123400,-2017,-23583,-23583
485.544412,5,2878,2884,-6,6,123400,123400,10576,-247176,-247176
485.544412,6,0,0,0,0,123400,123400,0,0,0
485.78976,0,545,645,-100,100,123500,123400,30201,244199,234199
485.78976,1,539,631,-92,92,123500,123400,29698,91902,82702
485.78976,2,4409,4410,-1,1,123500,123400,21899,-424799,-424899
485.78976,3,568,638,-70,70,123500,123400,18943,153257,146257
485.78976,4,110,50,60,-60,123500,123400,-2017,-23583,-17583
485.78976,5,2888,2884,4,-4,123500,123400,10823,-247423,-247023
485.78976,6,0,0,0,0,123500,123400,0,0,0
486.007207,0,545,645,-100,100,123600,123400,30201,244199,224199
486.007207,1,539,631,-92,92,123600,123400,29698,91902,73502
486.007207,2,4409,4416,-7,7,123600,123400,21825,-424125,-425525
486.007207,3,574,638,-64,64,123600,123400,19091,151909,139109
486.007207,4,110,50,60,-60,123600,123400,-2017,-23583,-11583
486.007207,5,2888,2884,4,-4,123600,123400,10823,-247423,-246623
486.007207,6,0,0,0,0,123600,123400,0,0,0
486.25733,0,545,645,-100,100,123600,123400,30201,244199,224199
486.25733,1,539,631,-92,92,123600,123400,29698,91902,73502
486.25733,2,4409,4416,-7,7,123600,123400,21825,-424125,-425525
486.25733,3,574,638,-64,64,123600,123400,19091,151909,139109
486.25733,4,110,50,60,-60,123600,123400,-2017,-23583,-11583
486.25733,5,2888,2884,4,-4,123600,123400,10823,-247423,-246623
486.25733,6,0,0,0,0,123600,123400,0,0,0
486.54577,0,545,645,-100,100,124000,123400,30201,244199,219499
486.54577,1,539,631,-92,92,124000,123400,29698,91902,69178
486.54577,2,4419,4426,-7,7,124000,123400,21577,-424877,-426606
486.54577,3,574,640,-66,66,124000,123400,19066,152534,136232
486.54577,4,110,50,60,-60,124000,123400,-2017,-23583,-8763
486.54577,5,2888,2894,-6,6,124000,123400,11070,-246670,-248152
486.54577,6,0,0,0,0,124000,123400,0,0,0
486.776747,0,545,645,-100,100,123200,123300,30201,244199,254199
486.776747,1,539,631,-92,92,123200,123300,29698,91902,101102
486.776747,2,4429,4426,3,-3,123200,123300,21454,-425754,-426054
486.776747,3,574,640,-66,66,123200,123300,19066,152534,159134
486.776747,4,110,50,60,-60,123200,123300,-2017,-23583,-29583
486.776747,5,2906,2894,12,-12,123200,123300,11144,-245944,-247144
486.776747,6,0,0,0,0,123200,123300,0,0,0
487.047539,0,545,645,-100,100,123200,123300,30201,244199,254199
487.047539,1,539,631,-92,92,123200,123300,29698,91902,101102
487.047539,2,4429,4426,3,-3,123200,123300,21454,-425754,-426054
487.047539,3,574,640,-66,66,123200,123300,19066,152534,159134
487.047539,4,110,50,60,-60,123200,123300,-2017,-23583,-29583
487.047539,5,2906,2894,12,-12,123200,123300,11144,-245944,-247144
487.047539,6,0,0,0,0,123200,123300,0,0,0
487.254366,0,545,645,-100,100,123100,123300,30201,244199,264199
487.254366,1,539,631,-92,92,123100,123300,29698,91902,110302
487.254366,2,4429,4436,-7,7,123100,123300,21700,-425000,-423600
487.254366,3,574,640,-66,66,123100,123300,19066,152534,165734
487.254366,4,110,50,60,-60,123100,123300,-2017,-23583,-35583
487.254366,5,2906,2894,12,-12,123100,123300,11144,-245944,-248344
487.254366,6,0,0,0,0,123100,123300,0,0,0
487.473504,0,545,645,-100,100,123100,123300,30201,244199,264199
487.473504,1,539,631,-92,92,123100,123300,29698,91902,110302
487.473504,2,4429,4436,-7,7,123100,123300,21700,-425000,-423600
487.473504,3,574,640,-66,66,123100,123300,19066,152534,165734
487.473504,4,110,50,60,-60,123100,123300,-2017,-23583,-35583
487.473504,5,2906,2904,2,-2,123100,123300,11390,-247190,-247590
487.473504,6,0,0,0,0,123100,123300,0,0,0
487.721471,0,545,645,-100,100,123100,123300,30201,244199,264199
487.721471,1,539,631,-92,92,123100,123300,29698,91902,110302
487.721471,2,4439,4436,3,-3,123100,123300,21577,-424877,-425477
487.721471,3,574,640,-66,66,123100,123300,19066,152534,165734
487.721471,4,110,50,60,-60,123100,123300,-2017,-23583,-35583
487.721471,5,2906,2904,2,-2,123100,123300,11390,-247190,-247590
487.721471,6,0,0,0,0,123100,123300,0,0,0
487.999952,0,545,645,-100,100,123300,123300,30201,244199,244199
487.999952,1,539,631,-92,92,123300,123300,29698,91902,91902
487.999952,2,4441,4442,-1,1,123300,123300,21478,-424578,-424578
487.999952,3,580,640,-60,60,123300,123300,19214,151186,151186
487.999952,4,110,50,60,-60,123300,123300,-2017,-23583,-23583
487.999952,5,2906,2904,2,-2,123300,123300,11390,-247190,-247190
487.999952,6,0,0,0,0,123300,123300,0,0,0
488.249572,0,545,645,-100,100,123300,123300,30201,244199,244199
488.249572,1,539,631,-92,92,123300,123300,29698,91902,91902
488.249572,2,4441,4442,-1,1,123300,123300,21478,-424578,-424578
488.249572,3,580,640,-60,60,123300,123300,19214,151186,151186
488.249572,4,110,50,60,-60,123300,123300,-2017,-23583,-23583
488.249572,5,2906,2904,2,-2,123300,123300,11390,-247190,-247190
488.249572,6,0,0,0,0,123300,123300,0,0,0
488.492998,0,545,645,-100,100,123300,123400,30201,244199,254199
488.492998,1,539,631,-92,92,123300,123400,29698,91902,101102
488.492998,2,4441,4442,-1,1,123300,123400,21478,-424578,-424478
488.492998,3,580,640,-60,60,123300,123400,19214,151186,157186
488.492998,4,110,50,60,-60,123300,123400,-2017,-23583,-29583
488.492998,5,2906,2904,2,-2,123300,123400,11390,-247190,-247390
488.492998,6,0,0,0,0,123300,123400,0,0,0
488.764956,0,545,645,-100,100,124000,123400,30201,244199,219499
488.764956,1,539,631,-92,92,124000,123400,29698,91902,69178
488.764956,2,4451,4452,-1,1,124000,123400,21230,-425330,-425577
488.764956,3,580,642,-62,62,124000,123400,19189,152011,136697
488.764956,4,110,50,60,-60,124000,123400,-2017,-23583,-8763
488.764956,5,2906,2914,-8,8,124000,123400,11637,-246437,-248413
488.764956,6,0,0,0,0,124000,123400,0,0,0
489.028279,0,545,645,-100,100,124000,123400,30201,244199,219499
489.028279,1,539,631,-92,92,124000,123400,29698,91902,69178
489.028279,2,4451,4452,-1,1,124000,123400,21230,-425330,-425577
489.028279,3,580,642,-62,62,124000,123400,19189,152011,136697
489.028279,4,110,50,60,-60,124000,123400,-2017,-23583,-8763
489.028279,5,2906,2914,-8,8,124000,123400,11637,-246437,-248413
489.028279,6,0,0,0,0,124000,123400,0,0,0
489.232348,0,545,645,-100,100,124000,123400,30201,244199,219499
489.232348,1,539,631,-92,92,124000,123400,29698,91902,69178
489.232348,2,4451,4452,-1,1,124000,123400,21230,-425330,-425577
489.232348,3,580,642,-62,62,124000,123400,19189,152011,136697
489.232348,4,110,50,60,-60,124000,123400,-2017,-23583,-8763
489.232348,5,2906,2914,-8,8,124000,123400,11637,-246437,-248413
489.232348,6,0,0,0,0,124000,123400,0,0,0
489.543341,0,545,645,-100,100,124100,123400,30201,244199,219499
489.543341,1,539,631,-92,92,124100,123400,29698,91902,69178
489.543341,2,4451,4462,-11,11,124100,123400,21106,-423206,-425923
489.543341,3,580,644,-64,64,124100,123400,19164,152836,137028
489.543341,4,110,50,60,-60,124100,123400,-2017,-23583,-8763
489.543341,5,2906,2924,-18,18,124100,123400,11513,-243313,-247759
489.543341,6,0,0,0,0,124100,123400,0,0,0
489.792328,0,545,645,-100,100,122900,123400,30201,244199,268899
489.792328,1,539,631,-92,92,122900,123400,29698,91902,114626
489.792328,2,4461,4472,-11,11,122900,123400,20858,-422958,-420241
489.792328,3,582,644,-62,62,122900,123400,19139,153661,168975
489.792328,4,110,50,60,-60,122900,123400,-2017,-23583,-38403
489.792328,5,2916,2934,-18,18,122900,123400,12007,-245807,-241361
489.792328,6,0,0,0,0,122900,123400,0,0,0
490.005685,0,545,645,-100,100,122900,123800,30201,244199,268999
490.005685,1,539,631,-92,92,122900,123800,29698,91902,114718
490.005685,2,4461,4472,-11,11,122900,123800,20858,-422958,-420230
490.005685,3,582,644,-62,62,122900,123800,19139,153661,169037
490.005685,4,110,50,60,-60,122900,123800,-2017,-23583,-38463
490.005685,5,2916,2934,-18,18,122900,123800,12007,-245807,-241343
490.005685,6,0,0,0,0,122900,123800,0,0,0
490.215145,0,545,645,-100,100,123900,123800,30201,244199,234199
490.215145,1,539,631,-92,92,123900,123800,29698,91902,82702
490.215145,2,4463,4482,-19,19,123900,123800,20784,-423284,-425184
490.215145,3,582,646,-64,64,123900,123800,19114,153886,147486
490.215145,4,110,50,60,-60,123900,123800,-2017,-23583,-17583
490.215145,5,2926,2934,-8,8,123900,123800,12255,-247055,-247855
490.215145,6,0,0,0,0,123900,123800,0,0,0
490.477944,0,545,645,-100,100,124100,123800,30201,244199,219399
490.477944,1,539,631,-92,92,124100,123800,29698,91902,69086
490.477944,2,4463,4482,-19,19,124100,123800,20784,-423284,-427996
490.477944,3,588,646,-58,58,124100,123800,19263,151937,137553
490.477944,4,110,50,60,-60,124100,123800,-2017,-23583,-8703
490.477944,5,2926,2934,-8,8,124100,123800,12255,-247055,-249039
490.477944,6,0,0,0,0,124100,123800,0,0,0
490.75241,0,545,645,-100,100,124100,123800,30201,244199,219399
490.75241,1,539,631,-92,92,124100,123800,29698,91902,69086
490.75241,2,4463,4482,-19,19,124100,123800,20784,-423284,-427996
490.75241,3,588,646,-58,58,124100,123800,19263,151937,137553
490.75241,4,110,50,60,-60,124100,123800,-2017,-23583,-8703
490.75241,5,2926,2934,-8,8,124100,123800,12255,-247055,-249039
490.75241,6,0,0,0,0,124100,123800,0,0,0
491.002015,0,545,645,-100,100,123800,123800,30201,244199,244199
491.002015,1,539,631,-92,92,123800,123800,29698,91902,91902
491.002015,2,4463,4485,-22,22,123800,123800,20747,-422647,-422647
491.002015,3,588,646,-58,58,123800,123800,19263,151937,151937
491.002015,4,110,50,60,-60,123800,123800,-2017,-23583,-23583
491.002015,5,2926,2934,-8,8,123800,123800,12255,-247055,-247055
491.002015,6,0,0,0,0,123800,123800,0,0,0
491.297128,0,545,645,-100,100,123800,123800,30201,244199,244199
491.297128,1,539,631,-92,92,123800,123800,29698,91902,91902
491.297128,2,4465,4485,-20,20,123800,123800,20722,-423222,-423222
491.297128,3,588,648,-60,60,123800,123800,19313,152287,152287
491.297128,4,110,50,60,-60,123800,123800,-2017,-23583,-23583
491.297128,5,2926,2934,-8,8,123800,123800,12255,-247055,-247055
491.297128,6,0,0,0,0,123800,123800,0,0,0
491.514657,0,545,645,-100,100,123700,123600,30201,244199,234199
491.514657,1,539,631,-92,92,123700,123600,29698,91902,82702
491.514657,2,4465,4485,-20,20,123700,123600,20722,-423222,-425222
491.514657,3,588,648,-60,60,123700,123600,19313,152287,146287
491.514657,4,110,50,60,-60,123700,123600,-2017,-23583,-17583
491.514657,5,2929,2934,-5,5,123700,123600,12218,-247618,-248118
491.514657,6,0,0,0,0,123700,123600,0,0,0
491.760321,0,545,645,-100,100,123700,123700,30201,244199,244199
491.760321,1,539,631,-92,92,123700,123700,29698,91902,91902
491.760321,2,4465,4485,-20,20,123700,123700,20722,-423222,-423222
491.760321,3,588,648,-60,60,123700,123700,19313,152287,152287
491.760321,4,110,50,60,-60,123700,123700,-2017,-23583,-23583
491.760321,5,2929,2934,-5,5,123700,123700,12218,-247618,-247618
491.760321,6,0,0,0,0,123700,123700,0,0,0
492.006104,0,545,645,-100,100,123700,123700,30201,244199,244199
492.006104,1,539,631,-92,92,123700,123700,29698,91902,91902
492.006104,2,4465,4485,-20,20,123700,123700,20722,-423222,-423222
492.006104,3,588,648,-60,60,123700,123700,19313,152287,152287
492.006104,4,110,50,60,-60,123700,123700,-2017,-23583,-23583
492.006104,5,2929,2934,-5,5,123700,123700,12218,-247618,-247618
492.006104,6,0,0,0,0,123700,123700,0,0,0
492.234031,0,545,645,-100,100,123900,123700,30201,244199,224199
492.234031,1,539,631,-92,92,123900,123700,29698,91902,73502
492.234031,2,4470,4485,-15,15,123900,123700,20660,-424160,-427160
492.234031,3,588,648,-60,60,123900,123700,19313,152287,140287
492.234031,4,110,50,60,-60,123900,123700,-2017,-23583,-11583
492.234031,5,2929,2934,-5,5,123900,123700,12218,-247618,-248618
492.234031,6,0,0,0,0,123900,123700,0,0,0
492.549305,0,545,645,-100,100,123900,123700,30201,244199,224199
492.549305,1,539,631,-92,92,123900,123700,29698,91902,73502
492.549305,2,4470,4485,-15,15,123900,123700,20660,-424160,-427160
492.549305,3,588,648,-60,60,123900,123700,19313,152287,140287
492.549305,4,110,50,60,-60,123900,123700,-2017,-23583,-11583
492.549305,5,2929,2934,-5,5,123900,123700,12218,-247618,-248618
492.549305,6,0,0,0,0,123900,123700,0,0,0
492.725291,0,545,645,-100,100,123900,123700,30201,244199,224199
492.725291,1,539,631,-92,92,123900,123700,29698,91902,73502
492.725291,2,4470,4485,-15,15,123900,123700,20660,-424160,-427160
492.725291,3,588,648,-60,60,123900,123700,19313,152287,140287
492.725291,4,110,50,60,-60,123900,123700,-2017,-23583,-11583
492.725291,5,2929,2934,-5,5,123900,123700,12218,-247618,-248618
492.725291,6,0,0,0,0,123900,123700,0,0,0
493.036821,0,545,645,-100,100,123900,123600,30201,244199,219499
493.036821,1,539,631,-92,92,123900,123600,29698,91902,69178
493.036821,2,4470,4485,-15,15,123900,123600,20660,-424160,-427865
493.036821,3,588,648,-60,60,123900,123600,19313,152287,137467
493.036821,4,110,50,60,-60,123900,123600,-2017,-23583,-8763
493.036821,5,2929,2934,-5,5,123900,123600,12218,-247618,-248853
493.036821,6,0,0,0,0,123900,123600,0,0,0
493.274322,0,545,645,-100,100,123800,123600,30201,244199,224199
493.274322,1,539,631,-92,92,123800,123600,29698,91902,73502
493.274322,2,4472,4485,-13,13,123800,123600,20635,-424535,-427135
493.274322,3,588,650,-62,62,123800,123600,19363,152237,139837
493.274322,4,110,50,60,-60,123800,123600,-2017,-23583,-11583
493.274322,5,2929,2934,-5,5,123800,123600,12218,-247618,-248618
493.274322,6,0,0,0,0,123800,123600,0,0,0
493.548157,0,545,645,-100,100,123800,123800,30201,244199,244199
493.548157,1,539,631,-92,92,123800,123800,29698,91902,91902
493.548157,2,4472,4485,-13,13,123800,123800,20635,-424535,-424535
493.548157,3,588,650,-62,62,123800,123800,19363,152237,152237
493.548157,4,110,50,60,-60,123800,123800,-2017,-23583,-23583
493.548157,5,2929,2934,-5,5,123800,123800,12218,-247618,-247618
493.548157,6,0,0,0,0,123800,123800,0,0,0
493.776793,0,545,645,-100,100,123800,123800,30201,244199,244199
493.776793,1,539,631,-92,92,123800,123800,29698,91902,91902
493.776793,2,4472,4485,-13,13,123800,123800,20635,-424535,-424535
493.776793,3,588,650,-62,62,123800,123800,19363,152237,152237
493.776793,4,110,50,60,-60,123800,123800,-2017,-23583,-23583
493.776793,5,2929,2934,-5,5,123800,123800,12218,-247618,-247618
493.776793,6,0,0,0,0,123800,123800,0,0,0
493.979489,0,545,645,-100,100,124100,123800,30201,244199,219399
493.979489,1,539,631,-92,92,124100,123800,29698,91902,69086
493.979489,2,4472,4495,-23,23,124100,123800,20883,-422783,-428487
493.979489,3,588,650,-62,62,124100,123800,19363,152237,136861
493.979489,4,110,50,60,-60,124100,123800,-2017,-23583,-8703
493.979489,5,2939,2934,5,-5,124100,123800,12094,-250494,-249254
493.979489,6,0,0,0,0,124100,123800,0,0,0
494.261657,0,545,645,-100,100,124100,123700,30201,244199,219499
494.261657,1,539,631,-92,92,124100,123700,29698,91902,69178
494.261657,2,4482,4495,-13,13,124100,123700,20759,-425659,-428870
494.261657,3,588,650,-62,62,124100,123700,19363,152237,136923
494.261657,4,110,50,60,-60,124100,123700,-2017,-23583,-8763
494.261657,5,2939,2944,-5,5,124100,123700,12342,-248742,-249977
494.261657,6,0,0,0,0,124100,123700,0,0,0
494.484406,0,545,645,-100,100,124100,123700,30201,244199,219499
494.484406,1,539,631,-92,92,124100,123700,29698,91902,69178
494.484406,2,4482,4495,-13,13,124100,123700,20759,-425659,-428870
494.484406,3,588,650,-62,62,124100,123700,19363,152237,136923
494.484406,4,110,50,60,-60,124100,123700,-2017,-23583,-8763
494.484406,5,2939,2944,-5,5,124100,123700,12342,-248742,-249977
494.484406,6,0,0,0,0,124100,123700,0,0,0
494.714504,0,545,645,-100,100,124100,123700,30201,244199,219499
494.714504,1,539,631,-92,92,124100,123700,29698,91902,69178
494.714504,2,4482,4495,-13,13,124100,123700,20759,-425659,-428870
494.714504,3,588,650,-62,62,124100,123700,19363,152237,136923
494.714504,4,110,50,60,-60,124100,123700,-2017,-23583,-8763
494.714504,5,2939,2944,-5,5,124100,123700,12342,-248742,-249977
494.714504,6,0,0,0,0,124100,123700,0,0,0
495.04861,0,545,645,-100,100,124100,123700,30201,244199,219499
495.04861,1,539,631,-92,92,124100,123700,29698,91902,69178
495.04861,2,4482,4495,-13,13,124100,123700,20759,-425659,-428870
495.04861,3,588,650,-62,62,124100,123700,19363,152237,136923
495.04861,4,110,50,60,-60,124100,123700,-2017,-23583,-8763
495.04861,5,2939,2944,-5,5,124100,123700,12342,-248742,-249977
495.04861,6,0,0,0,0,124100,123700,0,0,0
495.200408,0,545,645,-100,100,124100,123700,30201,244199,219499
495.200408,1,539,631,-92,92,124100,123700,29698,91902,69178
495.200408,2,4482,4495,-13,13,124100,123700,20759,-425659,-428870
495.200408,3,588,650,-62,62,124100,123700,19363,152237,136923
495.200408,4,110,50,60,-60,124100,123700,-2017,-23583,-8763
495.200408,5,2939,2944,-5,5,124100,123700,12342,-248742,-249977
495.200408,6,0,0,0,0,124100,123700,0,0,0
495.462406,0,545,645,-100,100,123500,123700,30201,244199,264199
495.462406,1,539,631,-92,92,123500,123700,29698,91902,110302
495.462406,2,4492,4505,-13,13,123500,123700,20511,-426411,-423811
495.462406,3,588,650,-62,62,123500,123700,19363,152237,164637
495.462406,4,110,50,60,-60,123500,123700,-2017,-23583,-35583
495.462406,5,2949,2954,-5,5,123500,123700,12836,-252236,-251236
495.462406,6,0,0,0,0,123500,123700,0,0,0
495.71708,0,545,645,-100,100,123500,123700,30201,244199,264199
495.71708,1,539,631,-92,92,123500,123700,29698,91902,110302
495.71708,2,4492,4505,-13,13,123500,123700,20511,-426411,-423811
495.71708,3,588,650,-62,62,123500,123700,19363,152237,164637
495.71708,4,110,50,60,-60,123500,123700,-2017,-23583,-35583
495.71708,5,2949,2954,-5,5,123500,123700,12836,-252236,-251236
495.71708,6,0,0,0,0,123500,123700,0,0,0
495.968381,0,545,645,-100,100,123500,123700,30201,244199,264199
495.968381,1,539,631,-92,92,123500,123700,29698,91902,110302
495.968381,2,4492,4505,-13,13,123500,123700,20511,-426411,-423811
495.968381,3,588,650,-62,62,123500,123700,19363,152237,164637
495.968381,4,110,50,60,-60,123500,123700,-2017,-23583,-35583
495.968381,5,2949,2954,-5,5,123500,123700,12836,-252236,-251236
495.968381,6,0,0,0,0,123500,123700,0,0,0
496.28214,0,545,645,-100,100,123500,123700,30201,244199,264199
496.28214,1,539,631,-92,92,123500,123700,29698,91902,110302
496.28214,2,4492,4505,-13,13,123500,123700,20511,-426411,-423811
496.28214,3,588,650,-62,62,123500,123700,19363,152237,164637
496.28214,4,110,50,60,-60,123500,123700,-2017,-23583,-35583
496.28214,5,2949,2954,-5,5,123500,123700,12836,-252236,-251236
496.28214,6,0,0,0,0,123500,123700,0,0,0
496.49304,0,545,645,-100,100,123500,123700,30201,244199,264199
496.49304,1,539,631,-92,92,123500,123700,29698,91902,110302
496.49304,2,4502,4509,-7,7,123500,123700,20337,-426437,-425037
496.49304,3,588,650,-62,62,123500,123700,19363,152237,164637
496.49304,4,110,50,60,-60,123500,123700,-2017,-23583,-35583
496.49304,5,2957,2964,-7,7,123500,123700,12613,-250013,-248613
496.49304,6,0,0,0,0,123500,123700,0,0,0
496.772369,0,545,645,-100,100,123500,123700,30201,244199,264199
496.772369,1,539,631,-92,92,123500,123700,29698,91902,110302
496.772369,2,4502,4509,-7,7,123500,123700,20337,-426437,-425037
496.772369,3,588,650,-62,62,123500,123700,19363,152237,164637
496.772369,4,110,50,60,-60,123500,123700,-2017,-23583,-35583
496.772369,5,2957,2964,-7,7,123500,123700,12613,-250013,-248613
496.772369,6,0,0,0,0,123500,123700,0,0,0
497.008507,0,545,645,-100,100,123500,123700,30201,244199,264199
497.008507,1,539,631,-92,92,123500,123700,29698,91902,110302
497.008507,2,4502,4509,-7,7,123500,123700,20337,-426437,-425037
497.008507,3,588,650,-62,62,123500,123700,19363,152237,164637
497.008507,4,110,50,60,-60,123500,123700,-2017,-23583,-35583
497.008507,5,2957,2964,-7,7,123500,123700,12613,-250013,-248613
497.008507,6,0,0,0,0,123500,123700,0,0,0
497.271836,0,545,645,-100,100,123500,123700,30201,244199,264199
497.271836,1,539,631,-92,92,123500,123700,29698,91902,110302
497.271836,2,4502,4519,-17,17,123500,123700,20584,-426684,-423284
497.271836,3,588,650,-62,62,123500,123700,19363,152237,164637
497.271836,4,110,50,60,-60,123500,123700,-2017,-23583,-35583
497.271836,5,2967,2964,3,-3,123500,123700,12489,-251889,-252489
497.271836,6,0,0,0,0,123500,123700,0,0,0
497.52286,0,545,645,-100,100,123700,123700,30201,244199,244199
497.52286,1,539,631,-92,92,123700,123700,29698,91902,91902
497.52286,2,4512,4519,-7,7,123700,123700,20831,-428931,-428931
497.52286,3,588,652,-64,64,123700,123700,19338,152462,152462
497.52286,4,110,50,60,-60,123700,123700,-2017,-23583,-23583
497.52286,5,2967,2972,-5,5,123700,123700,12390,-250990,-250990
497.52286,6,0,0,0,0,123700,123700,0,0,0
497.747472,0,545,645,-100,100,123700,123700,30201,244199,244199
497.747472,1,539,631,-92,92,123700,123700,29698,91902,91902
497.747472,2,4512,4519,-7,7,123700,123700,20831,-428931,-428931
497.747472,3,588,652,-64,64,123700,123700,19338,152462,152462
497.747472,4,110,50,60,-60,123700,123700,-2017,-23583,-23583
497.747472,5,2967,2972,-5,5,123700,123700,12390,-250990,-250990
497.747472,6,0,0,0,0,123700,123700,0,0,0
497.955404,0,545,645,-100,100,123700,123700,30201,244199,244199
497.955404,1,539,631,-92,92,123700,123700,29698,91902,91902
497.955404,2,4512,4519,-7,7,123700,123700,20831,-428931,-428931
497.955404,3,588,652,-64,64,123700,123700,19338,152462,152462
497.955404,4,110,50,60,-60,123700,123700,-2017,-23583,-23583
497.955404,5,2967,2972,-5,5,123700,123700,12390,-250990,-250990
497.955404,6,0,0,0,0,123700,123700,0,0,0
498.221543,0,545,645,-100,100,123700,123700,30201,244199,244199
498.221543,1,539,631,-92,92,123700,123700,29698,91902,91902
498.221543,2,4512,4519,-7,7,123700,123700,20831,-428931,-428931
498.221543,3,588,652,-64,64,123700,123700,19338,152462,152462
498.221543,4,110,50,60,-60,123700,123700,-2017,-23583,-23583
498.221543,5,2967,2972,-5,5,123700,123700,12390,-250990,-250990
498.221543,6,0,0,0,0,123700,123700,0,0,0
498.464814,0,545,645,-100,100,123700,123700,30201,244199,244199
498.464814,1,539,631,-92,92,123700,123700,29698,91902,91902
498.464814,2,4512,4519,-7,7,123700,123700,20831,-428931,-428931
498.464814,3,588,652,-64,64,123700,123700,19338,152462,152462
498.464814,4,110,50,60,-60,123700,123700,-2017,-23583,-23583
498.464814,5,2967,2972,-5,5,123700,123700,12390,-250990,-250990
498.464814,6,0,0,0,0,123700,123700,0,0,0
498.767539,0,545,645,-100,100,124000,123600,30201,244199,219499
498.767539,1,539,631,-92,92,124000,123600,29698,91902,69178
498.767539,2,4512,4529,-17,17,124000,123600,20707,-427807,-432006
498.767539,3,588,654,-66,66,124000,123600,19313,153087,136785
498.767539,4,110,50,60,-60,124000,123600,-2017,-23583,-8763
498.767539,5,2967,2982,-15,15,124000,123600,12266,-248866,-252571
498.767539,6,0,0,0,0,124000,123600,0,0,0
499.004921,0,545,645,-100,100,124000,123600,30201,244199,219499
499.004921,1,539,631,-92,92,124000,123600,29698,91902,69178
499.004921,2,4512,4529,-17,17,124000,123600,20707,-427807,-432006
499.004921,3,588,654,-66,66,124000,123600,19313,153087,136785
499.004921,4,110,50,60,-60,124000,123600,-2017,-23583,-8763
499.004921,5,2967,2982,-15,15,124000,123600,12266,-248866,-252571
499.004921,6,0,0,0,0,124000,123600,0,0,0
499.257417,0,545,645,-100,100,124000,123600,30201,244199,219499
499.257417,1,539,631,-92,92,124000,123600,29698,91902,69178
499.257417,2,4512,4529,-17,17,124000,123600,20707,-427807,-432006
499.257417,3,588,654,-66,66,124000,123600,19313,153087,136785
499.257417,4,110,50,60,-60,124000,123600,-2017,-23583,-8763
499.257417,5,2967,2982,-15,15,124000,123600,12266,-248866,-252571
499.257417,6,0,0,0,0,124000,123600,0,0,0
499.491462,0,545,645,-100,100,123300,123600,30201,244199,268899
499.491462,1,539,631,-92,92,123300,123600,29698,91902,114626
499.491462,2,4522,4529,-7,7,123300,123600,20583,-429683,-427954
499.491462,3,590,654,-64,64,123300,123600,19288,153712,169520
499.491462,4,110,50,60,-60,123300,123600,-2017,-23583,-38403
499.491462,5,2977,2982,-5,5,123300,123600,12142,-249742,-248507
499.491462,6,0,0,0,0,123300,123600,0,0,0
499.788932,0,545,645,-100,100,123300,123600,30201,244199,268899
499.788932,1,539,631,-92,92,123300,123600,29698,91902,114626
499.788932,2,4522,4529,-7,7,123300,123600,20583,-429683,-427954
499.788932,3,590,654,-64,64,123300,123600,19288,153712,169520
499.788932,4,110,50,60,-60,123300,123600,-2017,-23583,-38403
499.788932,5,2977,2982,-5,5,123300,123600,12142,-249742,-248507
499.788932,6,0,0,0,0,123300,123600,0,0,0
500.010266,0,545,645,-100,100,123300,123600,30201,244199,268899
500.010266,1,539,631,-92,92,123300,123600,29698,91902,114626
500.010266,2,4522,4529,-7,7,123300,123600,20583,-429683,-427954
500.010266,3,590,654,-64,64,123300,123600,19288,153712,169520
500.010266,4,110,50,60,-60,123300,123600,-2017,-23583,-38403
500.010266,5,2977,2982,-5,5,123300,123600,12142,-249742,-248507
500.010266,6,0,0,0,0,123300,123600,0,0,0
500.239187,0,545,645,-100,100,123700,123600,30201,244199,234199
500.239187,1,539,631,-92,92,123700,123600,29698,91902,82702
500.239187,2,4522,4539,-17,17,123700,123600,20830,-428930,-430630
500.239187,3,590,654,-64,64,123700,123600,19288,153712,147312
500.239187,4,110,50,60,-60,123700,123600,-2017,-23583,-17583
500.239187,5,2987,2982,5,-5,123700,123600,12018,-252618,-252118
500.239187,6,0,0,0,0,123700,123600,0,0,0
500.504391,0,545,645,-100,100,123300,123600,30201,244199,268899
500.504391,1,539,631,-92,92,123300,123600,29698,91902,114626
500.504391,2,4532,4539,-7,7,123300,123600,20706,-430806,-429077
500.504391,3,590,654,-64,64,123300,123600,19288,153712,169520
500.504391,4,110,50,60,-60,123300,123600,-2017,-23583,-38403
500.504391,5,2997,2982,15,-15,123300,123600,11894,-253494,-257199
500.504391,6,0,0,0,0,123300,123600,0,0,0
500.702928,0,545,645,-100,100,123300,123600,30201,244199,268899
500.702928,1,539,631,-92,92,123300,123600,29698,91902,114626
500.702928,2,4532,4539,-7,7,123300,123600,20706,-430806,-429077
500.702928,3,590,654,-64,64,123300,123600,19288,153712,169520
500.702928,4,110,50,60,-60,123300,123600,-2017,-23583,-38403
500.702928,5,2997,2982,15,-15,123300,123600,11894,-253494,-257199
500.702928,6,0,0,0,0,123300,123600,0,0,0
501.032724,0,545,645,-100,100,123300,123600,30201,244199,268899
501.032724,1,539,631,-92,92,123300,123600,29698,91902,114626
501.032724,2,4532,4539,-7,7,123300,123600,20706,-430806,-429077
501.032724,3,590,654,-64,64,123300,123600,19288,153712,169520
501.032724,4,110,50,60,-60,123300,123600,-2017,-23583,-38403
501.032724,5,2997,2982,15,-15,123300,123600,11894,-253494,-257199
501.032724,6,0,0,0,0,123300,123600,0,0,0
501.292212,0,545,645,-100,100,123300,123600,30201,244199,268899
501.292212,1,539,631,-92,92,123300,123600,29698,91902,114626
501.292212,2,4532,4539,-7,7,123300,123600,20706,-430806,-429077
501.292212,3,590,654,-64,64,123300,123600,19288,153712,169520
501.292212,4,110,50,60,-60,123300,123600,-2017,-23583,-38403
501.292212,5,2997,2982,15,-15,123300,123600,11894,-253494,-257199
501.292212,6,0,0,0,0,123300,123600,0,0,0
501.517312,0,545,645,-100,100,123300,123600,30201,244199,268899
501.517312,1,539,631,-92,92,123300,123600,29698,91902,114626
501.517312,2,4532,4539,-7,7,123300,123600,20706,-430806,-429077
501.517312,3,590,654,-64,64,123300,123600,19288,153712,169520
501.517312,4,110,50,60,-60,123300,123600,-2017,-23583,-38403
501.517312,5,2997,2982,15,-15,123300,123600,11894,-253494,-257199
501.517312,6,0,0,0,0,123300,123600,0,0,0
501.740619,0,545,645,-100,100,123300,123600,30201,244199,268899
501.740619,1,539,631,-92,92,123300,123600,29698,91902,114626
501.740619,2,4532,4539,-7,7,123300,123600,20706,-430806,-429077
501.740619,3,590,654,-64,64,123300,123600,19288,153712,169520
501.740619,4,110,50,60,-60,123300,123600,-2017,-23583,-38403
501.740619,5,2997,2982,15,-15,123300,123600,11894,-253494,-257199
501.740619,6,0,0,0,0,123300,123600,0,0,0
502.038908,0,545,645,-100,100,123300,123600,30201,244199,268899
502.038908,1,539,631,-92,92,123300,123600,29698,91902,114626
502.038908,2,4532,4539,-7,7,123300,123600,20706,-430806,-429077
502.038908,3,590,654,-64,64,123300,123600,19288,153712,169520
502.038908,4,110,50,60,-60,123300,123600,-2017,-23583,-38403
502.038908,5,2997,2982,15,-15,123300,123600,11894,-253494,-257199
502.038908,6,0,0,0,0,123300,123600,0,0,0
502.236023,0,545,645,-100,100,123300,123600,30201,244199,268899
502.236023,1,539,631,-92,92,123300,123600,29698,91902,114626
502.236023,2,4532,4539,-7,7,123300,123600,20706,-430806,-429077
502.236023,3,590,654,-64,64,123300,123600,19288,153712,169520
502.236023,4,110,50,60,-60,123300,123600,-2017,-23583,-38403
502.236023,5,2997,2982,15,-15,123300,123600,11894,-253494,-257199
502.236023,6,0,0,0,0,123300,123600,0,0,0
502.468618,0,545,645,-100,100,123500,123600,30201,244199,254199
502.468618,1,539,631,-92,92,123500,123600,29698,91902,101102
502.468618,2,4536,4539,-3,3,123500,123600,20805,-431305,-431005
502.468618,3,596,654,-58,58,123500,123600,19436,152964,158764
502.468618,4,110,50,60,-60,123500,123600,-2017,-23583,-29583
502.468618,5,2997,2992,5,-5,123500,123600,11771,-253371,-253871
502.468618,6,0,0,0,0,123500,123600,0,0,0
502.720891,0,545,645,-100,100,123600,123600,30201,244199,244199
502.720891,1,539,631,-92,92,123600,123600,29698,91902,91902
502.720891,2,4536,4539,-3,3,123600,123600,20805,-431305,-431305
502.720891,3,596,654,-58,58,123600,123600,19436,152964,152964
502.720891,4,110,50,60,-60,123600,123600,-2017,-23583,-23583
502.720891,5,2997,2992,5,-5,123600,123600,11771,-253371,-253371
502.720891,6,0,0,0,0,123600,123600,0,0,0
502.995458,0,545,645,-100,100,123600,123400,30201,244199,224199
502.995458,1,539,631,-92,92,123600,123400,29698,91902,73502
502.995458,2,4536,4539,-3,3,123600,123400,20805,-431305,-431905
502.995458,3,596,654,-58,58,123600,123400,19436,152964,141364
502.995458,4,110,50,60,-60,123600,123400,-2017,-23583,-11583
502.995458,5,2997,2992,5,-5,123600,123400,11771,-253371,-252371
502.995458,6,0,0,0,0,123600,123400,0,0,0
503.210291,0,545,645,-100,100,123400,123400,30201,244199,244199
503.210291,1,539,631,-92,92,123400,123400,29698,91902,91902
503.210291,2,4546,4539,7,-7,123400,123400,20830,-432930,-432930
503.210291,3,596,654,-58,58,123400,123400,19436,152964,152964
503.210291,4,110,50,60,-60,123400,123400,-2017,-23583,-23583
503.210291,5,2997,3002,-5,5,123400,123400,11870,-253870,-253870
503.210291,6,0,0,0,0,123400,123400,0,0,0
503.513729,0,545,645,-100,100,123700,123400,30201,244199,219499
503.513729,1,539,631,-92,92,123700,123400,29698,91902,69178
503.513729,2,4546,4549,-3,3,123700,123400,21077,-432177,-432918
503.513729,3,596,655,-59,59,123700,123400,19424,153176,138603
503.513729,4,110,50,60,-60,123700,123400,-2017,-23583,-8763
503.513729,5,3007,3002,5,-5,123700,123400,11746,-255746,-254511
503.513729,6,0,0,0,0,123700,123400,0,0,0
503.789223,0,545,645,-100,100,123400,123500,30201,244199,254199
503.789223,1,539,631,-92,92,123400,123500,29698,91902,101102
503.789223,2,4556,4559,-3,3,123400,123500,21201,-431301,-431001
503.789223,3,596,656,-60,60,123400,123500,19412,153388,159388
503.789223,4,110,50,60,-60,123400,123500,-2017,-23583,-29583
503.789223,5,3016,3002,14,-14,123400,123500,11635,-255635,-257035
503.789223,6,0,0,0,0,123400,123500,0,0,0
504.0024,0,545,645,-100,100,123400,123500,30201,244199,254199
504.0024,1,539,631,-92,92,123400,123500,29698,91902,101102
504.0024,2,4556,4559,-3,3,123400,123500,21201,-431301,-431001
504.0024,3,596,656,-60,60,123400,123500,19412,153388,159388
504.0024,4,110,50,60,-60,123400,123500,-2017,-23583,-29583
504.0024,5,3016,3002,14,-14,123400,123500,11635,-255635,-257035
504.0024,6,0,0,0,0,123400,123500,0,0,0
504.28623,0,545,645,-100,100,123400,123500,30201,244199,254199
504.28623,1,539,631,-92,92,123400,123500,29698,91902,101102
504.28623,2,4556,4559,-3,3,123400,123500,21201,-431301,-431001
504.28623,3,596,656,-60,60,123400,123500,19412,153388,159388
504.28623,4,110,50,60,-60,123400,123500,-2017,-23583,-29583
504.28623,5,3016,3002,14,-14,123400,123500,11635,-255635,-257035
504.28623,6,0,0,0,0,123400,123500,0,0,0
504.4659,0,545,645,-100,100,123700,123500,30201,244199,224199
504.4659,1,539,631,-92,92,123700,123500,29698,91902,73502
504.4659,2,4566,4564,2,-2,123700,123500,21015,-431615,-431215
504.4659,3,601,656,-55,55,123700,123500,19536,152264,141264
504.4659,4,110,50,60,-60,123700,123500,-2017,-23583,-11583
504.4659,5,3016,3012,4,-4,123700,123500,11882,-255882,-255082
504.4659,6,0,0,0,0,123700,123500,0,0,0
504.742437,0,545,645,-100,100,123700,123500,30201,244199,224199
504.742437,1,539,631,-92,92,123700,123500,29698,91902,73502
504.742437,2,4566,4564,2,-2,123700,123500,21015,-431615,-431215
504.742437,3,601,656,-55,55,123700,123500,19536,152264,141264
504.742437,4,110,50,60,-60,123700,123500,-2017,-23583,-11583
504.742437,5,3016,3012,4,-4,123700,123500,11882,-255882,-255082
504.742437,6,0,0,0,0,123700,123500,0,0,0
505.024875,0,545,645,-100,100,123700,123500,30201,244199,224199
505.024875,1,539,631,-92,92,123700,123500,29698,91902,73502
505.024875,2,4566,4564,2,-2,123700,123500,21015,-431615,-431215
505.024875,3,601,656,-55,55,123700,123500,19536,152264,141264
505.024875,4,110,50,60,-60,123700,123500,-2017,-23583,-11583
505.024875,5,3016,3012,4,-4,123700,123500,11882,-255882,-255082
505.024875,6,0,0,0,0,123700,123500,0,0,0
505.295522,0,545,645,-100,100,123700,123500,30201,244199,224199
505.295522,1,539,631,-92,92,123700,123500,29698,91902,73502
505.295522,2,4566,4564,2,-2,123700,123500,21015,-431615,-431215
505.295522,3,601,656,-55,55,123700,123500,19536,152264,141264
505.295522,4,110,50,60,-60,123700,123500,-2017,-23583,-11583
505.295522,5,3016,3012,4,-4,123700,123500,11882,-255882,-255082
505.295522,6,0,0,0,0,123700,123500,0,0,0
505.518661,0,545,645,-100,100,124000,123500,30201,244199,219499
505.518661,1,539,631,-92,92,124000,123500,29698,91902,69178
505.518661,2,4566,4574,-8,8,124000,123500,20891,-431491,-433467
505.518661,3,601,658,-57,57,124000,123500,19511,152889,138810
505.518661,4,110,50,60,-60,124000,123500,-2017,-23583,-8763
505.518661,5,3016,3012,4,-4,124000,123500,11882,-255882,-254894
505.518661,6,0,0,0,0,124000,123500,0,0,0
505.797104,0,545,645,-100,100,124000,123500,30201,244199,219499
505.797104,1,539,631,-92,92,124000,123500,29698,91902,69178
505.797104,2,4566,4574,-8,8,124000,123500,20891,-431491,-433467
505.797104,3,601,658,-57,57,124000,123500,19511,152889,138810
505.797104,4,110,50,60,-60,124000,123500,-2017,-23583,-8763
505.797104,5,3016,3012,4,-4,124000,123500,11882,-255882,-254894
505.797104,6,0,0,0,0,124000,123500,0,0,0
506.014437,0,545,645,-100,100,124000,123500,30201,244199,219499
506.014437,1,539,631,-92,92,124000,123500,29698,91902,69178
506.014437,2,4566,4574,-8,8,124000,123500,20891,-431491,-433467
506.014437,3,601,658,-57,57,124000,123500,19511,152889,138810
506.014437,4,110,50,60,-60,124000,123500,-2017,-23583,-8763
506.014437,5,3016,3012,4,-4,124000,123500,11882,-255882,-254894
506.014437,6,0,0,0,0,124000,123500,0,0,0
506.206626,0,545,645,-100,100,124000,123500,30201,244199,219499
506.206626,1,539,631,-92,92,124000,123500,29698,91902,69178
506.206626,2,4566,4574,-8,8,124000,123500,20891,-431491,-433467
506.206626,3,601,658,-57,57,124000,123500,19511,152889,138810
506.206626,4,110,50,60,-60,124000,123500,-2017,-23583,-8763
506.206626,5,3016,3012,4,-4,124000,123500,11882,-255882,-254894
506.206626,6,0,0,0,0,124000,123500,0,0,0
506.48593,0,545,645,-100,100,124000,123500,30201,244199,219499
506.48593,1,539,631,-92,92,124000,123500,29698,91902,69178
506.48593,2,4566,4574,-8,8,124000,123500,20891,-431491,-433467
506.48593,3,601,658,-57,57,124000,123500,19511,152889,138810
506.48593,4,110,50,60,-60,124000,123500,-2017,-23583,-8763
506.48593,5,3016,3012,4,-4,124000,123500,11882,-255882,-254894
506.48593,6,0,0,0,0,124000,123500,0,0,0
506.72827,0,545,645,-100,100,123700,123500,30201,244199,224199
506.72827,1,539,631,-92,92,123700,123500,29698,91902,73502
506.72827,2,4566,4574,-8,8,123700,123500,20891,-431491,-433091
506.72827,3,601,658,-57,57,123700,123500,19511,152889,141489
506.72827,4,110,50,60,-60,123700,123500,-2017,-23583,-11583
506.72827,5,3016,3021,-5,5,123700,123500,11771,-253971,-254971
506.72827,6,0,0,0,0,123700,123500,0,0,0
507.02567,0,545,645,-100,100,123500,123500,30201,244199,244199
507.02567,1,539,631,-92,92,123500,123500,29698,91902,91902
507.02567,2,4576,4584,-8,8,123500,123500,20643,-431243,-431243
507.02567,3,601,658,-57,57,123500,123500,19511,152889,152889
507.02567,4,110,50,60,-60,123500,123500,-2017,-23583,-23583
507.02567,5,3026,3031,-5,5,123500,123500,12265,-256465,-256465
507.02567,6,0,0,0,0,123500,123500,0,0,0
507.244128,0,545,645,-100,100,123600,123500,30201,244199,234199
507.244128,1,539,631,-92,92,123600,123500,29698,91902,82702
507.244128,2,4576,4594,-18,18,123600,123500,20890,-430490,-432290
507.244128,3,601,658,-57,57,123600,123500,19511,152889,147189
507.244128,4,110,50,60,-60,123600,123500,-2017,-23583,-17583
507.244128,5,3036,3031,5,-5,123600,123500,12141,-258341,-257841
507.244128,6,0,0,0,0,123600,123500,0,0,0
507.451405,0,545,645,-100,100,123600,123500,30201,244199,234199
507.451405,1,539,631,-92,92,123600,123500,29698,91902,82702
507.451405,2,4576,4594,-18,18,123600,123500,20890,-430490,-432290
507.451405,3,601,658,-57,57,123600,123500,19511,152889,147189
507.451405,4,110,50,60,-60,123600,123500,-2017,-23583,-17583
507.451405,5,3036,3031,5,-5,123600,123500,12141,-258341,-257841
507.451405,6,0,0,0,0,123600,123500,0,0,0
507.799152,0,545,645,-100,100,123700,123500,30201,244199,224199
507.799152,1,539,631,-92,92,123700,123500,29698,91902,73502
507.799152,2,4586,4594,-8,8,123700,123500,21137,-432737,-434337
507.799152,3,601,658,-57,57,123700,123500,19511,152889,141489
507.799152,4,110,50,60,-60,123700,123500,-2017,-23583,-11583
507.799152,5,3036,3041,-5,5,123700,123500,12017,-258217,-259217
507.799152,6,0,0,0,0,123700,123500,0,0,0
507.96888,0,545,645,-100,100,123700,123500,30201,244199,224199
507.96888,1,539,631,-92,92,123700,123500,29698,91902,73502
507.96888,2,4586,4594,-8,8,123700,123500,21137,-432737,-434337
507.96888,3,601,658,-57,57,123700,123500,19511,152889,141489
507.96888,4,110,50,60,-60,123700,123500,-2017,-23583,-11583
507.96888,5,3036,3041,-5,5,123700,123500,12017,-258217,-259217
507.96888,6,0,0,0,0,123700,123500,0,0,0
508.279084,0,545,645,-100,100,123700,123500,30201,244199,224199
508.279084,1,539,631,-92,92,123700,123500,29698,91902,73502
508.279084,2,4586,4594,-8,8,123700,123500,21137,-432737,-434337
508.279084,3,601,658,-57,57,123700,123500,19511,152889,141489
508.279084,4,110,50,60,-60,123700,123500,-2017,-23583,-11583
508.279084,5,3036,3041,-5,5,123700,123500,12017,-258217,-259217
508.279084,6,0,0,0,0,123700,123500,0,0,0
508.488273,0,545,645,-100,100,123700,123500,30201,244199,224199
508.488273,1,539,631,-92,92,123700,123500,29698,91902,73502
508.488273,2,4586,4594,-8,8,123700,123500,21137,-432737,-434337
508.488273,3,601,658,-57,57,123700,123500,19511,152889,141489
508.488273,4,110,50,60,-60,123700,123500,-2017,-23583,-11583
508.488273,5,3036,3041,-5,5,123700,123500,12017,-258217,-259217
508.488273,6,0,0,0,0,123700,123500,0,0,0
508.771098,0,545,645,-100,100,123700,123500,30201,244199,224199
508.771098,1,539,631,-92,92,123700,123500,29698,91902,73502
508.771098,2,4586,4594,-8,8,123700,123500,21137,-432737,-434337
508.771098,3,601,658,-57,57,123700,123500,19511,152889,141489
508.771098,4,110,50,60,-60,123700,123500,-2017,-23583,-11583
508.771098,5,3036,3041,-5,5,123700,123500,12017,-258217,-259217
508.771098,6,0,0,0,0,123700,123500,0,0,0
508.994277,0,545,645,-100,100,123600,123500,30201,244199,234199
508.994277,1,539,631,-92,92,123600,123500,29698,91902,82702
508.994277,2,4586,4598,-12,12,123600,123500,21088,-432288,-433488
508.994277,3,601,658,-57,57,123600,123500,19511,152889,147189
508.994277,4,110,50,60,-60,123600,123500,-2017,-23583,-17583
508.994277,5,3036,3041,-5,5,123600,123500,12017,-258217,-258717
508.994277,6,0,0,0,0,123600,123500,0,0,0
509.260218,0,545,645,-100,100,123600,123400,30201,244199,224199
509.260218,1,539,631,-92,92,123600,123400,29698,91902,73502
509.260218,2,4586,4598,-12,12,123600,123400,21088,-432288,-434688
509.260218,3,601,658,-57,57,123600,123400,19511,152889,141489
509.260218,4,110,50,60,-60,123600,123400,-2017,-23583,-11583
509.260218,5,3036,3041,-5,5,123600,123400,12017,-258217,-259217
509.260218,6,0,0,0,0,123600,123400,0,0,0
509.528034,0,545,645,-100,100,123500,123400,30201,244199,234199
509.528034,1,539,631,-92,92,123500,123400,29698,91902,82702
509.528034,2,4588,4598,-10,10,123500,123400,21063,-432663,-433663
509.528034,3,601,660,-59,59,123500,123400,19560,153040,147140
509.528034,4,110,50,60,-60,123500,123400,-2017,-23583,-17583
509.528034,5,3036,3041,-5,5,123500,123400,12017,-258217,-258717
509.528034,6,0,0,0,0,123500,123400,0,0,0
509.726043,0,545,645,-100,100,123400,123100,30201,244199,219599
509.726043,1,539,631,-92,92,123400,123100,29698,91902,69270
509.726043,2,4598,4608,-10,10,123400,123100,21187,-432787,-435247
509.726043,3,601,660,-59,59,123400,123100,19560,153040,138526
509.726043,4,110,50,60,-60,123400,123100,-2017,-23583,-8823
509.726043,5,3046,3051,-5,5,123400,123100,12140,-260340,-261570
509.726043,6,0,0,0,0,123400,123100,0,0,0
510.01019,0,545,645,-100,100,123300,123100,30201,244199,224199
510.01019,1,539,631,-92,92,123300,123100,29698,91902,73502
510.01019,2,4598,4618,-20,20,123300,123100,21434,-430034,-434034
510.01019,3,601,664,-63,63,123300,123100,19658,154142,141542
510.01019,4,110,50,60,-60,123300,123100,-2017,-23583,-11583
510.01019,5,3046,3061,-15,15,123300,123100,12387,-257587,-260587
510.01019,6,0,0,0,0,123300,123100,0,0,0
510.206973,0,545,645,-100,100,123100,123100,30201,244199,244199
510.206973,1,539,631,-92,92,123100,123100,29698,91902,91902
510.206973,2,4598,4628,-30,30,123100,123100,21680,-426280,-426280
510.206973,3,601,666,-65,65,123100,123100,19707,154893,154893
510.206973,4,110,50,60,-60,123100,123100,-2017,-23583,-23583
510.206973,5,3046,3061,-15,15,123100,123100,12387,-257587,-257587
510.206973,6,0,0,0,0,123100,123100,0,0,0
510.479068,0,545,645,-100,100,123100,123100,30201,244199,244199
510.479068,1,539,631,-92,92,123100,123100,29698,91902,91902
510.479068,2,4598,4638,-40,40,123100,123100,21926,-422526,-422526
510.479068,3,601,668,-67,67,123100,123100,19756,155644,155644
510.479068,4,110,50,60,-60,123100,123100,-2017,-23583,-23583
510.479068,5,3046,3061,-15,15,123100,123100,12387,-257587,-257587
510.479068,6,0,0,0,0,123100,123100,0,0,0
510.797186,0,545,645,-100,100,123100,123100,30201,244199,244199
510.797186,1,539,631,-92,92,123100,123100,29698,91902,91902
510.797186,2,4598,4648,-50,50,123100,123100,22172,-418772,-418772
510.797186,3,601,672,-71,71,123100,123100,19854,157146,157146
510.797186,4,110,50,60,-60,123100,123100,-2017,-23583,-23583
510.797186,5,3046,3061,-15,15,123100,123100,12387,-257587,-257587
510.797186,6,0,0,0,0,123100,123100,0,0,0
511.00326,0,545,645,-100,100,123100,123100,30201,244199,244199
511.00326,1,539,631,-92,92,123100,123100,29698,91902,91902
511.00326,2,4598,4648,-50,50,123100,123100,22172,-418772,-418772
511.00326,3,601,674,-73,73,123100,123100,19903,157897,157897
511.00326,4,110,50,60,-60,123100,123100,-2017,-23583,-23583
511.00326,5,3046,3061,-15,15,123100,123100,12387,-257587,-257587
511.00326,6,0,0,0,0,123100,123100,0,0,0
511.268988,0,545,645,-100,100,123100,123100,30201,244199,244199
511.268988,1,539,631,-92,92,123100,123100,29698,91902,91902
511.268988,2,4598,4648,-50,50,123100,123100,22172,-418772,-418772
511.268988,3,601,678,-77,77,123100,123100,20001,159399,159399
511.268988,4,110,50,60,-60,123100,123100,-2017,-23583,-23583
511.268988,5,3046,3061,-15,15,123100,123100,12387,-257587,-257587
511.268988,6,0,0,0,0,123100,123100,0,0,0
511.472656,0,545,645,-100,100,123100,123100,30201,244199,244199
511.472656,1,539,631,-92,92,123100,123100,29698,91902,91902
511.472656,2,4598,4648,-50,50,123100,123100,22172,-418772,-418772
511.472656,3,601,680,-79,79,123100,123100,20050,160150,160150
511.472656,4,110,50,60,-60,123100,123100,-2017,-23583,-23583
511.472656,5,3046,3061,-15,15,123100,123100,12387,-257587,-257587
511.472656,6,0,0,0,0,123100,123100,0,0,0
511.782822,0,545,645,-100,100,123100,123100,30201,244199,244199
511.782822,1,539,631,-92,92,123100,123100,29698,91902,91902
511.782822,2,4598,4648,-50,50,123100,123100,22172,-418772,-418772
511.782822,3,601,682,-81,81,123100,123100,20099,160901,160901
511.782822,4,110,50,60,-60,123100,123100,-2017,-23583,-23583
511.782822,5,3046,3061,-15,15,123100,123100,12387,-257587,-257587
511.782822,6,0,0,0,0,123100,123100,0,0,0
512.040262,0,545,645,-100,100,123100,123100,30201,244199,244199
512.040262,1,539,631,-92,92,123100,123100,29698,91902,91902
512.040262,2,4598,4648,-50,50,123100,123100,22172,-418772,-418772
512.040262,3,601,684,-83,83,123100,123100,20148,161652,161652
512.040262,4,110,50,60,-60,123100,123100,-2017,-23583,-23583
512.040262,5,3046,3061,-15,15,123100,123100,12387,-257587,-257587
512.040262,6,0,0,0,0,123100,123100,0,0,0
512.248318,0,545,645,-100,100,123200,123100,30201,244199,234199
512.248318,1,539,631,-92,92,123200,123100,29698,91902,82702
512.248318,2,4600,4648,-48,48,123200,123100,22147,-419747,-424547
512.248318,3,601,686,-85,85,123200,123100,20197,162403,153903
512.248318,4,110,50,60,-60,123200,123100,-2017,-23583,-17583
512.248318,5,3046,3061,-15,15,123200,123100,12387,-257587,-259087
512.248318,6,0,0,0,0,123200,123100,0,0,0
512.47946,0,545,645,-100,100,123200,122600,30201,244199,219699
512.47946,1,539,631,-92,92,123200,122600,29698,91902,69362
512.47946,2,4602,4648,-46,46,123200,122600,22122,-420722,-431992
512.47946,3,601,688,-87,87,123200,122600,20246,163154,141839
512.47946,4,110,50,60,-60,123200,122600,-2017,-23583,-8883
512.47946,5,3046,3061,-15,15,123200,122600,12387,-257587,-261262
512.47946,6,0,0,0,0,123200,122600,0,0,0
512.750314,0,545,645,-100,100,122900,122600,30201,244199,219699
512.750314,1,539,631,-92,92,122900,122600,29698,91902,69362
512.750314,2,4608,4658,-50,50,122900,122600,22294,-420694,-432944
512.750314,3,601,690,-89,89,122900,122600,20295,163905,142100
512.750314,4,110,50,60,-60,122900,122600,-2017,-23583,-8883
512.750314,5,3050,3071,-21,21,122900,122600,12584,-256184,-261329
512.750314,6,0,0,0,0,122900,122600,0,0,0
512.962674,0,545,645,-100,100,123000,122600,30201,244199,219699
512.962674,1,539,631,-92,92,123000,122600,29698,91902,69362
512.962674,2,4618,4658,-40,40,123000,122600,22540,-425940,-435740
512.962674,3,601,690,-89,89,123000,122600,20295,163905,142100
512.962674,4,110,50,60,-60,123000,122600,-2017,-23583,-8883
512.962674,5,3050,3071,-21,21,123000,122600,12584,-256184,-261329
512.962674,6,0,0,0,0,123000,122600,0,0,0
513.24823,0,545,645,-100,100,122900,122600,30201,244199,219699
513.24823,1,539,631,-92,92,122900,122600,29698,91902,69362
513.24823,2,4618,4658,-40,40,122900,122600,22540,-425940,-435740
513.24823,3,601,692,-91,91,122900,122600,20344,164456,142161
513.24823,4,110,50,60,-60,122900,122600,-2017,-23583,-8883
513.24823,5,3050,3071,-21,21,122900,122600,12584,-256184,-261329
513.24823,6,0,0,0,0,122900,122600,0,0,0
513.537464,0,545,645,-100,100,122900,122500,30201,244199,219699
513.537464,1,539,631,-92,92,122900,122500,29698,91902,69362
513.537464,2,4618,4658,-40,40,122900,122500,22540,-425940,-435740
513.537464,3,601,692,-91,91,122900,122500,20344,164456,142161
513.537464,4,110,50,60,-60,122900,122500,-2017,-23583,-8883
513.537464,5,3050,3071,-21,21,122900,122500,12584,-256184,-261329
513.537464,6,0,0,0,0,122900,122500,0,0,0
513.774781,0,545,645,-100,100,122900,122500,30201,244199,219699
513.774781,1,539,631,-92,92,122900,122500,29698,91902,69362
513.774781,2,4618,4658,-40,40,122900,122500,22540,-425940,-435740
513.774781,3,601,692,-91,91,122900,122500,20344,164456,142161
513.774781,4,110,50,60,-60,122900,122500,-2017,-23583,-8883
513.774781,5,3050,3071,-21,21,122900,122500,12584,-256184,-261329
513.774781,6,0,0,0,0,122900,122500,0,0,0
513.989914,0,545,645,-100,100,122900,122500,30201,244199,219699
513.989914,1,539,631,-92,92,122900,122500,29698,91902,69362
513.989914,2,4618,4658,-40,40,122900,122500,22540,-425940,-435740
513.989914,3,601,692,-91,91,122900,122500,20344,164456,142161
513.989914,4,110,50,60,-60,122900,122500,-2017,-23583,-8883
513.989914,5,3050,3071,-21,21,122900,122500,12584,-256184,-261329
513.989914,6,0,0,0,0,122900,122500,0,0,0
514.243766,0,545,645,-100,100,123100,122500,30201,244199,219699
514.243766,1,539,631,-92,92,123100,122500,29698,91902,69362
514.243766,2,4628,4658,-30,30,123100,122500,22786,-430186,-437536
514.243766,3,601,692,-91,91,123100,122500,20344,164456,142161
514.243766,4,110,50,60,-60,123100,122500,-2017,-23583,-8883
514.243766,5,3050,3081,-31,31,123100,122500,12461,-253061,-260656
514.243766,6,0,0,0,0,123100,122500,0,0,0
514.494823,0,545,645,-100,100,123100,122800,30201,244199,219599
514.494823,1,539,631,-92,92,123100,122800,29698,91902,69270
514.494823,2,4628,4658,-30,30,123100,122800,22786,-430186,-437566
514.494823,3,601,692,-91,91,123100,122800,20344,164456,142070
514.494823,4,110,50,60,-60,123100,122800,-2017,-23583,-8823
514.494823,5,3050,3081,-31,31,123100,122800,12461,-253061,-260687
514.494823,6,0,0,0,0,123100,122800,0,0,0
514.790006,0,545,645,-100,100,123100,122800,30201,244199,219599
514.790006,1,539,631,-92,92,123100,122800,29698,91902,69270
514.790006,2,4628,4668,-40,40,123100,122800,22663,-429063,-438903
514.790006,3,601,692,-91,91,123100,122800,20344,164456,142070
514.790006,4,110,50,60,-60,123100,122800,-2017,-23583,-8823
514.790006,5,3060,3081,-21,21,123100,122800,12707,-256307,-261473
514.790006,6,0,0,0,0,123100,122800,0,0,0
514.97212,0,545,645,-100,100,123200,122800,30201,244199,219599
514.97212,1,539,631,-92,92,123200,122800,29698,91902,69270
514.97212,2,4630,4668,-38,38,123200,122800,22638,-429838,-439186
514.97212,3,601,694,-93,93,123200,122800,20393,164807,141929
514.97212,4,110,50,60,-60,123200,122800,-2017,-23583,-8823
514.97212,5,3060,3081,-21,21,123200,122800,12707,-256307,-261473
514.97212,6,0,0,0,0,123200,122800,0,0,0
515.280154,0,545,645,-100,100,123200,122800,30201,244199,219599
515.280154,1,539,631,-92,92,123200,122800,29698,91902,69270
515.280154,2,4630,4668,-38,38,123200,122800,22638,-429838,-439186
515.280154,3,601,694,-93,93,123200,122800,20393,164807,141929
515.280154,4,110,50,60,-60,123200,122800,-2017,-23583,-8823
515.280154,5,3060,3081,-21,21,123200,122800,12707,-256307,-261473
515.280154,6,0,0,0,0,123200,122800,0,0,0
515.486027,0,545,645,-100,100,123200,122800,30201,244199,219599
515.486027,1,539,631,-92,92,123200,122800,29698,91902,69270
515.486027,2,4630,4668,-38,38,123200,122800,22638,-429838,-439186
515.486027,3,601,694,-93,93,123200,122800,20393,164807,141929
515.486027,4,110,50,60,-60,123200,122800,-2017,-23583,-8823
515.486027,5,3060,3081,-21,21,123200,122800,12707,-256307,-261473
515.486027,6,0,0,0,0,123200,122800,0,0,0
515.769716,0,545,645,-100,100,123200,122800,30201,244199,219599
515.769716,1,539,631,-92,92,123200,122800,29698,91902,69270
515.769716,2,4630,4668,-38,38,123200,122800,22638,-429838,-439186
515.769716,3,601,694,-93,93,123200,122800,20393,164807,141929
515.769716,4,110,50,60,-60,123200,122800,-2017,-23583,-8823
515.769716,5,3060,3081,-21,21,123200,122800,12707,-256307,-261473
515.769716,6,0,0,0,0,123200,122800,0,0,0
515.989736,0,545,645,-100,100,123200,122800,30201,244199,219599
515.989736,1,539,631,-92,92,123200,122800,29698,91902,69270
515.989736,2,4630,4668,-38,38,123200,122800,22638,-429838,-439186
515.989736,3,601,694,-93,93,123200,122800,20393,164807,141929
515.989736,4,110,50,60,-60,123200,122800,-2017,-23583,-8823
515.989736,5,3060,3081,-21,21,123200,122800,12707,-256307,-261473
515.989736,6,0,0,0,0,123200,122800,0,0,0
516.229637,0,545,645,-100,100,123200,122800,30201,244199,219599
516.229637,1,539,631,-92,92,123200,122800,29698,91902,69270
516.229637,2,4630,4668,-38,38,123200,122800,22638,-429838,-439186
516.229637,3,601,694,-93,93,123200,122800,20393,164807,141929
516.229637,4,110,50,60,-60,123200,122800,-2017,-23583,-8823
516.229637,5,3060,3081,-21,21,123200,122800,12707,-256307,-261473
516.229637,6,0,0,0,0,123200,122800,0,0,0
516.533657,0,545,645,-100,100,123200,122800,30201,244199,219599
516.533657,1,539,631,-92,92,123200,122800,29698,91902,69270
516.533657,2,4630,4668,-38,38,123200,122800,22638,-429838,-439186
516.533657,3,601,694,-93,93,123200,122800,20393,164807,141929
516.533657,4,110,50,60,-60,123200,122800,-2017,-23583,-8823
516.533657,5,3060,3081,-21,21,123200,122800,12707,-256307,-261473
516.533657,6,0,0,0,0,123200,122800,0,0,0
516.79536,0,545,645,-100,100,123200,122800,30201,244199,219599
516.79536,1,539,631,-92,92,123200,122800,29698,91902,69270
516.79536,2,4630,4668,-38,38,123200,122800,22638,-429838,-439186
516.79536,3,601,694,-93,93,123200,122800,20393,164807,141929
516.79536,4,110,50,60,-60,123200,122800,-2017,-23583,-8823
516.79536,5,3060,3081,-21,21,123200,122800,12707,-256307,-261473
516.79536,6,0,0,0,0,123200,122800,0,0,0
516.95726,0,545,645,-100,100,123200,122800,30201,244199,219599
516.95726,1,539,631,-92,92,123200,122800,29698,91902,69270
516.95726,2,4630,4668,-38,38,123200,122800,22638,-429838,-439186
516.95726,3,601,694,-93,93,123200,122800,20393,164807,141929
516.95726,4,110,50,60,-60,123200,122800,-2017,-23583,-8823
516.95726,5,3060,3081,-21,21,123200,122800,12707,-256307,-261473
516.95726,6,0,0,0,0,123200,122800,0,0,0
517.23563,0,545,645,-100,100,123200,123000,30201,244199,224199
517.23563,1,539,631,-92,92,123200,123000,29698,91902,73502
517.23563,2,4630,4668,-38,38,123200,123000,22638,-429838,-437438
517.23563,3,601,694,-93,93,123200,123000,20393,164807,146207
517.23563,4,110,50,60,-60,123200,123000,-2017,-23583,-11583
517.23563,5,3060,3081,-21,21,123200,123000,12707,-256307,-260507
517.23563,6,0,0,0,0,123200,123000,0,0,0
517.453881,0,545,645,-100,100,123200,123000,30201,244199,224199
517.453881,1,539,631,-92,92,123200,123000,29698,91902,73502
517.453881,2,4630,4668,-38,38,123200,123000,22638,-429838,-437438
517.453881,3,601,694,-93,93,123200,123000,20393,164807,146207
517.453881,4,110,50,60,-60,123200,123000,-2017,-23583,-11583
517.453881,5,3060,3081,-21,21,123200,123000,12707,-256307,-260507
517.453881,6,0,0,0,0,123200,123000,0,0,0
517.711593,0,545,645,-100,100,123200,123000,30201,244199,224199
517.711593,1,539,631,-92,92,123200,123000,29698,91902,73502
517.711593,2,4640,4668,-28,28,123200,123000,22885,-433085,-438685
517.711593,3,601,694,-93,93,123200,123000,20393,164807,146207
517.711593,4,110,50,60,-60,123200,123000,-2017,-23583,-11583
517.711593,5,3070,3091,-21,21,123200,123000,12461,-256061,-260261
517.711593,6,0,0,0,0,123200,123000,0,0,0
518.018771,0,545,645,-100,100,123200,123000,30201,244199,224199
518.018771,1,539,631,-92,92,123200,123000,29698,91902,73502
518.018771,2,4646,4668,-22,22,123200,123000,23033,-434433,-438833
518.018771,3,601,694,-93,93,123200,123000,20393,164807,146207
518.018771,4,110,50,60,-60,123200,123000,-2017,-23583,-11583
518.018771,5,3070,3091,-21,21,123200,123000,12461,-256061,-260261
518.018771,6,0,0,0,0,123200,123000,0,0,0
518.226722,0,545,645,-100,100,123300,123000,30201,244199,219599
518.226722,1,539,631,-92,92,123300,123000,29698,91902,69270
518.226722,2,4650,4678,-28,28,123300,123000,22861,-432461,-439349
518.226722,3,601,694,-93,93,123300,123000,20393,164807,141929
518.226722,4,110,50,60,-60,123300,123000,-2017,-23583,-8823
518.226722,5,3080,3095,-15,15,123300,123000,12807,-259607,-263297
518.226722,6,0,0,0,0,123300,123000,0,0,0
518.461446,0,545,645,-100,100,123300,123000,30201,244199,219599
518.461446,1,539,631,-92,92,123300,123000,29698,91902,69270
518.461446,2,4650,4678,-28,28,123300,123000,22861,-432461,-439349
518.461446,3,601,694,-93,93,123300,123000,20393,164807,141929
518.461446,4,110,50,60,-60,123300,123000,-2017,-23583,-8823
518.461446,5,3080,3095,-15,15,123300,123000,12807,-259607,-263297
518.461446,6,0,0,0,0,123300,123000,0,0,0
518.748037,0,545,645,-100,100,123300,123100,30201,244199,224199
518.748037,1,539,631,-92,92,123300,123100,29698,91902,73502
518.748037,2,4650,4678,-28,28,123300,123100,22861,-432461,-438061
518.748037,3,601,694,-93,93,123300,123100,20393,164807,146207
518.748037,4,110,50,60,-60,123300,123100,-2017,-23583,-11583
518.748037,5,3080,3095,-15,15,123300,123100,12807,-259607,-262607
518.748037,6,0,0,0,0,123300,123100,0,0,0
518.961196,0,545,645,-100,100,123300,123100,30201,244199,224199
518.961196,1,539,631,-92,92,123300,123100,29698,91902,73502
518.961196,2,4650,4678,-28,28,123300,123100,22861,-432461,-438061
518.961196,3,601,694,-93,93,123300,123100,20393,164807,146207
518.961196,4,110,50,60,-60,123300,123100,-2017,-23583,-11583
518.961196,5,3080,3095,-15,15,123300,123100,12807,-259607,-262607
518.961196,6,0,0,0,0,123300,123100,0,0,0
519.267012,0,545,645,-100,100,123300,123100,30201,244199,224199
519.267012,1,539,631,-92,92,123300,123100,29698,91902,73502
519.267012,2,4650,4678,-28,28,123300,123100,22861,-432461,-438061
519.267012,3,601,694,-93,93,123300,123100,20393,164807,146207
519.267012,4,110,50,60,-60,123300,123100,-2017,-23583,-11583
519.267012,5,3080,3095,-15,15,123300,123100,12807,-259607,-262607
519.267012,6,0,0,0,0,123300,123100,0,0,0
519.481324,0,545,645,-100,100,123300,123100,30201,244199,224199
519.481324,1,539,631,-92,92,123300,123100,29698,91902,73502
519.481324,2,4650,4678,-28,28,123300,123100,22861,-432461,-438061
519.481324,3,601,694,-93,93,123300,123100,20393,164807,146207
519.481324,4,110,50,60,-60,123300,123100,-2017,-23583,-11583
519.481324,5,3080,3095,-15,15,123300,123100,12807,-259607,-262607
519.481324,6,0,0,0,0,123300,123100,0,0,0
519.722398,0,545,645,-100,100,122900,123100,30201,244199,264199
519.722398,1,539,631,-92,92,122900,123100,29698,91902,110302
519.722398,2,4660,4678,-18,18,122900,123100,22738,-434338,-430738
519.722398,3,601,694,-93,93,122900,123100,20393,164807,183407
519.722398,4,110,50,60,-60,122900,123100,-2017,-23583,-35583
519.722398,5,3090,3095,-5,5,122900,123100,12684,-261484,-260484
519.722398,6,0,0,0,0,122900,123100,0,0,0
519.955132,0,545,645,-100,100,122900,122900,30201,244199,244199
519.955132,1,539,631,-92,92,122900,122900,29698,91902,91902
519.955132,2,4670,4678,-8,8,122900,122900,22615,-436215,-436215
519.955132,3,601,694,-93,93,122900,122900,20393,164807,164807
519.955132,4,110,50,60,-60,122900,122900,-2017,-23583,-23583
519.955132,5,3090,3095,-5,5,122900,122900,12684,-261484,-261484
519.955132,6,0,0,0,0,122900,122900,0,0,0
520.204122,0,545,645,-100,100,122900,122900,30201,244199,244199
520.204122,1,539,631,-92,92,122900,122900,29698,91902,91902
520.204122,2,4670,4678,-8,8,122900,122900,22615,-436215,-436215
520.204122,3,601,694,-93,93,122900,122900,20393,164807,164807
520.204122,4,110,50,60,-60,122900,122900,-2017,-23583,-23583
520.204122,5,3090,3095,-5,5,122900,122900,12684,-261484,-261484
520.204122,6,0,0,0,0,122900,122900,0,0,0
520.462397,0,545,645,-100,100,122900,122900,30201,244199,244199
520.462397,1,539,631,-92,92,122900,122900,29698,91902,91902
520.462397,2,4670,4678,-8,8,122900,122900,22615,-436215,-436215
520.462397,3,601,694,-93,93,122900,122900,20393,164807,164807
520.462397,4,110,50,60,-60,122900,122900,-2017,-23583,-23583
520.462397,5,3090,3095,-5,5,122900,122900,12684,-261484,-261484
520.462397,6,0,0,0,0,122900,122900,0,0,0
520.753059,0,545,645,-100,100,123000,122900,30201,244199,234199
520.753059,1,539,631,-92,92,123000,122900,29698,91902,82702
520.753059,2,4670,4688,-18,18,123000,122900,22861,-435461,-437261
520.753059,3,601,694,-93,93,123000,122900,20393,164807,155507
520.753059,4,110,50,60,-60,123000,122900,-2017,-23583,-17583
520.753059,5,3100,3095,5,-5,123000,122900,12561,-264361,-263861
520.753059,6,0,0,0,0,123000,122900,0,0,0
520.964024,0,545,645,-100,100,123000,122900,30201,244199,234199
520.964024,1,539,631,-92,92,123000,122900,29698,91902,82702
520.964024,2,4670,4688,-18,18,123000,122900,22861,-435461,-437261
520.964024,3,601,694,-93,93,123000,122900,20393,164807,155507
520.964024,4,110,50,60,-60,123000,122900,-2017,-23583,-17583
520.964024,5,3100,3095,5,-5,123000,122900,12561,-264361,-263861
520.964024,6,0,0,0,0,123000,122900,0,0,0
521.232255,0,545,645,-100,100,123000,122900,30201,244199,234199
521.232255,1,539,631,-92,92,123000,122900,29698,91902,82702
521.232255,2,4670,4688,-18,18,123000,122900,22861,-435461,-437261
521.232255,3,601,694,-93,93,123000,122900,20393,164807,155507
521.232255,4,110,50,60,-60,123000,122900,-2017,-23583,-17583
521.232255,5,3100,3095,5,-5,123000,122900,12561,-264361,-263861
521.232255,6,0,0,0,0,123000,122900,0,0,0
521.465626,0,545,645,-100,100,123000,122900,30201,244199,234199
521.465626,1,539,631,-92,92,123000,122900,29698,91902,82702
521.465626,2,4670,4688,-18,18,123000,122900,22861,-435461,-437261
521.465626,3,601,694,-93,93,123000,122900,20393,164807,155507
521.465626,4,110,50,60,-60,123000,122900,-2017,-23583,-17583
521.465626,5,3100,3095,5,-5,123000,122900,12561,-264361,-263861
521.465626,6,0,0,0,0,123000,122900,0,0,0
521.731705,0,545,645,-100,100,122800,122900,30201,244199,254199
521.731705,1,539,631,-92,92,122800,122900,29698,91902,101102
521.731705,2,4680,4698,-18,18,122800,122900,22615,-433215,-431415
521.731705,3,601,694,-93,93,122800,122900,20393,164807,174107
521.731705,4,110,50,60,-60,122800,122900,-2017,-23583,-29583
521.731705,5,3100,3095,5,-5,122800,122900,12561,-264361,-264861
521.731705,6,0,0,0,0,122800,122900,0,0,0
522.002158,0,545,645,-100,100,122800,123000,30201,244199,264199
522.002158,1,539,631,-92,92,122800,123000,29698,91902,110302
522.002158,2,4680,4698,-18,18,122800,123000,22615,-433215,-429615
522.002158,3,601,694,-93,93,122800,123000,20393,164807,183407
522.002158,4,110,50,60,-60,122800,123000,-2017,-23583,-35583
522.002158,5,3100,3095,5,-5,122800,123000,12561,-264361,-265361
522.002158,6,0,0,0,0,122800,123000,0,0,0
522.242576,0,545,645,-100,100,122800,123000,30201,244199,264199
522.242576,1,539,631,-92,92,122800,123000,29698,91902,110302
522.242576,2,4680,4698,-18,18,122800,123000,22615,-433215,-429615
522.242576,3,601,694,-93,93,122800,123000,20393,164807,183407
522.242576,4,110,50,60,-60,122800,123000,-2017,-23583,-35583
522.242576,5,3100,3095,5,-5,122800,123000,12561,-264361,-265361
522.242576,6,0,0,0,0,122800,123000,0,0,0
522.490014,0,545,645,-100,100,123100,123000,30201,244199,234199
522.490014,1,539,631,-92,92,123100,123000,29698,91902,82702
522.490014,2,4690,4698,-8,8,123100,123000,22492,-435092,-435892
522.490014,3,601,694,-93,93,123100,123000,20393,164807,155507
522.490014,4,110,50,60,-60,123100,123000,-2017,-23583,-17583
522.490014,5,3100,3105,-5,5,123100,123000,12807,-263607,-264107
522.490014,6,0,0,0,0,123100,123000,0,0,0
522.771135,0,545,645,-100,100,123100,122800,30201,244199,219599
522.771135,1,539,631,-92,92,123100,122800,29698,91902,69270
522.771135,2,4690,4698,-8,8,123100,122800,22492,-435092,-437060
522.771135,3,601,694,-93,93,123100,122800,20393,164807,141929
522.771135,4,110,50,60,-60,123100,122800,-2017,-23583,-8823
522.771135,5,3100,3105,-5,5,123100,122800,12807,-263607,-264837
522.771135,6,0,0,0,0,123100,122800,0,0,0
522.955379,0,545,645,-100,100,122800,122800,30201,244199,244199
522.955379,1,539,631,-92,92,122800,122800,29698,91902,91902
522.955379,2,4690,4708,-18,18,122800,122800,22738,-434338,-434338
522.955379,3,601,694,-93,93,122800,122800,20393,164807,164807
522.955379,4,110,50,60,-60,122800,122800,-2017,-23583,-23583
522.955379,5,3110,3115,-5,5,122800,122800,12930,-266730,-266730
522.955379,6,0,0,0,0,122800,122800,0,0,0
523.244104,0,545,645,-100,100,123400,122800,30201,244199,219599
523.244104,1,539,631,-92,92,123400,122800,29698,91902,69270
523.244104,2,4690,4718,-28,18,123400,122800,22615,794785,-440103
523.244104,3,601,694,-93,93,123400,122800,20393,164807,141929
523.244104,4,110,50,60,-60,123400,122800,-2017,-23583,-8823
523.244104,5,3110,3115,-5,5,123400,122800,12930,-266730,-267960
523.244104,6,0,0,0,0,123400,122800,0,0,0
523.486334,0,545,645,-100,100,123400,122800,30201,244199,219599
523.486334,1,539,631,-92,92,123400,122800,29698,91902,69270
523.486334,2,4690,4718,-28,28,123400,122800,22615,-434215,-441103
523.486334,3,601,694,-93,93,123400,122800,20393,164807,141929
523.486334,4,110,50,60,-60,123400,122800,-2017,-23583,-8823
523.486334,5,3110,3115,-5,5,123400,122800,12930,-266730,-267960
523.486334,6,0,0,0,0,123400,122800,0,0,0
523.763572,0,545,645,-100,100,123100,122800,30201,244199,219599
523.763572,1,539,631,-92,92,123100,122800,29698,91902,69270
523.763572,2,4700,4718,-18,18,123100,122800,22492,-437092,-441520
523.763572,3,601,694,-93,93,123100,122800,20393,164807,141929
523.763572,4,110,50,60,-60,123100,122800,-2017,-23583,-8823
523.763572,5,3110,3125,-15,15,123100,122800,13176,-264976,-268666
523.763572,6,0,0,0,0,123100,122800,0,0,0
523.983922,0,545,645,-100,100,123100,122800,30201,244199,219599
523.983922,1,539,631,-92,92,123100,122800,29698,91902,69270
523.983922,2,4700,4728,-28,28,123100,122800,22738,-435338,-442226
523.983922,3,601,694,-93,93,123100,122800,20393,164807,141929
523.983922,4,110,50,60,-60,123100,122800,-2017,-23583,-8823
523.983922,5,3120,3125,-5,5,123100,122800,13053,-267853,-269083
523.983922,6,0,0,0,0,123100,122800,0,0,0
524.224338,0,545,645,-100,100,123200,122900,30201,244199,219599
524.224338,1,539,631,-92,92,123200,122900,29698,91902,69270
524.224338,2,4700,4738,-38,38,123200,122900,22984,-433584,-442932
524.224338,3,601,694,-93,93,123200,122900,20393,164807,141929
524.224338,4,110,50,60,-60,123200,122900,-2017,-23583,-8823
524.224338,5,3120,3135,-15,15,123200,122900,13299,-266099,-269789
524.224338,6,0,0,0,0,123200,122900,0,0,0
524.491464,0,545,645,-100,100,123500,122900,30201,244199,219599
524.491464,1,539,631,-92,92,123500,122900,29698,91902,69270
524.491464,2,4710,4748,-38,38,123500,122900,22738,-433338,-442686
524.491464,3,601,694,-93,93,123500,122900,20393,164807,141929
524.491464,4,110,50,60,-60,123500,122900,-2017,-23583,-8823
524.491464,5,3120,3145,-25,25,123500,122900,13546,-263346,-269496
524.491464,6,0,0,0,0,123500,122900,0,0,0
524.794474,0,545,645,-100,100,123500,122900,30201,244199,219599
524.794474,1,539,631,-92,92,123500,122900,29698,91902,69270
524.794474,2,4710,4758,-48,48,123500,122900,22615,-429215,-441023
524.794474,3,601,694,-93,93,123500,122900,20393,164807,141929
524.794474,4,110,50,60,-60,123500,122900,-2017,-23583,-8823
524.794474,5,3120,3155,-35,35,123500,122900,13423,-259223,-267833
524.794474,6,0,0,0,0,123500,122900,0,0,0
524.97717,0,545,645,-100,100,123500,122900,30201,244199,219599
524.97717,1,539,631,-92,92,123500,122900,29698,91902,69270
524.97717,2,4710,4758,-48,48,123500,122900,22615,-429215,-441023
524.97717,3,601,694,-93,93,123500,122900,20393,164807,141929
524.97717,4,110,50,60,-60,123500,122900,-2017,-23583,-8823
524.97717,5,3120,3155,-35,35,123500,122900,13423,-259223,-267833
524.97717,6,0,0,0,0,123500,122900,0,0,0
525.23869,0,545,645,-100,100,123500,122900,30201,244199,219599
525.23869,1,539,631,-92,92,123500,122900,29698,91902,69270
525.23869,2,4710,4758,-48,48,123500,122900,22615,-429215,-441023
525.23869,3,601,694,-93,93,123500,122900,20393,164807,141929
525.23869,4,110,50,60,-60,123500,122900,-2017,-23583,-8823
525.23869,5,3120,3155,-35,35,123500,122900,13423,-259223,-267833
525.23869,6,0,0,0,0,123500,122900,0,0,0
525.45988,0,545,645,-100,100,123500,123000,30201,244199,219599
525.45988,1,539,631,-92,92,123500,123000,29698,91902,69270
525.45988,2,4710,4758,-48,48,123500,123000,22615,-429215,-441023
525.45988,3,601,694,-93,93,123500,123000,20393,164807,141929
525.45988,4,110,50,60,-60,123500,123000,-2017,-23583,-8823
525.45988,5,3120,3155,-35,35,123500,123000,13423,-259223,-267833
525.45988,6,0,0,0,0,123500,123000,0,0,0
525.765424,0,545,645,-100,100,123500,123100,30201,244199,219599
525.765424,1,539,631,-92,92,123500,123100,29698,91902,69270
525.765424,2,4710,4758,-48,48,123500,123100,22615,-429215,-441023
525.765424,3,601,694,-93,93,123500,123100,20393,164807,141929
525.765424,4,110,50,60,-60,123500,123100,-2017,-23583,-8823
525.765424,5,3120,3155,-35,35,123500,123100,13423,-259223,-267833
525.765424,6,0,0,0,0,123500,123100,0,0,0
525.983293,0,545,645,-100,100,123500,123100,30201,244199,219599
525.983293,1,539,631,-92,92,123500,123100,29698,91902,69270
525.983293,2,4720,4758,-38,38,123500,123100,22862,-434462,-443810
525.983293,3,601,694,-93,93,123500,123100,20393,164807,141929
525.983293,4,110,50,60,-60,123500,123100,-2017,-23583,-8823
525.983293,5,3120,3165,-45,45,123500,123100,13299,-255099,-266169
525.983293,6,0,0,0,0,123500,123100,0,0,0
526.290187,0,545,645,-100,100,123500,123100,30201,244199,219599
526.290187,1,539,631,-92,92,123500,123100,29698,91902,69270
526.290187,2,4720,4758,-38,38,123500,123100,22862,-434462,-443810
526.290187,3,601,694,-93,93,123500,123100,20393,164807,141929
526.290187,4,110,50,60,-60,123500,123100,-2017,-23583,-8823
526.290187,5,3120,3165,-45,45,123500,123100,13299,-255099,-266169
526.290187,6,0,0,0,0,123500,123100,0,0,0
526.507745,0,545,645,-100,100,123500,123100,30201,244199,219599
526.507745,1,539,631,-92,92,123500,123100,29698,91902,69270
526.507745,2,4720,4758,-38,38,123500,123100,22862,-434462,-443810
526.507745,3,601,694,-93,93,123500,123100,20393,164807,141929
526.507745,4,110,50,60,-60,123500,123100,-2017,-23583,-8823
526.507745,5,3120,3165,-45,45,123500,123100,13299,-255099,-266169
526.507745,6,0,0,0,0,123500,123100,0,0,0
526.762881,0,545,645,-100,100,122800,123100,30201,244199,268799
526.762881,1,539,631,-92,92,122800,123100,29698,91902,114534
526.762881,2,4730,4758,-28,28,122800,123100,22738,-439338,-432450
526.762881,3,601,694,-93,93,122800,123100,20393,164807,187685
526.762881,4,110,50,60,-60,122800,123100,-2017,-23583,-38343
526.762881,5,3130,3165,-35,35,122800,123100,13175,-259975,-251365
526.762881,6,0,0,0,0,122800,123100,0,0,0
526.984857,0,545,645,-100,100,122800,123100,30201,244199,268799
526.984857,1,539,631,-92,92,122800,123100,29698,91902,114534
526.984857,2,4730,4758,-28,28,122800,123100,22738,-439338,-432450
526.984857,3,601,694,-93,93,122800,123100,20393,164807,187685
526.984857,4,110,50,60,-60,122800,123100,-2017,-23583,-38343
526.984857,5,3130,3165,-35,35,122800,123100,13175,-259975,-251365
526.984857,6,0,0,0,0,122800,123100,0,0,0
527.233638,0,545,645,-100,100,123500,123100,30201,244199,219599
527.233638,1,539,631,-92,92,123500,123100,29698,91902,69270
527.233638,2,4730,4768,-38,38,123500,123100,22614,-436214,-445562
527.233638,3,601,694,-93,93,123500,123100,20393,164807,141929
527.233638,4,110,50,60,-60,123500,123100,-2017,-23583,-8823
527.233638,5,3140,3165,-25,25,123500,123100,13422,-265222,-271372
527.233638,6,0,0,0,0,123500,123100,0,0,0
527.457609,0,545,645,-100,100,123500,123100,30201,244199,219599
527.457609,1,539,631,-92,92,123500,123100,29698,91902,69270
527.457609,2,4730,4768,-38,38,123500,123100,22614,-436214,-445562
527.457609,3,601,694,-93,93,123500,123100,20393,164807,141929
527.457609,4,110,50,60,-60,123500,123100,-2017,-23583,-8823
527.457609,5,3140,3165,-25,25,123500,123100,13422,-265222,-271372
527.457609,6,0,0,0,0,123500,123100,0,0,0
527.75375,0,545,645,-100,100,123500,123100,30201,244199,219599
527.75375,1,539,631,-92,92,123500,123100,29698,91902,69270
527.75375,2,4730,4768,-38,38,123500,123100,22614,-436214,-445562
527.75375,3,601,694,-93,93,123500,123100,20393,164807,141929
527.75375,4,110,50,60,-60,123500,123100,-2017,-23583,-8823
527.75375,5,3140,3165,-25,25,123500,123100,13422,-265222,-271372
527.75375,6,0,0,0,0,123500,123100,0,0,0
528.007589,0,545,645,-100,100,123500,123100,30201,244199,219599
528.007589,1,539,631,-92,92,123500,123100,29698,91902,69270
528.007589,2,4730,4768,-38,38,123500,123100,22614,-436214,-445562
528.007589,3,601,694,-93,93,123500,123100,20393,164807,141929
528.007589,4,110,50,60,-60,123500,123100,-2017,-23583,-8823
528.007589,5,3140,3165,-25,25,123500,123100,13422,-265222,-271372
528.007589,6,0,0,0,0,123500,123100,0,0,0
528.248909,0,545,645,-100,100,123500,123100,30201,244199,219599
528.248909,1,539,631,-92,92,123500,123100,29698,91902,69270
528.248909,2,4730,4768,-38,38,123500,123100,22614,-436214,-445562
528.248909,3,601,694,-93,93,123500,123100,20393,164807,141929
528.248909,4,110,50,60,-60,123500,123100,-2017,-23583,-8823
528.248909,5,3140,3165,-25,25,123500,123100,13422,-265222,-271372
528.248909,6,0,0,0,0,123500,123100,0,0,0
528.47573,0,545,645,-100,100,123500,123100,30201,244199,219599
528.47573,1,539,631,-92,92,123500,123100,29698,91902,69270
528.47573,2,4730,4768,-38,38,123500,123100,22614,-436214,-445562
528.47573,3,601,694,-93,93,123500,123100,20393,164807,141929
528.47573,4,110,50,60,-60,123500,123100,-2017,-23583,-8823
528.47573,5,3140,3165,-25,25,123500,123100,13422,-265222,-271372
528.47573,6,0,0,0,0,123500,123100,0,0,0
528.728877,0,545,645,-100,100,123500,123100,30201,244199,219599
528.728877,1,539,631,-92,92,123500,123100,29698,91902,69270
528.728877,2,4730,4768,-38,38,123500,123100,22614,-436214,-445562
528.728877,3,601,694,-93,93,123500,123100,20393,164807,141929
528.728877,4,110,50,60,-60,123500,123100,-2017,-23583,-8823
528.728877,5,3140,3165,-25,25,123500,123100,13422,-265222,-271372
528.728877,6,0,0,0,0,123500,123100,0,0,0
529.002206,0,545,645,-100,100,123300,123100,30201,244199,224199
529.002206,1,539,631,-92,92,123300,123100,29698,91902,73502
529.002206,2,4738,4768,-30,30,123300,123100,22515,-439315,-445315
529.002206,3,601,694,-93,93,123300,123100,20393,164807,146207
529.002206,4,110,50,60,-60,123300,123100,-2017,-23583,-11583
529.002206,5,3140,3165,-25,25,123300,123100,13422,-265222,-270222
529.002206,6,0,0,0,0,123300,123100,0,0,0
529.249363,0,545,645,-100,100,123300,123100,30201,244199,224199
529.249363,1,539,631,-92,92,123300,123100,29698,91902,73502
529.249363,2,4738,4768,-30,30,123300,123100,22515,-439315,-445315
529.249363,3,601,694,-93,93,123300,123100,20393,164807,146207
529.249363,4,110,50,60,-60,123300,123100,-2017,-23583,-11583
529.249363,5,3140,3165,-25,25,123300,123100,13422,-265222,-270222
529.249363,6,0,0,0,0,123300,123100,0,0,0
529.464194,0,545,645,-100,100,123300,123100,30201,244199,224199
529.464194,1,539,631,-92,92,123300,123100,29698,91902,73502
529.464194,2,4738,4768,-30,30,123300,123100,22515,-439315,-445315
529.464194,3,601,694,-93,93,123300,123100,20393,164807,146207
529.464194,4,110,50,60,-60,123300,123100,-2017,-23583,-11583
529.464194,5,3140,3165,-25,25,123300,123100,13422,-265222,-270222
529.464194,6,0,0,0,0,123300,123100,0,0,0
529.796718,0,545,645,-100,100,123300,123100,30201,244199,224199
529.796718,1,539,631,-92,92,123300,123100,29698,91902,73502
529.796718,2,4738,4768,-30,30,123300,123100,22515,-439315,-445315
529.796718,3,601,694,-93,93,123300,123100,20393,164807,146207
529.796718,4,110,50,60,-60,123300,123100,-2017,-23583,-11583
529.796718,5,3140,3165,-25,25,123300,123100,13422,-265222,-270222
529.796718,6,0,0,0,0,123300,123100,0,0,0
530.040502,0,545,645,-100,100,123300,123100,30201,244199,224199
530.040502,1,539,631,-92,92,123300,123100,29698,91902,73502
530.040502,2,4738,4768,-30,30,123300,123100,22515,-439315,-445315
530.040502,3,601,694,-93,93,123300,123100,20393,164807,146207
530.040502,4,110,50,60,-60,123300,123100,-2017,-23583,-11583
530.040502,5,3140,3165,-25,25,123300,123100,13422,-265222,-270222
530.040502,6,0,0,0,0,123300,123100,0,0,0
530.286019,0,545,645,-100,100,123300,123100,30201,244199,224199
530.286019,1,539,631,-92,92,123300,123100,29698,91902,73502
530.286019,2,4738,4768,-30,30,123300,123100,22515,-439315,-445315
530.286019,3,601,694,-93,93,123300,123100,20393,164807,146207
530.286019,4,110,50,60,-60,123300,123100,-2017,-23583,-11583
530.286019,5,3140,3165,-25,25,123300,123100,13422,-265222,-270222
530.286019,6,0,0,0,0,123300,123100,0,0,0
530.506637,0,545,645,-100,100,123300,123100,30201,244199,224199
530.506637,1,539,631,-92,92,123300,123100,29698,91902,73502
530.506637,2,4738,4768,-30,30,123300,123100,22515,-439315,-445315
530.506637,3,601,694,-93,93,123300,123100,20393,164807,146207
530.506637,4,110,50,60,-60,123300,123100,-2017,-23583,-11583
530.506637,5,3140,3165,-25,25,123300,123100,13422,-265222,-270222
530.506637,6,0,0,0,0,123300,123100,0,0,0
530.73069,0,545,645,-100,100,123300,123100,30201,244199,224199
530.73069,1,539,631,-92,92,123300,123100,29698,91902,73502
530.73069,2,4738,4768,-30,30,123300,123100,22515,-439315,-445315
530.73069,3,601,694,-93,93,123300,123100,20393,164807,146207
530.73069,4,110,50,60,-60,123300,123100,-2017,-23583,-11583
530.73069,5,3140,3165,-25,25,123300,123100,13422,-265222,-270222
530.73069,6,0,0,0,0,123300,123100,0,0,0
530.992208,0,545,645,-100,100,123300,122700,30201,244199,219699
530.992208,1,539,631,-92,92,123300,122700,29698,91902,69362
530.992208,2,4738,4768,-30,30,123300,122700,22515,-439315,-446665
530.992208,3,601,694,-93,93,123300,122700,20393,164807,142022
530.992208,4,110,50,60,-60,123300,122700,-2017,-23583,-8883
530.992208,5,3140,3165,-25,25,123300,122700,13422,-265222,-271347
530.992208,6,0,0,0,0,123300,122700,0,0,0
531.29081,0,545,645,-100,100,123300,122700,30201,244199,219699
531.29081,1,539,631,-92,92,123300,122700,29698,91902,69362
531.29081,2,4738,4768,-30,30,123300,122700,22515,-439315,-446665
531.29081,3,601,694,-93,93,123300,122700,20393,164807,142022
531.29081,4,110,50,60,-60,123300,122700,-2017,-23583,-8883
531.29081,5,3140,3165,-25,25,123300,122700,13422,-265222,-271347
531.29081,6,0,0,0,0,123300,122700,0,0,0
531.459993,0,545,645,-100,100,123300,122700,30201,244199,219699
531.459993,1,539,631,-92,92,123300,122700,29698,91902,69362
531.459993,2,4738,4768,-30,30,123300,122700,22515,-439315,-446665
531.459993,3,601,694,-93,93,123300,122700,20393,164807,142022
531.459993,4,110,50,60,-60,123300,122700,-2017,-23583,-8883
531.459993,5,3140,3165,-25,25,123300,122700,13422,-265222,-271347
531.459993,6,0,0,0,0,123300,122700,0,0,0
531.703914,0,545,645,-100,100,123300,122700,30201,244199,219699
531.703914,1,539,631,-92,92,123300,122700,29698,91902,69362
531.703914,2,4738,4768,-30,30,123300,122700,22515,-439315,-446665
531.703914,3,601,694,-93,93,123300,122700,20393,164807,142022
531.703914,4,110,50,60,-60,123300,122700,-2017,-23583,-8883
531.703914,5,3140,3165,-25,25,123300,122700,13422,-265222,-271347
531.703914,6,0,0,0,0,123300,122700,0,0,0
532.0349,0,545,645,-100,100,123300,122600,30201,244199,219699
532.0349,1,539,631,-92,92,123300,122600,29698,91902,69362
532.0349,2,4738,4768,-30,30,123300,122600,22515,-439315,-446665
532.0349,3,601,694,-93,93,123300,122600,20393,164807,142022
532.0349,4,110,50,60,-60,123300,122600,-2017,-23583,-8883
532.0349,5,3140,3165,-25,25,123300,122600,13422,-265222,-271347
532.0349,6,0,0,0,0,123300,122600,0,0,0
532.238312,0,545,645,-100,100,122900,122600,30201,244199,219699
532.238312,1,539,631,-92,92,122900,122600,29698,91902,69362
532.238312,2,4738,4778,-40,40,122900,122600,22392,-436192,-445992
532.238312,3,601,694,-93,93,122900,122600,20393,164807,142022
532.238312,4,110,50,60,-60,122900,122600,-2017,-23583,-8883
532.238312,5,3150,3165,-15,15,122900,122600,13668,-270468,-274143
532.238312,6,0,0,0,0,122900,122600,0,0,0
532.458593,0,545,645,-100,100,122900,122400,30201,244199,219699
532.458593,1,539,631,-92,92,122900,122400,29698,91902,69362
532.458593,2,4738,4778,-40,40,122900,122400,22392,-436192,-445992
532.458593,3,601,694,-93,93,122900,122400,20393,164807,142022
532.458593,4,110,50,60,-60,122900,122400,-2017,-23583,-8883
532.458593,5,3150,3165,-15,15,122900,122400,13668,-270468,-274143
532.458593,6,0,0,0,0,122900,122400,0,0,0
532.741132,0,545,645,-100,100,122800,122400,30201,244199,219699
532.741132,1,539,631,-92,92,122800,122400,29698,91902,69362
532.741132,2,4738,4788,-50,50,122800,122400,22638,-432438,-444688
532.741132,3,601,694,-93,93,122800,122400,20393,164807,142022
532.741132,4,110,50,60,-60,122800,122400,-2017,-23583,-8883
532.741132,5,3150,3175,-25,25,122800,122400,13914,-266714,-272839
532.741132,6,0,0,0,0,122800,122400,0,0,0
532.97223,0,545,645,-100,100,122800,122400,30201,244199,219699
532.97223,1,539,631,-92,92,122800,122400,29698,91902,69362
532.97223,2,4738,4788,-50,50,122800,122400,22638,-432438,-444688
532.97223,3,601,694,-93,93,122800,122400,20393,164807,142022
532.97223,4,110,50,60,-60,122800,122400,-2017,-23583,-8883
532.97223,5,3150,3175,-25,25,122800,122400,13914,-266714,-272839
532.97223,6,0,0,0,0,122800,122400,0,0,0
533.216544,0,545,645,-100,100,123000,122400,30201,244199,219699
533.216544,1,539,631,-92,92,123000,122400,29698,91902,69362
533.216544,2,4748,4788,-40,40,123000,122400,22884,-436684,-446484
533.216544,3,601,694,-93,93,123000,122400,20393,164807,142022
533.216544,4,110,50,60,-60,123000,122400,-2017,-23583,-8883
533.216544,5,3150,3185,-35,35,123000,122400,13791,-263591,-272166
533.216544,6,0,0,0,0,123000,122400,0,0,0
533.46758,0,545,645,-100,100,122800,122400,30201,244199,219699
533.46758,1,539,631,-92,92,122800,122400,29698,91902,69362
533.46758,2,4748,4788,-40,40,122800,122400,22884,-436684,-446484
533.46758,3,601,694,-93,93,122800,122400,20393,164807,142022
533.46758,4,110,50,60,-60,122800,122400,-2017,-23583,-8883
533.46758,5,3150,3185,-35,35,122800,122400,13791,-263591,-272166
533.46758,6,0,0,0,0,122800,122400,0,0,0
533.728473,0,545,645,-100,100,122800,122400,30201,244199,219699
533.728473,1,539,631,-92,92,122800,122400,29698,91902,69362
533.728473,2,4748,4788,-40,40,122800,122400,22884,-436684,-446484
533.728473,3,601,694,-93,93,122800,122400,20393,164807,142022
533.728473,4,110,50,60,-60,122800,122400,-2017,-23583,-8883
533.728473,5,3150,3185,-35,35,122800,122400,13791,-263591,-272166
533.728473,6,0,0,0,0,122800,122400,0,0,0
533.984575,0,545,645,-100,100,122800,122400,30201,244199,219699
533.984575,1,539,631,-92,92,122800,122400,29698,91902,69362
533.984575,2,4748,4788,-40,40,122800,122400,22884,-436684,-446484
533.984575,3,601,694,-93,93,122800,122400,20393,164807,142022
533.984575,4,110,50,60,-60,122800,122400,-2017,-23583,-8883
533.984575,5,3150,3185,-35,35,122800,122400,13791,-263591,-272166
533.984575,6,0,0,0,0,122800,122400,0,0,0
534.206037,0,545,645,-100,100,122800,122400,30201,244199,219699
534.206037,1,539,631,-92,92,122800,122400,29698,91902,69362
534.206037,2,4748,4788,-40,40,122800,122400,22884,-436684,-446484
534.206037,3,601,694,-93,93,122800,122400,20393,164807,142022
534.206037,4,110,50,60,-60,122800,122400,-2017,-23583,-8883
534.206037,5,3150,3185,-35,35,122800,122400,13791,-263591,-272166
534.206037,6,0,0,0,0,122800,122400,0,0,0
534.530922,0,545,645,-100,100,122800,122400,30201,244199,219699
534.530922,1,539,631,-92,92,122800,122400,29698,91902,69362
534.530922,2,4748,4788,-40,40,122800,122400,22884,-436684,-446484
534.530922,3,601,694,-93,93,122800,122400,20393,164807,142022
534.530922,4,110,50,60,-60,122800,122400,-2017,-23583,-8883
534.530922,5,3150,3185,-35,35,122800,122400,13791,-263591,-272166
534.530922,6,0,0,0,0,122800,122400,0,0,0
534.716868,0,545,645,-100,100,122900,122400,30201,244199,219699
534.716868,1,539,631,-92,92,122900,122400,29698,91902,69362
534.716868,2,4758,4798,-40,40,122900,122400,23007,-438807,-448607
534.716868,3,601,694,-93,93,122900,122400,20393,164807,142022
534.716868,4,110,50,60,-60,122900,122400,-2017,-23583,-8883
534.716868,5,3160,3185,-25,25,122900,122400,13668,-267468,-273593
534.716868,6,0,0,0,0,122900,122400,0,0,0
535.041103,0,545,645,-100,100,122900,122400,30201,244199,219699
535.041103,1,539,631,-92,92,122900,122400,29698,91902,69362
535.041103,2,4758,4798,-40,40,122900,122400,23007,-438807,-448607
535.041103,3,601,694,-93,93,122900,122400,20393,164807,142022
535.041103,4,110,50,60,-60,122900,122400,-2017,-23583,-8883
535.041103,5,3160,3185,-25,25,122900,122400,13668,-267468,-273593
535.041103,6,0,0,0,0,122900,122400,0,0,0
535.25793,0,545,645,-100,100,122900,122400,30201,244199,219699
535.25793,1,539,631,-92,92,122900,122400,29698,91902,69362
535.25793,2,4758,4798,-40,40,122900,122400,23007,-438807,-448607
535.25793,3,601,694,-93,93,122900,122400,20393,164807,142022
535.25793,4,110,50,60,-60,122900,122400,-2017,-23583,-8883
535.25793,5,3160,3185,-25,25,122900,122400,13668,-267468,-273593
535.25793,6,0,0,0,0,122900,122400,0,0,0
535.475559,0,545,645,-100,100,122900,122400,30201,244199,219699
535.475559,1,539,631,-92,92,122900,122400,29698,91902,69362
535.475559,2,4758,4808,-50,50,122900,122400,23253,-435053,-447303
535.475559,3,601,694,-93,93,122900,122400,20393,164807,142022
535.475559,4,110,50,60,-60,122900,122400,-2017,-23583,-8883
535.475559,5,3170,3185,-15,15,122900,122400,13545,-273345,-277020
535.475559,6,0,0,0,0,122900,122400,0,0,0
535.753274,0,545,645,-100,100,122800,122400,30201,244199,219699
535.753274,1,539,631,-92,92,122800,122400,29698,91902,69362
535.753274,2,4768,4808,-40,40,122800,122400,23499,-440299,-450099
535.753274,3,601,694,-93,93,122800,122400,20393,164807,142022
535.753274,4,110,50,60,-60,122800,122400,-2017,-23583,-8883
535.753274,5,3170,3205,-35,35,122800,122400,13668,-266468,-275043
535.753274,6,0,0,0,0,122800,122400,0,0,0
536.042916,0,545,645,-100,100,122800,122400,30201,244199,219699
536.042916,1,539,631,-92,92,122800,122400,29698,91902,69362
536.042916,2,4768,4808,-40,40,122800,122400,23499,-440299,-450099
536.042916,3,601,694,-93,93,122800,122400,20393,164807,142022
536.042916,4,110,50,60,-60,122800,122400,-2017,-23583,-8883
536.042916,5,3170,3205,-35,35,122800,122400,13668,-266468,-275043
536.042916,6,0,0,0,0,122800,122400,0,0,0
536.274803,0,545,645,-100,100,122800,122400,30201,244199,219699
536.274803,1,539,631,-92,92,122800,122400,29698,91902,69362
536.274803,2,4768,4808,-40,40,122800,122400,23499,-440299,-450099
536.274803,3,601,694,-93,93,122800,122400,20393,164807,142022
536.274803,4,110,50,60,-60,122800,122400,-2017,-23583,-8883
536.274803,5,3170,3205,-35,35,122800,122400,13668,-266468,-275043
536.274803,6,0,0,0,0,122800,122400,0,0,0
536.500189,0,545,645,-100,100,123000,122500,30201,244199,219699
536.500189,1,539,631,-92,92,123000,122500,29698,91902,69362
536.500189,2,4768,4818,-50,50,123000,122500,23376,-436176,-448426
536.500189,3,601,694,-93,93,123000,122500,20393,164807,142022
536.500189,4,110,50,60,-60,123000,122500,-2017,-23583,-8883
536.500189,5,3170,3205,-35,35,123000,122500,13668,-266468,-275043
536.500189,6,0,0,0,0,123000,122500,0,0,0
536.713408,0,545,645,-100,100,122900,122500,30201,244199,219699
536.713408,1,539,631,-92,92,122900,122500,29698,91902,69362
536.713408,2,4778,4818,-40,40,122900,122500,23253,-441053,-450853
536.713408,3,601,694,-93,93,122900,122500,20393,164807,142022
536.713408,4,110,50,60,-60,122900,122500,-2017,-23583,-8883
536.713408,5,3170,3205,-35,35,122900,122500,13668,-266468,-275043
536.713408,6,0,0,0,0,122900,122500,0,0,0
536.986632,0,545,645,-100,100,122800,122500,30201,244199,219699
536.986632,1,539,631,-92,92,122800,122500,29698,91902,69362
536.986632,2,4778,4818,-40,40,122800,122500,23253,-441053,-450853
536.986632,3,601,694,-93,93,122800,122500,20393,164807,142022
536.986632,4,110,50,60,-60,122800,122500,-2017,-23583,-8883
536.986632,5,3170,3205,-35,35,122800,122500,13668,-266468,-275043
536.986632,6,0,0,0,0,122800,122500,0,0,0
537.271861,0,545,645,-100,100,122700,122500,30201,244199,224199
537.271861,1,539,631,-92,92,122700,122500,29698,91902,73502
537.271861,2,4788,4818,-30,30,122700,122500,23130,-444930,-450930
537.271861,3,601,694,-93,93,122700,122500,20393,164807,146207
537.271861,4,110,50,60,-60,122700,122500,-2017,-23583,-11583
537.271861,5,3170,3205,-35,35,122700,122500,13668,-266468,-273468
537.271861,6,0,0,0,0,122700,122500,0,0,0
537.471517,0,545,645,-100,100,122700,122500,30201,244199,224199
537.471517,1,539,631,-92,92,122700,122500,29698,91902,73502
537.471517,2,4788,4818,-30,30,122700,122500,23130,-444930,-450930
537.471517,3,601,694,-93,93,122700,122500,20393,164807,146207
537.471517,4,110,50,60,-60,122700,122500,-2017,-23583,-11583
537.471517,5,3170,3205,-35,35,122700,122500,13668,-266468,-273468
537.471517,6,0,0,0,0,122700,122500,0,0,0
537.754022,0,545,645,-100,100,122700,122400,30201,244199,219699
537.754022,1,539,631,-92,92,122700,122400,29698,91902,69362
537.754022,2,4788,4818,-30,30,122700,122400,23130,-444930,-452280
537.754022,3,601,694,-93,93,122700,122400,20393,164807,142022
537.754022,4,110,50,60,-60,122700,122400,-2017,-23583,-8883
537.754022,5,3170,3205,-35,35,122700,122400,13668,-266468,-275043
537.754022,6,0,0,0,0,122700,122400,0,0,0
538.024559,0,545,645,-100,100,122700,122400,30201,244199,219699
538.024559,1,539,631,-92,92,122700,122400,29698,91902,69362
538.024559,2,4788,4818,-30,30,122700,122400,23130,-444930,-452280
538.024559,3,601,694,-93,93,122700,122400,20393,164807,142022
538.024559,4,110,50,60,-60,122700,122400,-2017,-23583,-8883
538.024559,5,3170,3205,-35,35,122700,122400,13668,-266468,-275043
538.024559,6,0,0,0,0,122700,122400,0,0,0
538.232969,0,545,645,-100,100,122700,122400,30201,244199,219699
538.232969,1,539,631,-92,92,122700,122400,29698,91902,69362
538.232969,2,4788,4818,-30,30,122700,122400,23130,-444930,-452280
538.232969,3,601,694,-93,93,122700,122400,20393,164807,142022
538.232969,4,110,50,60,-60,122700,122400,-2017,-23583,-8883
538.232969,5,3170,3205,-35,35,122700,122400,13668,-266468,-275043
538.232969,6,0,0,0,0,122700,122400,0,0,0
538.515673,0,545,645,-100,100,122700,122400,30201,244199,219699
538.515673,1,539,631,-92,92,122700,122400,29698,91902,69362
538.515673,2,4788,4818,-30,30,122700,122400,23130,-444930,-452280
538.515673,3,601,694,-93,93,122700,122400,20393,164807,142022
538.515673,4,110,50,60,-60,122700,122400,-2017,-23583,-8883
538.515673,5,3170,3205,-35,35,122700,122400,13668,-266468,-275043
538.515673,6,0,0,0,0,122700,122400,0,0,0
538.746907,0,545,645,-100,100,122700,122400,30201,244199,219699
538.746907,1,539,631,-92,92,122700,122400,29698,91902,69362
538.746907,2,4788,4818,-30,30,122700,122400,23130,-444930,-452280
538.746907,3,601,694,-93,93,122700,122400,20393,164807,142022
538.746907,4,110,50,60,-60,122700,122400,-2017,-23583,-8883
538.746907,5,3170,3205,-35,35,122700,122400,13668,-266468,-275043
538.746907,6,0,0,0,0,122700,122400,0,0,0
538.969097,0,545,645,-100,100,122700,122400,30201,244199,219699
538.969097,1,539,631,-92,92,122700,122400,29698,91902,69362
538.969097,2,4788,4828,-40,40,122700,122400,23375,-442175,-451975
538.969097,3,601,694,-93,93,122700,122400,20393,164807,142022
538.969097,4,110,50,60,-60,122700,122400,-2017,-23583,-8883
538.969097,5,3170,3205,-35,35,122700,122400,13668,-266468,-275043
538.969097,6,0,0,0,0,122700,122400,0,0,0
539.276159,0,545,645,-100,100,122700,122400,30201,244199,219699
539.276159,1,539,631,-92,92,122700,122400,29698,91902,69362
539.276159,2,4788,4828,-40,40,122700,122400,23375,-442175,-451975
539.276159,3,601,694,-93,93,122700,122400,20393,164807,142022
539.276159,4,110,50,60,-60,122700,122400,-2017,-23583,-8883
539.276159,5,3170,3205,-35,35,122700,122400,13668,-266468,-275043
539.276159,6,0,0,0,0,122700,122400,0,0,0
539.478203,0,545,645,-100,100,122700,122400,30201,244199,219699
539.478203,1,539,631,-92,92,122700,122400,29698,91902,69362
539.478203,2,4788,4828,-40,40,122700,122400,23375,-442175,-451975
539.478203,3,601,694,-93,93,122700,122400,20393,164807,142022
539.478203,4,110,50,60,-60,122700,122400,-2017,-23583,-8883
539.478203,5,3170,3205,-35,35,122700,122400,13668,-266468,-275043
539.478203,6,0,0,0,0,122700,122400,0,0,0
539.748431,0,545,645,-100,100,122700,122400,30201,244199,219699
539.748431,1,539,631,-92,92,122700,122400,29698,91902,69362
539.748431,2,4788,4828,-40,40,122700,122400,23375,-442175,-451975
539.748431,3,601,694,-93,93,122700,122400,20393,164807,142022
539.748431,4,110,50,60,-60,122700,122400,-2017,-23583,-8883
539.748431,5,3170,3205,-35,35,122700,122400,13668,-266468,-275043
539.748431,6,0,0,0,0,122700,122400,0,0,0
540.01709,0,545,645,-100,100,122700,122400,30201,244199,219699
540.01709,1,539,631,-92,92,122700,122400,29698,91902,69362
540.01709,2,4788,4828,-40,40,122700,122400,23375,-442175,-451975
540.01709,3,601,694,-93,93,122700,122400,20393,164807,142022
540.01709,4,110,50,60,-60,122700,122400,-2017,-23583,-8883
540.01709,5,3170,3205,-35,35,122700,122400,13668,-266468,-275043
540.01709,6,0,0,0,0,122700,122400,0,0,0
540.226271,0,545,645,-100,100,123300,122400,30201,244199,219699
540.226271,1,539,631,-92,92,123300,122400,29698,91902,69362
540.226271,2,4798,4838,-40,40,123300,122400,23498,-440398,-450198
540.226271,3,601,694,-93,93,123300,122400,20393,164807,142022
540.226271,4,110,50,60,-60,123300,122400,-2017,-23583,-8883
540.226271,5,3177,3205,-28,28,123300,122400,13840,-269440,-276300
540.226271,6,0,0,0,0,123300,122400,0,0,0
540.541537,0,545,645,-100,100,123300,122400,30201,244199,219699
540.541537,1,539,631,-92,92,123300,122400,29698,91902,69362
540.541537,2,4798,4838,-40,40,123300,122400,23498,-440398,-450198
540.541537,3,601,694,-93,93,123300,122400,20393,164807,142022
540.541537,4,110,50,60,-60,123300,122400,-2017,-23583,-8883
540.541537,5,3177,3205,-28,28,123300,122400,13840,-269440,-276300
540.541537,6,0,0,0,0,123300,122400,0,0,0
540.773655,0,545,645,-100,100,123300,122800,30201,244199,219599
540.773655,1,539,631,-92,92,123300,122800,29698,91902,69270
540.773655,2,4798,4838,-40,40,123300,122800,23498,-440398,-450238
540.773655,3,601,694,-93,93,123300,122800,20393,164807,141929
540.773655,4,110,50,60,-60,123300,122800,-2017,-23583,-8823
540.773655,5,3177,3205,-28,28,123300,122800,13840,-269440,-276328
540.773655,6,0,0,0,0,123300,122800,0,0,0
541.011843,0,545,645,-100,100,122700,123100,30201,244199,268799
541.011843,1,539,631,-92,92,122700,123100,29698,91902,114534
541.011843,2,4808,4838,-30,30,122700,123100,23744,-443644,-436264
541.011843,3,601,694,-93,93,122700,123100,20393,164807,187685
541.011843,4,110,50,60,-60,122700,123100,-2017,-23583,-38343
541.011843,5,3187,3215,-28,28,122700,123100,13594,-268194,-261306
541.011843,6,0,0,0,0,122700,123100,0,0,0
541.292414,0,545,645,-100,100,123400,123100,30201,244199,219599
541.292414,1,539,631,-92,92,123400,123100,29698,91902,69270
541.292414,2,4818,4838,-20,20,123400,123100,23991,-445891,-450811
541.292414,3,609,694,-85,85,123400,123100,20590,162210,141300
541.292414,4,110,50,60,-60,123400,123100,-2017,-23583,-8823
541.292414,5,3187,3225,-38,38,123400,123100,13471,-268071,-277419
541.292414,6,0,0,0,0,123400,123100,0,0,0
541.52605,0,545,645,-100,100,123300,123100,30201,244199,224199
541.52605,1,539,631,-92,92,123300,123100,29698,91902,73502
541.52605,2,4818,4848,-30,30,123300,123100,24238,-444138,-450138
541.52605,3,609,694,-85,85,123300,123100,20590,162210,145210
541.52605,4,110,50,60,-60,123300,123100,-2017,-23583,-11583
541.52605,5,3197,3225,-28,28,123300,123100,13348,-270948,-276548
541.52605,6,0,0,0,0,123300,123100,0,0,0
541.704982,0,545,645,-100,100,123300,123100,30201,244199,224199
541.704982,1,539,631,-92,92,123300,123100,29698,91902,73502
541.704982,2,4818,4848,-30,30,123300,123100,24238,-444138,-450138
541.704982,3,609,694,-85,85,123300,123100,20590,162210,145210
541.704982,4,110,50,60,-60,123300,123100,-2017,-23583,-11583
541.704982,5,3197,3225,-28,28,123300,123100,13348,-270948,-276548
541.704982,6,0,0,0,0,123300,123100,0,0,0
541.995169,0,545,645,-100,100,123300,123100,30201,244199,224199
541.995169,1,539,631,-92,92,123300,123100,29698,91902,73502
541.995169,2,4818,4848,-30,30,123300,123100,24238,-444138,-450138
541.995169,3,609,694,-85,85,123300,123100,20590,162210,145210
541.995169,4,110,50,60,-60,123300,123100,-2017,-23583,-11583
541.995169,5,3197,3225,-28,28,123300,123100,13348,-270948,-276548
541.995169,6,0,0,0,0,123300,123100,0,0,0
542.206344,0,545,645,-100,100,123300,123100,30201,244199,224199
542.206344,1,539,631,-92,92,123300,123100,29698,91902,73502
542.206344,2,4818,4848,-30,30,123300,123100,24238,-444138,-450138
542.206344,3,609,694,-85,85,123300,123100,20590,162210,145210
542.206344,4,110,50,60,-60,123300,123100,-2017,-23583,-11583
542.206344,5,3197,3225,-28,28,123300,123100,13348,-270948,-276548
542.206344,6,0,0,0,0,123300,123100,0,0,0
542.515868,0,545,645,-100,100,123200,123100,30201,244199,234199
542.515868,1,539,631,-92,92,123200,123100,29698,91902,82702
542.515868,2,4818,4848,-30,30,123200,123100,24238,-444138,-447138
542.515868,3,609,696,-87,87,123200,123100,20639,162361,153661
542.515868,4,110,50,60,-60,123200,123100,-2017,-23583,-17583
542.515868,5,3199,3225,-26,26,123200,123100,13323,-271523,-274123
542.515868,6,0,0,0,0,123200,123100,0,0,0
542.784082,0,545,645,-100,100,122700,123100,30201,244199,268799
542.784082,1,539,631,-92,92,122700,123100,29698,91902,114534
542.784082,2,4828,4848,-20,20,122700,123100,24115,-447015,-442095
542.784082,3,609,696,-87,87,122700,123100,20639,162361,183763
542.784082,4,110,50,60,-60,122700,123100,-2017,-23583,-38343
542.784082,5,3207,3225,-18,18,122700,123100,13224,-273824,-269396
542.784082,6,0,0,0,0,122700,123100,0,0,0
542.984094,0,545,645,-100,100,123200,123100,30201,244199,234199
542.984094,1,539,631,-92,92,123200,123100,29698,91902,82702
542.984094,2,4828,4858,-30,30,123200,123100,24361,-445261,-448261
542.984094,3,609,696,-87,87,123200,123100,20639,162361,153661
542.984094,4,110,50,60,-60,123200,123100,-2017,-23583,-17583
542.984094,5,3217,3225,-8,8,123200,123100,13101,-276701,-277501
542.984094,6,0,0,0,0,123200,123100,0,0,0
543.295464,0,545,645,-100,100,123200,123100,30201,244199,234199
543.295464,1,539,631,-92,92,123200,123100,29698,91902,82702
543.295464,2,4828,4858,-30,30,123200,123100,24361,-445261,-448261
543.295464,3,609,696,-87,87,123200,123100,20639,162361,153661
543.295464,4,110,50,60,-60,123200,123100,-2017,-23583,-17583
543.295464,5,3217,3225,-8,8,123200,123100,13101,-276701,-277501
543.295464,6,0,0,0,0,123200,123100,0,0,0
543.451656,0,545,645,-100,100,123200,123100,30201,244199,234199
543.451656,1,539,631,-92,92,123200,123100,29698,91902,82702
543.451656,2,4828,4858,-30,30,123200,123100,24361,-445261,-448261
543.451656,3,609,696,-87,87,123200,123100,20639,162361,153661
543.451656,4,110,50,60,-60,123200,123100,-2017,-23583,-17583
543.451656,5,3217,3225,-8,8,123200,123100,13101,-276701,-277501
543.451656,6,0,0,0,0,123200,123100,0,0,0
543.738801,0,545,645,-100,100,123200,123100,30201,244199,234199
543.738801,1,539,631,-92,92,123200,123100,29698,91902,82702
543.738801,2,4830,4858,-28,28,123200,123100,24336,-445836,-448636
543.738801,3,609,698,-89,89,123200,123100,20688,162712,153812
543.738801,4,110,50,60,-60,123200,123100,-2017,-23583,-17583
543.738801,5,3217,3225,-8,8,123200,123100,13101,-276701,-277501
543.738801,6,0,0,0,0,123200,123100,0,0,0
544.035095,0,545,645,-100,100,122700,123100,30201,244199,268799
544.035095,1,539,631,-92,92,122700,123100,29698,91902,114534
544.035095,2,4838,4858,-20,20,122700,123100,24237,-448937,-444017
544.035095,3,609,698,-89,89,122700,123100,20688,162712,184606
544.035095,4,110,50,60,-60,122700,123100,-2017,-23583,-38343
544.035095,5,3227,3225,2,-2,122700,123100,12978,-278578,-279070
544.035095,6,0,0,0,0,122700,123100,0,0,0
544.220346,0,545,645,-100,100,122700,123100,30201,244199,268799
544.220346,1,539,631,-92,92,122700,123100,29698,91902,114534
544.220346,2,4838,4858,-20,20,122700,123100,24237,-448937,-444017
544.220346,3,609,698,-89,89,122700,123100,20688,162712,184606
544.220346,4,110,50,60,-60,122700,123100,-2017,-23583,-38343
544.220346,5,3227,3225,2,-2,122700,123100,12978,-278578,-279070
544.220346,6,0,0,0,0,122700,123100,0,0,0
544.458944,0,545,645,-100,100,122700,123100,30201,244199,268799
544.458944,1,539,631,-92,92,122700,123100,29698,91902,114534
544.458944,2,4848,4858,-10,10,122700,123100,24114,-451814,-449354
544.458944,3,609,698,-89,89,122700,123100,20688,162712,184606
544.458944,4,110,50,60,-60,122700,123100,-2017,-23583,-38343
544.458944,5,3237,3225,12,-12,122700,123100,12855,-280455,-283407
544.458944,6,0,0,0,0,122700,123100,0,0,0
544.771392,0,545,645,-100,100,122700,122700,30201,244199,244199
544.771392,1,539,631,-92,92,122700,122700,29698,91902,91902
544.771392,2,4848,4858,-10,10,122700,122700,24114,-451814,-451814
544.771392,3,609,698,-89,89,122700,122700,20688,162712,162712
544.771392,4,110,50,60,-60,122700,122700,-2017,-23583,-23583
544.771392,5,3237,3225,12,-12,122700,122700,12855,-280455,-280455
544.771392,6,0,0,0,0,122700,122700,0,0,0
544.971128,0,545,645,-100,100,123300,122700,30201,244199,219699
544.971128,1,539,631,-92,92,123300,122700,29698,91902,69362
544.971128,2,4848,4868,-20,20,123300,122700,23991,-450691,-455591
544.971128,3,609,698,-89,89,123300,122700,20688,162712,140907
544.971128,4,110,50,60,-60,123300,122700,-2017,-23583,-8883
544.971128,5,3237,3225,12,-12,123300,122700,12855,-280455,-277515
544.971128,6,0,0,0,0,123300,122700,0,0,0
545.223006,0,545,645,-100,100,123300,122700,30201,244199,219699
545.223006,1,539,631,-92,92,123300,122700,29698,91902,69362
545.223006,2,4848,4868,-20,20,123300,122700,23991,-450691,-455591
545.223006,3,609,698,-89,89,123300,122700,20688,162712,140907
545.223006,4,110,50,60,-60,123300,122700,-2017,-23583,-8883
545.223006,5,3237,3225,12,-12,123300,122700,12855,-280455,-277515
545.223006,6,0,0,0,0,123300,122700,0,0,0
545.473549,0,545,645,-100,100,123300,122800,30201,244199,219599
545.473549,1,539,631,-92,92,123300,122800,29698,91902,69270
545.473549,2,4848,4868,-20,20,123300,122800,23991,-450691,-455611
545.473549,3,609,698,-89,89,123300,122800,20688,162712,140818
545.473549,4,110,50,60,-60,123300,122800,-2017,-23583,-8823
545.473549,5,3237,3225,12,-12,123300,122800,12855,-280455,-277503
545.473549,6,0,0,0,0,123300,122800,0,0,0
545.787674,0,545,645,-100,100,123300,122800,30201,244199,219599
545.787674,1,539,631,-92,92,123300,122800,29698,91902,69270
545.787674,2,4848,4868,-20,20,123300,122800,23991,-450691,-455611
545.787674,3,609,698,-89,89,123300,122800,20688,162712,140818
545.787674,4,110,50,60,-60,123300,122800,-2017,-23583,-8823
545.787674,5,3237,3225,12,-12,123300,122800,12855,-280455,-277503
545.787674,6,0,0,0,0,123300,122800,0,0,0
546.015885,0,545,645,-100,100,123300,122800,30201,244199,219599
546.015885,1,539,631,-92,92,123300,122800,29698,91902,69270
546.015885,2,4848,4868,-20,20,123300,122800,23991,-450691,-455611
546.015885,3,609,698,-89,89,123300,122800,20688,162712,140818
546.015885,4,110,50,60,-60,123300,122800,-2017,-23583,-8823
546.015885,5,3237,3225,12,-12,123300,122800,12855,-280455,-277503
546.015885,6,0,0,0,0,123300,122800,0,0,0
546.22818,0,545,645,-100,100,123000,122800,30201,244199,224199
546.22818,1,539,631,-92,92,123000,122800,29698,91902,73502
546.22818,2,4858,4868,-10,10,123000,122800,23868,-452568,-454568
546.22818,3,609,698,-89,89,123000,122800,20688,162712,144912
546.22818,4,110,50,60,-60,123000,122800,-2017,-23583,-11583
546.22818,5,3237,3235,2,-2,123000,122800,13101,-280701,-280301
546.22818,6,0,0,0,0,123000,122800,0,0,0
546.450379,0,545,645,-100,100,123000,122800,30201,244199,224199
546.450379,1,539,631,-92,92,123000,122800,29698,91902,73502
546.450379,2,4858,4868,-10,10,123000,122800,23868,-452568,-454568
546.450379,3,609,698,-89,89,123000,122800,20688,162712,144912
546.450379,4,110,50,60,-60,123000,122800,-2017,-23583,-11583
546.450379,5,3237,3235,2,-2,123000,122800,13101,-280701,-280301
546.450379,6,0,0,0,0,123000,122800,0,0,0
546.780812,0,545,645,-100,100,123000,122800,30201,244199,224199
546.780812,1,539,631,-92,92,123000,122800,29698,91902,73502
546.780812,2,4858,4868,-10,10,123000,122800,23868,-452568,-454568
546.780812,3,609,698,-89,89,123000,122800,20688,162712,144912
546.780812,4,110,50,60,-60,123000,122800,-2017,-23583,-11583
546.780812,5,3237,3235,2,-2,123000,122800,13101,-280701,-280301
546.780812,6,0,0,0,0,123000,122800,0,0,0
546.95153,0,545,645,-100,100,123400,122800,30201,244199,219599
546.95153,1,539,631,-92,92,123400,122800,29698,91902,69270
546.95153,2,4858,4878,-20,20,123400,122800,23745,-449445,-454365
546.95153,3,609,698,-89,89,123400,122800,20688,162712,140818
546.95153,4,110,50,60,-60,123400,122800,-2017,-23583,-8823
546.95153,5,3237,3235,2,-2,123400,122800,13101,-280701,-280209
546.95153,6,0,0,0,0,123400,122800,0,0,0
547.289692,0,545,645,-100,100,122700,122800,30201,244199,254199
547.289692,1,539,631,-92,92,122700,122800,29698,91902,101102
547.289692,2,4858,4888,-30,30,122700,122800,23622,-446322,-443322
547.289692,3,609,698,-89,89,122700,122800,20688,162712,171612
547.289692,4,110,50,60,-60,122700,122800,-2017,-23583,-29583
547.289692,5,3237,3235,2,-2,122700,122800,13101,-280701,-280901
547.289692,6,0,0,0,0,122700,122800,0,0,0
547.495974,0,545,645,-100,100,122700,122800,30201,244199,254199
547.495974,1,539,631,-92,92,122700,122800,29698,91902,101102
547.495974,2,4858,4888,-30,30,122700,122800,23622,-446322,-443322
547.495974,3,609,700,-91,91,122700,122800,20737,162863,171963
547.495974,4,110,50,60,-60,122700,122800,-2017,-23583,-29583
547.495974,5,3237,3245,-8,8,122700,122800,13346,-279946,-279146
547.495974,6,0,0,0,0,122700,122800,0,0,0
547.752636,0,545,645,-100,100,122900,122400,30201,244199,219699
547.752636,1,539,631,-92,92,122900,122400,29698,91902,69362
547.752636,2,4858,4898,-40,40,122900,122400,23499,-443199,-452999
547.752636,3,609,700,-91,91,122900,122400,20737,162863,140568
547.752636,4,110,50,60,-60,122900,122400,-2017,-23583,-8883
547.752636,5,3237,3255,-18,18,122900,122400,13591,-278191,-282601
547.752636,6,0,0,0,0,122900,122400,0,0,0
548.019091,0,545,645,-100,100,122700,122400,30201,244199,219699
548.019091,1,539,631,-92,92,122700,122400,29698,91902,69362
548.019091,2,4858,4898,-40,40,122700,122400,23499,-443199,-452999
548.019091,3,609,700,-91,91,122700,122400,20737,162863,140568
548.019091,4,110,50,60,-60,122700,122400,-2017,-23583,-8883
548.019091,5,3237,3265,-28,28,122700,122400,13836,-275436,-282296
548.019091,6,0,0,0,0,122700,122400,0,0,0
548.20936,0,545,645,-100,100,122700,122400,30201,244199,219699
548.20936,1,539,631,-92,92,122700,122400,29698,91902,69362
548.20936,2,4858,4898,-40,40,122700,122400,23499,-443199,-452999
548.20936,3,609,702,-93,93,122700,122400,20786,163414,140629
548.20936,4,110,50,60,-60,122700,122400,-2017,-23583,-8883
548.20936,5,3237,3265,-28,28,122700,122400,13836,-275436,-282296
548.20936,6,0,0,0,0,122700,122400,0,0,0
548.471741,0,545,645,-100,100,122700,122400,30201,244199,219699
548.471741,1,539,631,-92,92,122700,122400,29698,91902,69362
548.471741,2,4858,4898,-40,40,122700,122400,23499,-443199,-452999
548.471741,3,609,702,-93,93,122700,122400,20786,163414,140629
548.471741,4,110,50,60,-60,122700,122400,-2017,-23583,-8883
548.471741,5,3237,3265,-28,28,122700,122400,13836,-275436,-282296
548.471741,6,0,0,0,0,122700,122400,0,0,0
548.758678,0,545,645,-100,100,122700,122000,30201,244199,219799
548.758678,1,539,631,-92,92,122700,122000,29698,91902,69454
548.758678,2,4858,4908,-50,50,122700,122000,23744,-438444,-450644
548.758678,3,609,702,-93,93,122700,122000,20786,163414,140722
548.758678,4,110,50,60,-60,122700,122000,-2017,-23583,-8943
548.758678,5,3237,3275,-38,38,122700,122000,14081,-270681,-279953
548.758678,6,0,0,0,0,122700,122000,0,0,0
548.99094,0,545,645,-100,100,122400,121800,30201,244199,219799
548.99094,1,539,631,-92,92,122400,121800,29698,91902,69454
548.99094,2,4858,4918,-60,60,122400,121800,23989,-431689,-446329
548.99094,3,609,702,-93,93,122400,121800,20786,163414,140722
548.99094,4,120,50,70,-70,122400,121800,-2139,-30461,-13381
548.99094,5,3237,3285,-48,48,122400,121800,14326,-263926,-275638
548.99094,6,0,0,0,0,122400,121800,0,0,0
549.216527,0,545,645,-100,100,122300,121900,30201,244199,219799
549.216527,1,539,631,-92,92,122300,121900,29698,91902,69454
549.216527,2,4868,4918,-50,50,122300,121900,24234,-437934,-450134
549.216527,3,609,702,-93,93,122300,121900,20786,163414,140722
549.216527,4,120,50,70,-70,122300,121900,-2139,-30461,-13381
549.216527,5,3247,3295,-48,48,122300,121900,14816,-266416,-278128
549.216527,6,0,0,0,0,122300,121900,0,0,0
549.486108,0,545,645,-100,100,122300,121800,30201,244199,219799
549.486108,1,539,631,-92,92,122300,121800,29698,91902,69454
549.486108,2,4868,4918,-50,50,122300,121800,24234,-437934,-450134
549.486108,3,609,702,-93,93,122300,121800,20786,163414,140722
549.486108,4,120,50,70,-70,122300,121800,-2139,-30461,-13381
549.486108,5,3247,3295,-48,48,122300,121800,14816,-266416,-278128
549.486108,6,0,0,0,0,122300,121800,0,0,0
549.762884,0,545,645,-100,100,122300,121600,30201,244199,219899
549.762884,1,539,631,-92,92,122300,121600,29698,91902,69546
549.762884,2,4878,4918,-40,40,122300,121600,24112,-444812,-454532
549.762884,3,609,702,-93,93,122300,121600,20786,163414,140815
549.762884,4,120,50,70,-70,122300,121600,-2139,-30461,-13451
549.762884,5,3247,3295,-48,48,122300,121600,14816,-266416,-278080
549.762884,6,0,0,0,0,122300,121600,0,0,0
549.988167,0,545,645,-100,100,122300,121900,30201,244199,219799
549.988167,1,539,631,-92,92,122300,121900,29698,91902,69454
549.988167,2,4878,4918,-40,40,122300,121900,24112,-444812,-454572
549.988167,3,609,702,-93,93,122300,121900,20786,163414,140722
549.988167,4,120,50,70,-70,122300,121900,-2139,-30461,-13381
549.988167,5,3257,3295,-38,38,122300,121900,15061,-271661,-280933
549.988167,6,0,0,0,0,122300,121900,0,0,0
550.247748,0,545,645,-100,100,122300,121900,30201,244199,219799
550.247748,1,539,631,-92,92,122300,121900,29698,91902,69454
550.247748,2,4878,4928,-50,50,122300,121900,23990,-441690,-453890
550.247748,3,609,702,-93,93,122300,121900,20786,163414,140722
550.247748,4,120,50,70,-70,122300,121900,-2139,-30461,-13381
550.247748,5,3267,3295,-28,28,122300,121900,15306,-276906,-283738
550.247748,6,0,0,0,0,122300,121900,0,0,0
550.539152,0,545,645,-100,100,122300,121900,30201,244199,219799
550.539152,1,539,631,-92,92,122300,121900,29698,91902,69454
550.539152,2,4878,4928,-50,50,122300,121900,23990,-441690,-453890
550.539152,3,609,702,-93,93,122300,121900,20786,163414,140722
550.539152,4,120,50,70,-70,122300,121900,-2139,-30461,-13381
550.539152,5,3267,3295,-28,28,122300,121900,15306,-276906,-283738
550.539152,6,0,0,0,0,122300,121900,0,0,0
550.774611,0,545,645,-100,100,122400,122100,30201,244199,219799
550.774611,1,539,631,-92,92,122400,122100,29698,91902,69454
550.774611,2,4888,4928,-40,40,122400,122100,23868,-447568,-457328
550.774611,3,609,702,-93,93,122400,122100,20786,163414,140722
550.774611,4,120,50,70,-70,122400,122100,-2139,-30461,-13381
550.774611,5,3267,3305,-38,38,122400,122100,15551,-272151,-281423
550.774611,6,0,0,0,0,122400,122100,0,0,0
550.967646,0,545,645,-100,100,122400,122200,30201,244199,224199
550.967646,1,539,631,-92,92,122400,122200,29698,91902,73502
550.967646,2,4888,4928,-40,40,122400,122200,23868,-447568,-455568
550.967646,3,609,702,-93,93,122400,122200,20786,163414,144814
550.967646,4,120,50,70,-70,122400,122200,-2139,-30461,-16461
550.967646,5,3267,3305,-38,38,122400,122200,15551,-272151,-279751
550.967646,6,0,0,0,0,122400,122200,0,0,0
551.231866,0,545,645,-100,100,122700,122200,30201,244199,219799
551.231866,1,539,631,-92,92,122700,122200,29698,91902,69454
551.231866,2,4888,4938,-50,50,122700,122200,23745,-444445,-456645
551.231866,3,609,702,-93,93,122700,122200,20786,163414,140722
551.231866,4,120,50,70,-70,122700,122200,-2139,-30461,-13381
551.231866,5,3267,3315,-48,48,122700,122200,15428,-268028,-279740
551.231866,6,0,0,0,0,122700,122200,0,0,0
551.516249,0,545,645,-100,100,122700,122200,30201,244199,219799
551.516249,1,539,631,-92,92,122700,122200,29698,91902,69454
551.516249,2,4888,4938,-50,50,122700,122200,23745,-444445,-456645
551.516249,3,609,702,-93,93,122700,122200,20786,163414,140722
551.516249,4,120,50,70,-70,122700,122200,-2139,-30461,-13381
551.516249,5,3267,3315,-48,48,122700,122200,15428,-268028,-279740
551.516249,6,0,0,0,0,122700,122200,0,0,0
551.787252,0,545,645,-100,100,122100,122200,30201,244199,254199
551.787252,1,539,631,-92,92,122100,122200,29698,91902,101102
551.787252,2,4898,4948,-50,50,122100,122200,23868,-446568,-441568
551.787252,3,609,702,-93,93,122100,122200,20786,163414,172714
551.787252,4,120,50,70,-70,122100,122200,-2139,-30461,-37461
551.787252,5,3277,3315,-38,38,122100,122200,15674,-272274,-268474
551.787252,6,0,0,0,0,122100,122200,0,0,0
551.988359,0,545,645,-100,100,122900,122200,30201,244199,219799
551.988359,1,539,631,-92,92,122900,122200,29698,91902,69454
551.988359,2,4908,4948,-40,40,122900,122200,24114,-451814,-461574
551.988359,3,609,702,-93,93,122900,122200,20786,163414,140722
551.988359,4,120,50,70,-70,122900,122200,-2139,-30461,-13381
551.988359,5,3277,3315,-38,38,122900,122200,15674,-272274,-281546
551.988359,6,0,0,0,0,122900,122200,0,0,0
552.258627,0,545,645,-100,100,122900,122200,30201,244199,219799
552.258627,1,539,631,-92,92,122900,122200,29698,91902,69454
552.258627,2,4908,4948,-40,40,122900,122200,24114,-451814,-461574
552.258627,3,609,702,-93,93,122900,122200,20786,163414,140722
552.258627,4,120,50,70,-70,122900,122200,-2139,-30461,-13381
552.258627,5,3277,3315,-38,38,122900,122200,15674,-272274,-281546
552.258627,6,0,0,0,0,122900,122200,0,0,0
552.458845,0,545,645,-100,100,122900,122200,30201,244199,219799
552.458845,1,539,631,-92,92,122900,122200,29698,91902,69454
552.458845,2,4918,4948,-30,30,122900,122200,24360,-456060,-463380
552.458845,3,609,702,-93,93,122900,122200,20786,163414,140722
552.458845,4,120,50,70,-70,122900,122200,-2139,-30461,-13381
552.458845,5,3277,3325,-48,48,122900,122200,15551,-270151,-281863
552.458845,6,0,0,0,0,122900,122200,0,0,0
552.714581,0,545,645,-100,100,122900,122300,30201,244199,219699
552.714581,1,539,631,-92,92,122900,122300,29698,91902,69362
552.714581,2,4918,4951,-33,33,122900,122300,24434,-454634,-462719
552.714581,3,609,702,-93,93,122900,122300,20786,163414,140629
552.714581,4,120,50,70,-70,122900,122300,-2139,-30461,-13311
552.714581,5,3287,3325,-38,38,122900,122300,15686,-276286,-285596
552.714581,6,0,0,0,0,122900,122300,0,0,0
553.029109,0,545,645,-100,100,122600,122000,30201,244199,219799
553.029109,1,539,631,-92,92,122600,122000,29698,91902,69454
553.029109,2,4918,4951,-33,33,122600,122000,24434,-454634,-462686
553.029109,3,609,702,-93,93,122600,122000,20786,163414,140722
553.029109,4,120,50,70,-70,122600,122000,-2139,-30461,-13381
553.029109,5,3297,3325,-28,28,122600,122000,15563,-282163,-288995
553.029109,6,0,0,0,0,122600,122000,0,0,0
553.209968,0,545,645,-100,100,122700,122000,30201,244199,219799
553.209968,1,539,631,-92,92,122700,122000,29698,91902,69454
553.209968,2,4918,4961,-43,43,122700,122000,24311,-450511,-461003
553.209968,3,609,702,-93,93,122700,122000,20786,163414,140722
553.209968,4,120,50,70,-70,122700,122000,-2139,-30461,-13381
553.209968,5,3297,3325,-28,28,122700,122000,15563,-282163,-288995
553.209968,6,0,0,0,0,122700,122000,0,0,0
553.542527,0,545,645,-100,100,122600,122000,30201,244199,219799
553.542527,1,539,631,-92,92,122600,122000,29698,91902,69454
553.542527,2,4928,4961,-33,33,122600,122000,24188,-455388,-463440
553.542527,3,609,702,-93,93,122600,122000,20786,163414,140722
553.542527,4,120,50,70,-70,122600,122000,-2139,-30461,-13381
553.542527,5,3297,3335,-38,38,122600,122000,15808,-279408,-288680
553.542527,6,0,0,0,0,122600,122000,0,0,0
553.704713,0,545,645,-100,100,122600,122000,30201,244199,219799
553.704713,1,539,631,-92,92,122600,122000,29698,91902,69454
553.704713,2,4928,4961,-33,33,122600,122000,24188,-455388,-463440
553.704713,3,609,702,-93,93,122600,122000,20786,163414,140722
553.704713,4,120,50,70,-70,122600,122000,-2139,-30461,-13381
553.704713,5,3297,3335,-38,38,122600,122000,15808,-279408,-288680
553.704713,6,0,0,0,0,122600,122000,0,0,0
554.050207,0,545,645,-100,100,122600,122000,30201,244199,219799
554.050207,1,539,631,-92,92,122600,122000,29698,91902,69454
554.050207,2,4928,4961,-33,33,122600,122000,24188,-455388,-463440
554.050207,3,609,702,-93,93,122600,122000,20786,163414,140722
554.050207,4,120,50,70,-70,122600,122000,-2139,-30461,-13381
554.050207,5,3297,3335,-38,38,122600,122000,15808,-279408,-288680
554.050207,6,0,0,0,0,122600,122000,0,0,0
554.23013,0,545,645,-100,100,122600,122000,30201,244199,219799
554.23013,1,539,631,-92,92,122600,122000,29698,91902,69454
554.23013,2,4928,4961,-33,33,122600,122000,24188,-455388,-463440
554.23013,3,609,702,-93,93,122600,122000,20786,163414,140722
554.23013,4,120,50,70,-70,122600,122000,-2139,-30461,-13381
554.23013,5,3297,3335,-38,38,122600,122000,15808,-279408,-288680
554.23013,6,0,0,0,0,122600,122000,0,0,0
554.539661,0,545,645,-100,100,122700,122000,30201,244199,219799
554.539661,1,539,631,-92,92,122700,122000,29698,91902,69454
554.539661,2,4928,4971,-43,43,122700,122000,24065,-451265,-461757
554.539661,3,609,702,-93,93,122700,122000,20786,163414,140722
554.539661,4,120,50,70,-70,122700,122000,-2139,-30461,-13381
554.539661,5,3307,3335,-28,28,122700,122000,16053,-285653,-292485
554.539661,6,0,0,0,0,122700,122000,0,0,0
554.782971,0,545,645,-100,100,122600,122000,30201,244199,219799
554.782971,1,539,631,-92,92,122600,122000,29698,91902,69454
554.782971,2,4932,4971,-39,39,122600,122000,24016,-453216,-462732
554.782971,3,609,702,-93,93,122600,122000,20786,163414,140722
554.782971,4,120,50,70,-70,122600,122000,-2139,-30461,-13381
554.782971,5,3307,3335,-28,28,122600,122000,16053,-285653,-292485
554.782971,6,0,0,0,0,122600,122000,0,0,0
555.017588,0,545,645,-100,100,122100,122000,30201,244199,234199
555.017588,1,539,631,-92,92,122100,122000,29698,91902,82702
555.017588,2,4942,4971,-29,29,122100,122000,23894,-457094,-459994
555.017588,3,609,702,-93,93,122100,122000,20786,163414,154114
555.017588,4,120,50,70,-70,122100,122000,-2139,-30461,-23461
555.017588,5,3317,3335,-18,18,122100,122000,15931,-289531,-291331
555.017588,6,0,0,0,0,122100,122000,0,0,0
555.282932,0,545,645,-100,100,122100,122000,30201,244199,234199
555.282932,1,539,631,-92,92,122100,122000,29698,91902,82702
555.282932,2,4942,4971,-29,29,122100,122000,23894,-457094,-459994
555.282932,3,609,702,-93,93,122100,122000,20786,163414,154114
555.282932,4,120,50,70,-70,122100,122000,-2139,-30461,-23461
555.282932,5,3317,3335,-18,18,122100,122000,15931,-289531,-291331
555.282932,6,0,0,0,0,122100,122000,0,0,0
555.472186,0,545,645,-100,100,122100,122100,30201,244199,244199
555.472186,1,539,631,-92,92,122100,122100,29698,91902,91902
555.472186,2,4952,4971,-19,19,122100,122100,23772,-460972,-460972
555.472186,3,609,702,-93,93,122100,122100,20786,163414,163414
555.472186,4,120,50,70,-70,122100,122100,-2139,-30461,-30461
555.472186,5,3327,3335,-8,8,122100,122100,15809,-293409,-293409
555.472186,6,0,0,0,0,122100,122100,0,0,0
555.706601,0,545,645,-100,100,122100,122100,30201,244199,244199
555.706601,1,539,631,-92,92,122100,122100,29698,91902,91902
555.706601,2,4952,4971,-19,19,122100,122100,23772,-460972,-460972
555.706601,3,609,702,-93,93,122100,122100,20786,163414,163414
555.706601,4,120,50,70,-70,122100,122100,-2139,-30461,-30461
555.706601,5,3327,3335,-8,8,122100,122100,15809,-293409,-293409
555.706601,6,0,0,0,0,122100,122100,0,0,0
556.004901,0,545,645,-100,100,122300,122100,30201,244199,224199
556.004901,1,539,631,-92,92,122300,122100,29698,91902,73502
556.004901,2,4955,4971,-16,16,122300,122100,23735,-462135,-465335
556.004901,3,609,702,-93,93,122300,122100,20786,163414,144814
556.004901,4,120,50,70,-70,122300,122100,-2139,-30461,-16461
556.004901,5,3327,3335,-8,8,122300,122100,15809,-293409,-295009
556.004901,6,0,0,0,0,122300,122100,0,0,0
556.299865,0,545,645,-100,100,122300,122100,30201,244199,224199
556.299865,1,539,631,-92,92,122300,122100,29698,91902,73502
556.299865,2,4955,4971,-16,16,122300,122100,23735,-462135,-465335
556.299865,3,609,702,-93,93,122300,122100,20786,163414,144814
556.299865,4,120,50,70,-70,122300,122100,-2139,-30461,-16461
556.299865,5,3327,3335,-8,8,122300,122100,15809,-293409,-295009
556.299865,6,0,0,0,0,122300,122100,0,0,0
556.499994,0,545,645,-100,100,122300,121600,30201,244199,219899
556.499994,1,539,631,-92,92,122300,121600,29698,91902,69546
556.499994,2,4955,4971,-16,16,122300,121600,23735,-462135,-466023
556.499994,3,609,702,-93,93,122300,121600,20786,163414,140815
556.499994,4,120,50,70,-70,122300,121600,-2139,-30461,-13451
556.499994,5,3327,3335,-8,8,122300,121600,15809,-293409,-295353
556.499994,6,0,0,0,0,122300,121600,0,0,0
556.79295,0,545,645,-100,100,122100,121600,30201,244199,219899
556.79295,1,539,631,-92,92,122100,121600,29698,91902,69546
556.79295,2,4955,4981,-26,26,122100,121600,23979,-457379,-463697
556.79295,3,609,702,-93,93,122100,121600,20786,163414,140815
556.79295,4,120,50,70,-70,122100,121600,-2139,-30461,-13451
556.79295,5,3327,3335,-8,8,122100,121600,15809,-293409,-295353
556.79295,6,0,0,0,0,122100,121600,0,0,0
556.977454,0,545,645,-100,100,122100,121600,30201,244199,219899
556.977454,1,539,631,-92,92,122100,121600,29698,91902,69546
556.977454,2,4955,4991,-36,36,122100,121600,24223,-453623,-462371
556.977454,3,609,702,-93,93,122100,121600,20786,163414,140815
556.977454,4,120,50,70,-70,122100,121600,-2139,-30461,-13451
556.977454,5,3327,3335,-8,8,122100,121600,15809,-293409,-295353
556.977454,6,0,0,0,0,122100,121600,0,0,0
557.206342,0,545,645,-100,100,122300,121600,30201,244199,219899
557.206342,1,539,631,-92,92,122300,121600,29698,91902,69546
557.206342,2,4955,5001,-46,46,122300,121600,24467,-450867,-462045
557.206342,3,609,702,-93,93,122300,121600,20786,163414,140815
557.206342,4,120,50,70,-70,122300,121600,-2139,-30461,-13451
557.206342,5,3327,3345,-18,18,122300,121600,16053,-290653,-295027
557.206342,6,0,0,0,0,122300,121600,0,0,0
557.513273,0,545,645,-100,100,122200,121800,30201,244199,219799
557.513273,1,539,631,-92,92,122200,121800,29698,91902,69454
557.513273,2,4965,5001,-36,36,122200,121800,24711,-456111,-464895
557.513273,3,609,702,-93,93,122200,121800,20786,163414,140722
557.513273,4,120,50,70,-70,122200,121800,-2139,-30461,-13381
557.513273,5,3327,3355,-28,28,122200,121800,15931,-287531,-294363
557.513273,6,0,0,0,0,122200,121800,0,0,0
557.709437,0,545,645,-100,100,122200,121900,30201,244199,219799
557.709437,1,539,631,-92,92,122200,121900,29698,91902,69454
557.709437,2,4965,5001,-36,36,122200,121900,24711,-456111,-464895
557.709437,3,609,702,-93,93,122200,121900,20786,163414,140722
557.709437,4,120,50,70,-70,122200,121900,-2139,-30461,-13381
557.709437,5,3327,3355,-28,28,122200,121900,15931,-287531,-294363
557.709437,6,0,0,0,0,122200,121900,0,0,0
557.981683,0,545,645,-100,100,122200,121900,30201,244199,219799
557.981683,1,539,631,-92,92,122200,121900,29698,91902,69454
557.981683,2,4965,5001,-36,36,122200,121900,24711,-456111,-464895
557.981683,3,609,702,-93,93,122200,121900,20786,163414,140722
557.981683,4,120,50,70,-70,122200,121900,-2139,-30461,-13381
557.981683,5,3327,3355,-28,28,122200,121900,15931,-287531,-294363
557.981683,6,0,0,0,0,122200,121900,0,0,0
558.228416,0,545,645,-100,100,122300,121800,30201,244199,219799
558.228416,1,539,631,-92,92,122300,121800,29698,91902,69454
558.228416,2,4975,5001,-26,26,122300,121800,24956,-462356,-468700
558.228416,3,609,702,-93,93,122300,121800,20786,163414,140722
558.228416,4,120,50,70,-70,122300,121800,-2139,-30461,-13381
558.228416,5,3327,3355,-28,28,122300,121800,15931,-287531,-294363
558.228416,6,0,0,0,0,122300,121800,0,0,0
558.509606,0,545,645,-100,100,122300,121800,30201,244199,219799
558.509606,1,539,631,-92,92,122300,121800,29698,91902,69454
558.509606,2,4975,5001,-26,26,122300,121800,24956,-462356,-468700
558.509606,3,609,702,-93,93,122300,121800,20786,163414,140722
558.509606,4,120,50,70,-70,122300,121800,-2139,-30461,-13381
558.509606,5,3327,3355,-28,28,122300,121800,15931,-287531,-294363
558.509606,6,0,0,0,0,122300,121800,0,0,0
558.714522,0,545,645,-100,100,122300,121800,30201,244199,219799
558.714522,1,539,631,-92,92,122300,121800,29698,91902,69454
558.714522,2,4975,5001,-26,26,122300,121800,24956,-462356,-468700
558.714522,3,609,702,-93,93,122300,121800,20786,163414,140722
558.714522,4,120,50,70,-70,122300,121800,-2139,-30461,-13381
558.714522,5,3327,3355,-28,28,122300,121800,15931,-287531,-294363
558.714522,6,0,0,0,0,122300,121800,0,0,0
559.043235,0,545,645,-100,100,122300,121800,30201,244199,219799
559.043235,1,539,631,-92,92,122300,121800,29698,91902,69454
559.043235,2,4975,5001,-26,26,122300,121800,24956,-462356,-468700
559.043235,3,609,702,-93,93,122300,121800,20786,163414,140722
559.043235,4,120,50,70,-70,122300,121800,-2139,-30461,-13381
559.043235,5,3327,3355,-28,28,122300,121800,15931,-287531,-294363
559.043235,6,0,0,0,0,122300,121800,0,0,0
559.207917,0,545,645,-100,100,122100,121600,30201,244199,219899
559.207917,1,539,631,-92,92,122100,121600,29698,91902,69546
559.207917,2,4975,5011,-36,36,122100,121600,25200,-459600,-468348
559.207917,3,609,702,-93,93,122100,121600,20786,163414,140815
559.207917,4,120,50,70,-70,122100,121600,-2139,-30461,-13451
559.207917,5,3327,3365,-38,38,122100,121600,16175,-284775,-294009
559.207917,6,0,0,0,0,122100,121600,0,0,0
559.473053,0,545,645,-100,100,122000,121500,30201,244199,219899
559.473053,1,539,631,-92,92,122000,121500,29698,91902,69546
559.473053,2,4975,5021,-46,46,122000,121500,25444,-454844,-466022
559.473053,3,609,702,-93,93,122000,121500,20786,163414,140815
559.473053,4,120,50,70,-70,122000,121500,-2139,-30461,-13451
559.473053,5,3327,3365,-38,38,122000,121500,16175,-284775,-294009
559.473053,6,0,0,0,0,122000,121500,0,0,0
559.703131,0,545,645,-100,100,121800,121500,30201,244199,219899
559.703131,1,539,631,-92,92,121800,121500,29698,91902,69546
559.703131,2,4985,5021,-36,36,121800,121500,25322,-460722,-469470
559.703131,3,609,702,-93,93,121800,121500,20786,163414,140815
559.703131,4,120,50,70,-70,121800,121500,-2139,-30461,-13451
559.703131,5,3337,3365,-28,28,121800,121500,16053,-290653,-297457
559.703131,6,0,0,0,0,121800,121500,0,0,0
560.022552,0,545,645,-100,100,121700,121500,30201,244199,224199
560.022552,1,539,631,-92,92,121700,121500,29698,91902,73502
560.022552,2,4985,5031,-46,46,121700,121500,25565,-456965,-466165
560.022552,3,609,702,-93,93,121700,121500,20786,163414,144814
560.022552,4,120,50,70,-70,121700,121500,-2139,-30461,-16461
560.022552,5,3337,3365,-28,28,121700,121500,16053,-290653,-296253
560.022552,6,0,0,0,0,121700,121500,0,0,0
560.217809,0,545,645,-100,100,121700,121500,30201,244199,224199
560.217809,1,539,631,-92,92,121700,121500,29698,91902,73502
560.217809,2,4985,5031,-46,46,121700,121500,25565,-456965,-466165
560.217809,3,609,702,-93,93,121700,121500,20786,163414,144814
560.217809,4,120,50,70,-70,121700,121500,-2139,-30461,-16461
560.217809,5,3337,3365,-28,28,121700,121500,16053,-290653,-296253
560.217809,6,0,0,0,0,121700,121500,0,0,0
560.516668,0,545,645,-100,100,121500,121000,30201,244199,219999
560.516668,1,539,631,-92,92,121500,121000,29698,91902,69638
560.516668,2,4995,5041,-46,46,121500,121000,25686,-457086,-468218
560.516668,3,609,702,-93,93,121500,121000,20786,163414,140908
560.516668,4,120,50,70,-70,121500,121000,-2139,-30461,-13521
560.516668,5,3337,3365,-28,28,121500,121000,16053,-290653,-297429
560.516668,6,0,0,0,0,121500,121000,0,0,0
560.78265,0,545,645,-100,100,121500,121100,30201,244199,219999
560.78265,1,539,631,-92,92,121500,121100,29698,91902,69638
560.78265,2,5005,5041,-36,36,121500,121100,25929,-462329,-471041
560.78265,3,609,702,-93,93,121500,121100,20786,163414,140908
560.78265,4,120,50,70,-70,121500,121100,-2139,-30461,-13521
560.78265,5,3337,3365,-28,28,121500,121100,16053,-290653,-297429
560.78265,6,0,0,0,0,121500,121100,0,0,0
561.031362,0,545,645,-100,100,121500,121100,30201,244199,219999
561.031362,1,539,631,-92,92,121500,121100,29698,91902,69638
561.031362,2,5009,5041,-32,32,121500,121100,25880,-463480,-471224
561.031362,3,609,702,-93,93,121500,121100,20786,163414,140908
561.031362,4,120,50,70,-70,121500,121100,-2139,-30461,-13521
561.031362,5,3337,3365,-28,28,121500,121100,16053,-290653,-297429
561.031362,6,0,0,0,0,121500,121100,0,0,0
561.205895,0,545,645,-100,100,121400,121100,30201,244199,219999
561.205895,1,539,631,-92,92,121400,121100,29698,91902,69638
561.205895,2,5015,5041,-26,26,121400,121100,25807,-465807,-472099
561.205895,3,609,702,-93,93,121400,121100,20786,163414,140908
561.205895,4,120,50,70,-70,121400,121100,-2139,-30461,-13521
561.205895,5,3337,3371,-34,34,121400,121100,16199,-289599,-297827
561.205895,6,0,0,0,0,121400,121100,0,0,0
561.550009,0,545,645,-100,100,121400,121300,30201,244199,234199
561.550009,1,539,631,-92,92,121400,121300,29698,91902,82702
561.550009,2,5025,5041,-16,16,121400,121300,25685,-468685,-470285
561.550009,3,609,702,-93,93,121400,121300,20786,163414,154114
561.550009,4,120,50,70,-70,121400,121300,-2139,-30461,-23461
561.550009,5,3347,3371,-24,24,121400,121300,16077,-292477,-294877
561.550009,6,0,0,0,0,121400,121300,0,0,0
561.724725,0,545,645,-100,100,121400,121300,30201,244199,234199
561.724725,1,539,631,-92,92,121400,121300,29698,91902,82702
561.724725,2,5025,5041,-16,16,121400,121300,25685,-468685,-470285
561.724725,3,609,702,-93,93,121400,121300,20786,163414,154114
561.724725,4,120,50,70,-70,121400,121300,-2139,-30461,-23461
561.724725,5,3347,3371,-24,24,121400,121300,16077,-292477,-294877
561.724725,6,0,0,0,0,121400,121300,0,0,0
561.972794,0,545,645,-100,100,121400,121300,30201,244199,234199
561.972794,1,539,631,-92,92,121400,121300,29698,91902,82702
561.972794,2,5025,5041,-16,16,121400,121300,25685,-468685,-470285
561.972794,3,609,702,-93,93,121400,121300,20786,163414,154114
561.972794,4,120,50,70,-70,121400,121300,-2139,-30461,-23461
561.972794,5,3347,3371,-24,24,121400,121300,16077,-292477,-294877
561.972794,6,0,0,0,0,121400,121300,0,0,0
562.221104,0,545,645,-100,100,121400,121300,30201,244199,234199
562.221104,1,539,631,-92,92,121400,121300,29698,91902,82702
562.221104,2,5025,5041,-16,16,121400,121300,25685,-468685,-470285
562.221104,3,609,702,-93,93,121400,121300,20786,163414,154114
562.221104,4,120,50,70,-70,121400,121300,-2139,-30461,-23461
562.221104,5,3347,3371,-24,24,121400,121300,16077,-292477,-294877
562.221104,6,0,0,0,0,121400,121300,0,0,0
562.519648,0,545,645,-100,100,121400,121500,30201,244199,254199
562.519648,1,539,631,-92,92,121400,121500,29698,91902,101102
562.519648,2,5025,5041,-16,16,121400,121500,25685,-468685,-467085
562.519648,3,609,702,-93,93,121400,121500,20786,163414,172714
562.519648,4,120,50,70,-70,121400,121500,-2139,-30461,-37461
562.519648,5,3347,3371,-24,24,121400,121500,16077,-292477,-290077
562.519648,6,0,0,0,0,121400,121500,0,0,0
562.770581,0,545,645,-100,100,121900,121500,30201,244199,219899
562.770581,1,539,631,-92,92,121900,121500,29698,91902,69546
562.770581,2,5025,5059,-34,34,121900,121500,25465,-466865,-475127
562.770581,3,617,702,-85,85,121900,121500,20981,160819,140164
562.770581,4,120,50,70,-70,121900,121500,-2139,-30461,-13451
562.770581,5,3357,3371,-14,14,121900,121500,16320,-293720,-297122
562.770581,6,0,0,0,0,121900,121500,0,0,0
562.999456,0,545,645,-100,100,121300,121500,30201,244199,264199
562.999456,1,539,631,-92,92,121300,121500,29698,91902,110302
562.999456,2,5035,5069,-34,34,121300,121500,25221,-466621,-459821
562.999456,3,617,704,-87,87,121300,121500,20957,161443,178843
562.999456,4,120,50,70,-70,121300,121500,-2139,-30461,-44461
562.999456,5,3367,3381,-14,14,121300,121500,16076,-291476,-288676
562.999456,6,0,0,0,0,121300,121500,0,0,0
563.269008,0,545,645,-100,100,121700,121500,30201,244199,224199
563.269008,1,539,631,-92,92,121700,121500,29698,91902,73502
563.269008,2,5045,5069,-24,24,121700,121500,25465,-470865,-475665
563.269008,3,617,704,-87,87,121700,121500,20957,161443,144043
563.269008,4,120,50,70,-70,121700,121500,-2139,-30461,-16461
563.269008,5,3377,3391,-14,14,121700,121500,15832,-289232,-292032
563.269008,6,0,0,0,0,121700,121500,0,0,0
563.508149,0,575,645,-70,70,122000,121700,30929,248871,231861
563.508149,1,539,631,-92,92,122000,121700,29698,91902,69546
563.508149,2,5055,5069,-14,14,122000,121700,25708,-469108,-472510
563.508149,3,625,705,-80,80,122000,121700,21140,158360,138920
563.508149,4,120,50,70,-70,122000,121700,-2139,-30461,-13451
563.508149,5,3387,3399,-12,12,122000,121700,15977,-284977,-287893
563.508149,6,0,0,0,0,122000,121700,0,0,0
563.766088,0,575,645,-70,70,122000,121800,30929,248871,234871
563.766088,1,539,631,-92,92,122000,121800,29698,91902,73502
563.766088,2,5055,5074,-19,19,122000,121800,25647,-468047,-471847
563.766088,3,632,705,-73,73,122000,121800,21311,156089,141489
563.766088,4,120,50,70,-70,122000,121800,-2139,-30461,-16461
563.766088,5,3387,3401,-14,14,122000,121800,15953,-284553,-287353
563.766088,6,0,0,0,0,122000,121800,0,0,0
564.03043,0,575,645,-70,70,122300,121800,30929,248871,231791
564.03043,1,539,631,-92,92,122300,121800,29698,91902,69454
564.03043,2,5055,5079,-24,24,122300,121800,25586,-467986,-473842
564.03043,3,632,707,-75,75,122300,121800,21287,156313,138013
564.03043,4,120,50,70,-70,122300,121800,-2139,-30461,-13381
564.03043,5,3387,3401,-14,14,122300,121800,15953,-284553,-287969
564.03043,6,0,0,0,0,122300,121800,0,0,0
564.296196,0,575,645,-70,70,122300,121800,30929,248871,231791
564.296196,1,539,631,-92,92,122300,121800,29698,91902,69454
564.296196,2,5055,5079,-24,24,122300,121800,25586,-467986,-473842
564.296196,3,632,707,-75,75,122300,121800,21287,156313,138013
564.296196,4,120,50,70,-70,122300,121800,-2139,-30461,-13381
564.296196,5,3387,3401,-14,14,122300,121800,15953,-284553,-287969
564.296196,6,0,0,0,0,122300,121800,0,0,0
564.474347,0,575,655,-80,80,122100,121800,31173,250627,231107
564.474347,1,539,631,-92,92,122100,121800,29698,91902,69454
564.474347,2,5065,5079,-14,14,122100,121800,25464,-470864,-474280
564.474347,3,632,707,-75,75,122100,121800,21287,156313,138013
564.474347,4,120,50,70,-70,122100,121800,-2139,-30461,-13381
564.474347,5,3387,3401,-14,14,122100,121800,15953,-284553,-287969
564.474347,6,0,0,0,0,122100,121800,0,0,0
564.715538,0,575,655,-80,80,122500,121800,31173,250627,231107
564.715538,1,539,631,-92,92,122500,121800,29698,91902,69454
564.715538,2,5065,5089,-24,24,122500,121800,25342,-468742,-474598
564.715538,3,632,709,-77,77,122500,121800,21263,156937,138149
564.715538,4,120,50,70,-70,122500,121800,-2139,-30461,-13381
564.715538,5,3387,3411,-24,24,122500,121800,15831,-282431,-288287
564.715538,6,0,0,0,0,122500,121800,0,0,0
565.03833,0,575,655,-80,80,122500,121800,31173,250627,231107
565.03833,1,539,631,-92,92,122500,121800,29698,91902,69454
565.03833,2,5065,5089,-24,24,122500,121800,25342,-468742,-474598
565.03833,3,632,709,-77,77,122500,121800,21263,156937,138149
565.03833,4,120,50,70,-70,122500,121800,-2139,-30461,-13381
565.03833,5,3387,3411,-24,24,122500,121800,15831,-282431,-288287
565.03833,6,0,0,0,0,122500,121800,0,0,0
565.252468,0,575,665,-90,90,122200,122000,31417,252383,234383
565.252468,1,539,631,-92,92,122200,122000,29698,91902,73502
565.252468,2,5075,5089,-14,14,122200,122000,25220,-471620,-474420
565.252468,3,632,709,-77,77,122200,122000,21263,156937,141537
565.252468,4,120,50,70,-70,122200,122000,-2139,-30461,-16461
565.252468,5,3387,3411,-24,24,122200,122000,15831,-282431,-287231
565.252468,6,0,0,0,0,122200,122000,0,0,0
565.522142,0,575,665,-90,90,122200,122200,31417,252383,252383
565.522142,1,539,631,-92,92,122200,122200,29698,91902,91902
565.522142,2,5075,5089,-14,14,122200,122200,25220,-471620,-471620
565.522142,3,632,709,-77,77,122200,122200,21263,156937,156937
565.522142,4,120,50,70,-70,122200,122200,-2139,-30461,-30461
565.522142,5,3387,3411,-24,24,122200,122200,15831,-282431,-282431
565.522142,6,0,0,0,0,122200,122200,0,0,0
565.736617,0,575,665,-90,90,122300,122200,31417,252383,243383
565.736617,1,539,631,-92,92,122300,122200,29698,91902,82702
565.736617,2,5085,5089,-4,4,122300,122200,25465,-472865,-473265
565.736617,3,639,711,-72,72,122300,122200,21410,155890,148690
565.736617,4,120,50,70,-70,122300,122200,-2139,-30461,-23461
565.736617,5,3397,3411,-14,14,122300,122200,16076,-283676,-285076
565.736617,6,0,0,0,0,122300,122200,0,0,0
566.032056,0,575,665,-90,90,122300,122200,31417,252383,243383
566.032056,1,539,631,-92,92,122300,122200,29698,91902,82702
566.032056,2,5085,5089,-4,4,122300,122200,25465,-472865,-473265
566.032056,3,639,711,-72,72,122300,122200,21410,155890,148690
566.032056,4,120,50,70,-70,122300,122200,-2139,-30461,-23461
566.032056,5,3397,3411,-14,14,122300,122200,16076,-283676,-285076
566.032056,6,0,0,0,0,122300,122200,0,0,0
566.253703,0,575,665,-90,90,122300,122200,31417,252383,243383
566.253703,1,539,631,-92,92,122300,122200,29698,91902,82702
566.253703,2,5085,5089,-4,4,122300,122200,25465,-472865,-473265
566.253703,3,639,711,-72,72,122300,122200,21410,155890,148690
566.253703,4,120,50,70,-70,122300,122200,-2139,-30461,-23461
566.253703,5,3397,3411,-14,14,122300,122200,16076,-283676,-285076
566.253703,6,0,0,0,0,122300,122200,0,0,0
566.472754,0,575,665,-90,90,122300,122100,31417,252383,234383
566.472754,1,539,631,-92,92,122300,122100,29698,91902,73502
566.472754,2,5085,5089,-4,4,122300,122100,25465,-472865,-473665
566.472754,3,639,711,-72,72,122300,122100,21410,155890,141490
566.472754,4,120,50,70,-70,122300,122100,-2139,-30461,-16461
566.472754,5,3397,3411,-14,14,122300,122100,16076,-283676,-286476
566.472754,6,0,0,0,0,122300,122100,0,0,0
566.765597,0,575,665,-90,90,122700,122100,31417,252383,230423
566.765597,1,539,631,-92,92,122700,122100,29698,91902,69454
566.765597,2,5085,5109,-24,24,122700,122100,25404,-469304,-475160
566.765597,3,639,715,-76,76,122700,122100,21361,157539,138995
566.765597,4,120,50,70,-70,122700,122100,-2139,-30461,-13381
566.765597,5,3397,3431,-34,34,122700,122100,15831,-275431,-283727
566.765597,6,0,0,0,0,122700,122100,0,0,0
567.026349,0,575,665,-90,90,122400,122100,31417,252383,230423
567.026349,1,539,631,-92,92,122400,122100,29698,91902,69454
567.026349,2,5085,5119,-34,34,122400,122100,25649,-466549,-474845
567.026349,3,639,715,-76,76,122400,122100,21361,157539,138995
567.026349,4,120,50,70,-70,122400,122100,-2139,-30461,-13381
567.026349,5,3407,3431,-24,24,122400,122100,15709,-280309,-286165
567.026349,6,0,0,0,0,122400,122100,0,0,0
567.271409,0,575,665,-90,90,122300,122100,31417,252383,234383
567.271409,1,539,631,-92,92,122300,122100,29698,91902,73502
567.271409,2,5095,5119,-24,24,122300,122100,25527,-469427,-474227
567.271409,3,639,715,-76,76,122300,122100,21361,157539,142339
567.271409,4,120,50,70,-70,122300,122100,-2139,-30461,-16461
567.271409,5,3417,3431,-14,14,122300,122100,15587,-283187,-285987
567.271409,6,0,0,0,0,122300,122100,0,0,0
567.476248,0,575,665,-90,90,122300,122100,31417,252383,234383
567.476248,1,539,631,-92,92,122300,122100,29698,91902,73502
567.476248,2,5095,5119,-24,24,122300,122100,25527,-469427,-474227
567.476248,3,639,715,-76,76,122300,122100,21361,157539,142339
567.476248,4,120,50,70,-70,122300,122100,-2139,-30461,-16461
567.476248,5,3417,3431,-14,14,122300,122100,15587,-283187,-285987
567.476248,6,0,0,0,0,122300,122100,0,0,0
567.742972,0,575,665,-90,90,122400,122100,31417,252383,230423
567.742972,1,539,631,-92,92,122400,122100,29698,91902,69454
567.742972,2,5105,5119,-14,14,122400,122100,25772,-472672,-476088
567.742972,3,639,715,-76,76,122400,122100,21361,157539,138995
567.742972,4,120,50,70,-70,122400,122100,-2139,-30461,-13381
567.742972,5,3417,3441,-24,24,122400,122100,15465,-281065,-286921
567.742972,6,0,0,0,0,122400,122100,0,0,0
567.98994,0,575,665,-90,90,122800,122100,31417,252383,230423
567.98994,1,539,631,-92,92,122800,122100,29698,91902,69454
567.98994,2,5105,5129,-24,24,122800,122100,25650,-470550,-476406
567.98994,3,639,717,-78,78,122800,122100,21337,158163,139131
567.98994,4,120,50,70,-70,122800,122100,-2139,-30461,-13381
567.98994,5,3417,3451,-34,34,122800,122100,15342,-276942,-285238
567.98994,6,0,0,0,0,122800,122100,0,0,0
568.223356,0,575,665,-90,90,122400,122100,31417,252383,230423
568.223356,1,539,631,-92,92,122400,122100,29698,91902,69454
568.223356,2,5109,5129,-20,20,122400,122100,25601,-471701,-476581
568.223356,3,639,717,-78,78,122400,122100,21337,158163,139131
568.223356,4,120,50,70,-70,122400,122100,-2139,-30461,-13381
568.223356,5,3427,3451,-24,24,122400,122100,15220,-279820,-285676
568.223356,6,0,0,0,0,122400,122100,0,0,0
568.45691,0,575,665,-90,90,122300,122100,31417,252383,234383
568.45691,1,539,631,-92,92,122300,122100,29698,91902,73502
568.45691,2,5119,5139,-20,20,122300,122100,25357,-472457,-476457
568.45691,3,639,717,-78,78,122300,122100,21337,158163,142563
568.45691,4,120,50,70,-70,122300,122100,-2139,-30461,-16461
568.45691,5,3437,3451,-14,14,122300,122100,15465,-284065,-286865
568.45691,6,0,0,0,0,122300,122100,0,0,0
568.712378,0,575,665,-90,90,122000,122100,31417,252383,261383
568.712378,1,539,631,-92,92,122000,122100,29698,91902,101102
568.712378,2,5129,5139,-10,10,122000,122100,25601,-473701,-472701
568.712378,3,639,717,-78,78,122000,122100,21337,158163,165963
568.712378,4,120,50,70,-70,122000,122100,-2139,-30461,-37461
568.712378,5,3447,3451,-4,4,122000,122100,15709,-285309,-284909
568.712378,6,0,0,0,0,122000,122100,0,0,0
568.966087,0,575,665,-90,90,121400,122100,31417,252383,274343
568.966087,1,539,631,-92,92,121400,122100,29698,91902,114350
568.966087,2,5139,5139,0,0,121400,122100,25845,-473945,-473945
568.966087,3,655,717,-62,62,121400,122100,21655,158445,173573
568.966087,4,120,50,70,-70,121400,122100,-2139,-30461,-47541
568.966087,5,3457,3451,6,-6,121400,122100,15953,-285553,-287017
568.966087,6,0,0,0,0,121400,122100,0,0,0
569.236789,0,575,665,-90,90,121600,122200,31417,252383,274343
569.236789,1,539,631,-92,92,121600,122200,29698,91902,114350
569.236789,2,5149,5139,10,-10,121600,122200,25796,-472896,-475336
569.236789,3,657,717,-60,60,121600,122200,21631,159269,173909
569.236789,4,120,50,70,-70,121600,122200,-2139,-30461,-47541
569.236789,5,3467,3451,16,-16,121600,122200,15831,-283431,-287335
569.236789,6,0,0,0,0,121600,122200,0,0,0
569.515622,0,575,665,-90,90,122800,122200,31417,252383,230423
569.515622,1,539,631,-92,92,122800,122200,29698,91902,69454
569.515622,2,5149,5159,-10,10,122800,122200,25552,-474652,-477092
569.515622,3,667,717,-50,50,122800,122200,21875,158025,145825
569.515622,4,120,50,70,-70,122800,122200,-2139,-30461,-13381
569.515622,5,3477,3461,16,-16,122800,122200,15953,-283553,-279649
569.515622,6,0,0,0,0,122800,122200,0,0,0
569.769117,0,575,665,-90,90,121600,122200,31417,252383,274343
569.769117,1,539,631,-92,92,121600,122200,29698,91902,114350
569.769117,2,5169,5159,10,-10,121600,122200,25308,-472408,-474848
569.769117,3,669,717,-48,48,121600,122200,21851,158649,170361
569.769117,4,120,50,70,-70,121600,122200,-2139,-30461,-47541
569.769117,5,3487,3461,26,-26,121600,122200,15831,-280431,-286775
569.769117,6,0,0,0,0,121600,122200,0,0,0
569.998345,0,575,665,-90,90,122300,122200,31417,252383,243383
569.998345,1,539,631,-92,92,122300,122200,29698,91902,82702
569.998345,2,5179,5167,12,-12,122300,122200,25088,-471988,-470788
569.998345,3,671,717,-46,46,122300,122200,21827,159273,154673
569.998345,4,120,50,70,-70,122300,122200,-2139,-30461,-23461
569.998345,5,3497,3471,26,-26,122300,122200,15587,-278187,-275587
569.998345,6,0,0,0,0,122300,122200,0,0,0
570.259234,0,575,665,-90,90,122300,122200,31417,252383,243383
570.259234,1,539,631,-92,92,122300,122200,29698,91902,82702
570.259234,2,5179,5167,12,-12,122300,122200,25088,-471988,-470788
570.259234,3,671,717,-46,46,122300,122200,21827,159273,154673
570.259234,4,120,50,70,-70,122300,122200,-2139,-30461,-23461
570.259234,5,3497,3471,26,-26,122300,122200,15587,-278187,-275587
570.259234,6,0,0,0,0,122300,122200,0,0,0
570.533351,0,575,665,-90,90,122900,122200,31417,252383,230423
570.533351,1,539,631,-92,92,122900,122200,29698,91902,69454
570.533351,2,5189,5177,12,-12,122900,122200,25211,-472511,-469583
570.533351,3,679,717,-38,38,122900,122200,22023,159077,149805
570.533351,4,120,50,70,-70,122900,122200,-2139,-30461,-13381
570.533351,5,3497,3481,16,-16,122900,122200,15465,-280065,-276161
570.533351,6,0,0,0,0,122900,122200,0,0,0
570.743538,0,575,665,-90,90,122600,122200,31417,252383,230423
570.743538,1,539,631,-92,92,122600,122200,29698,91902,69454
570.743538,2,5189,5181,8,-8,122600,122200,25162,-472862,-470910
570.743538,3,683,717,-34,34,122600,122200,22121,158579,150283
570.743538,4,120,50,70,-70,122600,122200,-2139,-30461,-13381
570.743538,5,3497,3481,16,-16,122600,122200,15465,-280065,-276161
570.743538,6,0,0,0,0,122600,122200,0,0,0
571.017661,0,575,665,-90,90,122600,122500,31417,252383,243383
571.017661,1,539,631,-92,92,122600,122500,29698,91902,82702
571.017661,2,5189,5181,8,-8,122600,122500,25162,-472862,-472062
571.017661,3,683,717,-34,34,122600,122500,22121,158579,155179
571.017661,4,120,50,70,-70,122600,122500,-2139,-30461,-23461
571.017661,5,3497,3481,16,-16,122600,122500,15465,-280065,-278465
571.017661,6,0,0,0,0,122600,122500,0,0,0
571.243107,0,575,665,-90,90,122600,122400,31417,252383,234383
571.243107,1,539,631,-92,92,122600,122400,29698,91902,73502
571.243107,2,5189,5181,8,-8,122600,122400,25162,-472862,-471262
571.243107,3,683,717,-34,34,122600,122400,22121,158579,151779
571.243107,4,120,50,70,-70,122600,122400,-2139,-30461,-16461
571.243107,5,3497,3481,16,-16,122600,122400,15465,-280065,-276865
571.243107,6,0,0,0,0,122600,122400,0,0,0
571.48082,0,575,665,-90,90,122600,122400,31417,252383,234383
571.48082,1,539,631,-92,92,122600,122400,29698,91902,73502
571.48082,2,5189,5181,8,-8,122600,122400,25162,-472862,-471262
571.48082,3,683,717,-34,34,122600,122400,22121,158579,151779
571.48082,4,120,50,70,-70,122600,122400,-2139,-30461,-16461
571.48082,5,3497,3481,16,-16,122600,122400,15465,-280065,-276865
571.48082,6,0,0,0,0,122600,122400,0,0,0
571.776422,0,575,665,-90,90,122500,122400,31417,252383,243383
571.776422,1,539,631,-92,92,122500,122400,29698,91902,82702
571.776422,2,5189,5191,-2,2,122500,122400,25040,-472740,-472940
571.776422,3,683,717,-34,34,122500,122400,22121,158579,155179
571.776422,4,120,50,70,-70,122500,122400,-2139,-30461,-23461
571.776422,5,3497,3481,16,-16,122500,122400,15465,-280065,-278465
571.776422,6,0,0,0,0,122500,122400,0,0,0
571.957217,0,575,665,-90,90,122500,122400,31417,252383,243383
571.957217,1,539,631,-92,92,122500,122400,29698,91902,82702
571.957217,2,5189,5201,-12,12,122500,122400,25285,-471985,-473185
571.957217,3,683,717,-34,34,122500,122400,22121,158579,155179
571.957217,4,120,50,70,-70,122500,122400,-2139,-30461,-23461
571.957217,5,3497,3481,16,-16,122500,122400,15465,-280065,-278465
571.957217,6,0,0,0,0,122500,122400,0,0,0
572.228588,0,575,665,-90,90,122500,122400,31417,252383,243383
572.228588,1,539,631,-92,92,122500,122400,29698,91902,82702
572.228588,2,5195,5201,-6,6,122500,122400,25211,-473711,-474311
572.228588,3,683,717,-34,34,122500,122400,22121,158579,155179
572.228588,4,120,50,70,-70,122500,122400,-2139,-30461,-23461
572.228588,5,3497,3491,6,-6,122500,122400,15710,-279310,-278710
572.228588,6,0,0,0,0,122500,122400,0,0,0
572.523015,0,575,665,-90,90,122500,122400,31417,252383,243383
572.523015,1,539,631,-92,92,122500,122400,29698,91902,82702
572.523015,2,5195,5201,-6,6,122500,122400,25211,-473711,-474311
572.523015,3,683,717,-34,34,122500,122400,22121,158579,155179
572.523015,4,120,50,70,-70,122500,122400,-2139,-30461,-23461
572.523015,5,3497,3491,6,-6,122500,122400,15710,-279310,-278710
572.523015,6,0,0,0,0,122500,122400,0,0,0
572.78873,0,575,665,-90,90,122500,122400,31417,252383,243383
572.78873,1,539,631,-92,92,122500,122400,29698,91902,82702
572.78873,2,5195,5201,-6,6,122500,122400,25211,-473711,-474311
572.78873,3,683,717,-34,34,122500,122400,22121,158579,155179
572.78873,4,120,50,70,-70,122500,122400,-2139,-30461,-23461
572.78873,5,3497,3491,6,-6,122500,122400,15710,-279310,-278710
572.78873,6,0,0,0,0,122500,122400,0,0,0
573.020012,0,575,665,-90,90,121800,122500,31417,252383,274433
573.020012,1,539,631,-92,92,121800,122500,29698,91902,114442
573.020012,2,5205,5211,-6,6,121800,122500,24965,-478465,-476995
573.020012,3,688,719,-31,31,121800,122500,22146,157854,165449
573.020012,4,120,50,70,-70,121800,122500,-2139,-30461,-47611
573.020012,5,3507,3494,13,-13,121800,122500,15551,-279851,-283036
573.020012,6,0,0,0,0,121800,122500,0,0,0
573.298482,0,575,665,-90,90,122600,122500,31417,252383,243383
573.298482,1,539,631,-92,92,122600,122500,29698,91902,82702
573.298482,2,5215,5211,4,-4,122600,122500,24842,-479342,-478942
573.298482,3,688,719,-31,31,122600,122500,22146,157854,154754
573.298482,4,120,50,70,-70,122600,122500,-2139,-30461,-23461
573.298482,5,3507,3504,3,-3,122600,122500,15796,-280096,-279796
573.298482,6,0,0,0,0,122600,122500,0,0,0
573.529072,0,575,665,-90,90,122600,122200,31417,252383,230423
573.529072,1,539,631,-92,92,122600,122200,29698,91902,69454
573.529072,2,5215,5211,4,-4,122600,122200,24842,-479342,-478366
573.529072,3,688,719,-31,31,122600,122200,22146,157854,150290
573.529072,4,120,50,70,-70,122600,122200,-2139,-30461,-13381
573.529072,5,3507,3504,3,-3,122600,122200,15796,-280096,-279364
573.529072,6,0,0,0,0,122600,122200,0,0,0
573.738536,0,575,665,-90,90,122600,122200,31417,252383,230423
573.738536,1,539,631,-92,92,122600,122200,29698,91902,69454
573.738536,2,5215,5211,4,-4,122600,122200,24842,-479342,-478366
573.738536,3,688,719,-31,31,122600,122200,22146,157854,150290
573.738536,4,120,50,70,-70,122600,122200,-2139,-30461,-13381
573.738536,5,3507,3504,3,-3,122600,122200,15796,-280096,-279364
573.738536,6,0,0,0,0,122600,122200,0,0,0
573.954663,0,575,665,-90,90,122600,122200,31417,252383,230423
573.954663,1,539,631,-92,92,122600,122200,29698,91902,69454
573.954663,2,5215,5211,4,-4,122600,122200,24842,-479342,-478366
573.954663,3,688,719,-31,31,122600,122200,22146,157854,150290
573.954663,4,120,50,70,-70,122600,122200,-2139,-30461,-13381
573.954663,5,3507,3504,3,-3,122600,122200,15796,-280096,-279364
573.954663,6,0,0,0,0,122600,122200,0,0,0
574.261189,0,575,665,-90,90,122600,122200,31417,252383,230423
574.261189,1,539,631,-92,92,122600,122200,29698,91902,69454
574.261189,2,5215,5211,4,-4,122600,122200,24842,-479342,-478366
574.261189,3,688,719,-31,31,122600,122200,22146,157854,150290
574.261189,4,120,50,70,-70,122600,122200,-2139,-30461,-13381
574.261189,5,3507,3504,3,-3,122600,122200,15796,-280096,-279364
574.261189,6,0,0,0,0,122600,122200,0,0,0
574.533349,0,575,665,-90,90,122700,122200,31417,252383,230423
574.533349,1,539,631,-92,92,122700,122200,29698,91902,69454
574.533349,2,5215,5221,-6,6,122700,122200,24720,-480220,-481684
574.533349,3,688,721,-33,33,122700,122200,22121,158279,150227
574.533349,4,120,50,70,-70,122700,122200,-2139,-30461,-13381
574.533349,5,3507,3504,3,-3,122700,122200,15796,-280096,-279364
574.533349,6,0,0,0,0,122700,122200,0,0,0
574.706845,0,575,675,-100,100,122400,122200,31663,254137,234137
574.706845,1,539,631,-92,92,122400,122200,29698,91902,73502
574.706845,2,5225,5229,-4,4,122400,122200,24794,-478694,-479494
574.706845,3,688,721,-33,33,122400,122200,22121,158279,151679
574.706845,4,120,50,70,-70,122400,122200,-2139,-30461,-16461
574.706845,5,3507,3514,-7,7,122400,122200,16041,-282341,-283741
574.706845,6,0,0,0,0,122400,122200,0,0,0
575.027039,0,575,675,-100,100,122400,122200,31663,254137,234137
575.027039,1,539,631,-92,92,122400,122200,29698,91902,73502
575.027039,2,5225,5229,-4,4,122400,122200,24794,-478694,-479494
575.027039,3,688,721,-33,33,122400,122200,22121,158279,151679
575.027039,4,120,50,70,-70,122400,122200,-2139,-30461,-16461
575.027039,5,3507,3514,-7,7,122400,122200,16041,-282341,-283741
575.027039,6,0,0,0,0,122400,122200,0,0,0
575.237516,0,575,675,-100,100,122400,122200,31663,254137,234137
575.237516,1,539,631,-92,92,122400,122200,29698,91902,73502
575.237516,2,5225,5229,-4,4,122400,122200,24794,-478694,-479494
575.237516,3,688,721,-33,33,122400,122200,22121,158279,151679
575.237516,4,120,50,70,-70,122400,122200,-2139,-30461,-16461
575.237516,5,3507,3514,-7,7,122400,122200,16041,-282341,-283741
575.237516,6,0,0,0,0,122400,122200,0,0,0
575.495682,0,575,675,-100,100,122500,122600,31663,254137,264137
575.495682,1,539,631,-92,92,122500,122600,29698,91902,101102
575.495682,2,5233,5229,4,-4,122500,122600,24696,-479396,-479796
575.495682,3,688,721,-33,33,122500,122600,22121,158279,161579
575.495682,4,120,50,70,-70,122500,122600,-2139,-30461,-37461
575.495682,5,3517,3514,3,-3,122500,122600,15919,-283219,-283519
575.495682,6,0,0,0,0,122500,122600,0,0,0
575.788071,0,575,675,-100,100,122500,122600,31663,254137,264137
575.788071,1,539,631,-92,92,122500,122600,29698,91902,101102
575.788071,2,5233,5229,4,-4,122500,122600,24696,-479396,-479796
575.788071,3,688,721,-33,33,122500,122600,22121,158279,161579
575.788071,4,120,50,70,-70,122500,122600,-2139,-30461,-37461
575.788071,5,3517,3514,3,-3,122500,122600,15919,-283219,-283519
575.788071,6,0,0,0,0,122500,122600,0,0,0
576.040135,0,575,675,-100,100,122500,122600,31663,254137,264137
576.040135,1,539,631,-92,92,122500,122600,29698,91902,101102
576.040135,2,5233,5229,4,-4,122500,122600,24696,-479396,-479796
576.040135,3,688,721,-33,33,122500,122600,22121,158279,161579
576.040135,4,120,50,70,-70,122500,122600,-2139,-30461,-37461
576.040135,5,3517,3514,3,-3,122500,122600,15919,-283219,-283519
576.040135,6,0,0,0,0,122500,122600,0,0,0
576.235816,0,575,675,-100,100,122700,122600,31663,254137,244137
576.235816,1,539,631,-92,92,122700,122600,29698,91902,82702
576.235816,2,5233,5239,-6,6,122700,122600,24573,-478273,-478873
576.235816,3,688,721,-33,33,122700,122600,22121,158279,154979
576.235816,4,120,50,70,-70,122700,122600,-2139,-30461,-23461
576.235816,5,3517,3524,-7,7,122700,122600,15796,-283096,-283796
576.235816,6,0,0,0,0,122700,122600,0,0,0
576.494289,0,575,675,-100,100,122900,122600,31663,254137,229637
576.494289,1,539,631,-92,92,122900,122600,29698,91902,69362
576.494289,2,5233,5249,-16,16,122900,122600,24819,-476519,-480439
576.494289,3,688,721,-33,33,122900,122600,22121,158279,150194
576.494289,4,120,50,70,-70,122900,122600,-2139,-30461,-13311
576.494289,5,3517,3534,-17,17,122900,122600,16042,-281342,-285507
576.494289,6,0,0,0,0,122900,122600,0,0,0
576.789074,0,575,675,-100,100,122900,122500,31663,254137,229637
576.789074,1,539,631,-92,92,122900,122500,29698,91902,69362
576.789074,2,5233,5249,-16,16,122900,122500,24819,-476519,-480439
576.789074,3,688,721,-33,33,122900,122500,22121,158279,150194
576.789074,4,120,50,70,-70,122900,122500,-2139,-30461,-13311
576.789074,5,3517,3534,-17,17,122900,122500,16042,-281342,-285507
576.789074,6,0,0,0,0,122900,122500,0,0,0
577.039808,0,575,675,-100,100,122700,122500,31663,254137,234137
577.039808,1,539,631,-92,92,122700,122500,29698,91902,73502
577.039808,2,5237,5249,-12,12,122700,122500,24770,-477670,-480070
577.039808,3,688,721,-33,33,122700,122500,22121,158279,151679
577.039808,4,120,50,70,-70,122700,122500,-2139,-30461,-16461
577.039808,5,3517,3534,-17,17,122700,122500,16042,-281342,-284742
577.039808,6,0,0,0,0,122700,122500,0,0,0
577.258786,0,575,675,-100,100,122700,122500,31663,254137,234137
577.258786,1,539,631,-92,92,122700,122500,29698,91902,73502
577.258786,2,5237,5249,-12,12,122700,122500,24770,-477670,-480070
577.258786,3,688,721,-33,33,122700,122500,22121,158279,151679
577.258786,4,120,50,70,-70,122700,122500,-2139,-30461,-16461
577.258786,5,3517,3534,-17,17,122700,122500,16042,-281342,-284742
577.258786,6,0,0,0,0,122700,122500,0,0,0
577.506814,0,575,675,-100,100,122600,122700,31663,254137,264137
577.506814,1,539,631,-92,92,122600,122700,29698,91902,101102
577.506814,2,5237,5249,-12,12,122600,122700,24770,-477670,-476470
577.506814,3,688,723,-35,35,122600,122700,22170,158430,161930
577.506814,4,120,50,70,-70,122600,122700,-2139,-30461,-37461
577.506814,5,3519,3534,-15,15,122600,122700,16017,-281717,-280217
577.506814,6,0,0,0,0,122600,122700,0,0,0
577.761893,0,575,675,-100,100,122900,122800,31663,254137,244137
577.761893,1,539,631,-92,92,122900,122800,29698,91902,82702
577.761893,2,5247,5259,-12,12,122900,122800,24893,-480593,-481793
577.761893,3,691,725,-34,34,122900,122800,22219,157781,154381
577.761893,4,120,50,70,-70,122900,122800,-2139,-30461,-23461
577.761893,5,3529,3534,-5,5,122900,122800,16262,-281962,-282462
577.761893,6,0,0,0,0,122900,122800,0,0,0
578.026372,0,605,675,-70,70,122500,122800,32398,259402,276622
578.026372,1,557,631,-74,74,122500,122800,30139,95061,113265
578.026372,2,5257,5259,-2,2,122500,122800,25138,-478838,-478346
578.026372,3,697,725,-28,28,122500,122800,22367,158833,165721
578.026372,4,120,50,70,-70,122500,122800,-2139,-30461,-47681
578.026372,5,3539,3534,5,-5,122500,122800,16507,-280207,-281437
578.026372,6,0,0,0,0,122500,122800,0,0,0
578.24792,0,605,675,-70,70,122500,122700,32398,259402,273402
578.24792,1,557,631,-74,74,122500,122700,30139,95061,109861
578.24792,2,5257,5259,-2,2,122500,122700,25138,-478838,-478438
578.24792,3,697,725,-28,28,122500,122700,22367,158833,164433
578.24792,4,120,50,70,-70,122500,122700,-2139,-30461,-44461
578.24792,5,3539,3534,5,-5,122500,122700,16507,-280207,-281207
578.24792,6,0,0,0,0,122500,122700,0,0,0
578.470043,0,605,675,-70,70,122500,122700,32398,259402,273402
578.470043,1,557,631,-74,74,122500,122700,30139,95061,109861
578.470043,2,5257,5259,-2,2,122500,122700,25138,-478838,-478438
578.470043,3,697,725,-28,28,122500,122700,22367,158833,164433
578.470043,4,120,50,70,-70,122500,122700,-2139,-30461,-44461
578.470043,5,3539,3534,5,-5,122500,122700,16507,-280207,-281207
578.470043,6,0,0,0,0,122500,122700,0,0,0
578.764472,0,605,675,-70,70,122500,122600,32398,259402,266402
578.764472,1,557,631,-74,74,122500,122600,30139,95061,102461
578.764472,2,5257,5259,-2,2,122500,122600,25138,-478838,-478638
578.764472,3,697,725,-28,28,122500,122600,22367,158833,161633
578.764472,4,120,50,70,-70,122500,122600,-2139,-30461,-37461
578.764472,5,3539,3534,5,-5,122500,122600,16507,-280207,-280707
578.764472,6,0,0,0,0,122500,122600,0,0,0
578.969313,0,605,675,-70,70,122500,122600,32398,259402,266402
578.969313,1,557,631,-74,74,122500,122600,30139,95061,102461
578.969313,2,5257,5259,-2,2,122500,122600,25138,-478838,-478638
578.969313,3,697,725,-28,28,122500,122600,22367,158833,161633
578.969313,4,120,50,70,-70,122500,122600,-2139,-30461,-37461
578.969313,5,3539,3534,5,-5,122500,122600,16507,-280207,-280707
578.969313,6,0,0,0,0,122500,122600,0,0,0
579.26748,0,605,675,-70,70,122500,122500,32398,259402,259402
579.26748,1,557,631,-74,74,122500,122500,30139,95061,95061
579.26748,2,5257,5259,-2,2,122500,122500,25138,-478838,-478838
579.26748,3,697,725,-28,28,122500,122500,22367,158833,158833
579.26748,4,120,50,70,-70,122500,122500,-2139,-30461,-30461
579.26748,5,3539,3534,5,-5,122500,122500,16507,-280207,-280207
579.26748,6,0,0,0,0,122500,122500,0,0,0
579.479174,0,605,675,-70,70,123000,122500,32398,259402,242252
579.479174,1,557,631,-74,74,123000,122500,30139,95061,76931
579.479174,2,5264,5279,-15,15,123000,122500,25174,-475574,-479249
579.479174,3,697,729,-32,32,123000,122500,22317,160083,152243
579.479174,4,120,50,70,-70,123000,122500,-2139,-30461,-13311
579.479174,5,3549,3544,5,-5,123000,122500,16261,-282961,-281736
579.479174,6,0,0,0,0,123000,122500,0,0,0
579.764248,0,605,675,-70,70,122000,122500,32398,259402,276552
579.764248,1,557,631,-74,74,122000,122500,30139,95061,113191
579.764248,2,5274,5279,-5,5,122000,122500,25051,-477451,-476226
579.764248,3,699,729,-30,30,122000,122500,22293,160707,168057
579.764248,4,120,50,70,-70,122000,122500,-2139,-30461,-47611
579.764248,5,3559,3544,15,-15,122000,122500,16139,-281839,-285514
579.764248,6,0,0,0,0,122000,122500,0,0,0
579.964565,0,605,675,-70,70,122000,122500,32398,259402,276552
579.964565,1,557,631,-74,74,122000,122500,30139,95061,113191
579.964565,2,5274,5279,-5,5,122000,122500,25051,-477451,-476226
579.964565,3,699,729,-30,30,122000,122500,22293,160707,168057
579.964565,4,120,50,70,-70,122000,122500,-2139,-30461,-47611
579.964565,5,3559,3544,15,-15,122000,122500,16139,-281839,-285514
579.964565,6,0,0,0,0,122000,122500,0,0,0
580.224753,0,605,675,-70,70,122900,122500,32398,259402,242252
580.224753,1,557,631,-74,74,122900,122500,30139,95061,76931
580.224753,2,5274,5279,-5,5,122900,122500,25051,-477451,-478676
580.224753,3,702,729,-27,27,122900,122500,22367,160033,153418
580.224753,4,120,50,70,-70,122900,122500,-2139,-30461,-13311
580.224753,5,3559,3547,12,-12,122900,122500,16102,-281802,-278862
580.224753,6,0,0,0,0,122900,122500,0,0,0
580.490787,0,605,675,-70,70,123100,122500,32398,259402,242252
580.490787,1,557,631,-74,74,123100,122500,30139,95061,76931
580.490787,2,5284,5289,-5,5,123100,122500,24805,-478205,-479430
580.490787,3,702,729,-27,27,123100,122500,22367,160033,153418
580.490787,4,120,50,70,-70,123100,122500,-2139,-30461,-13311
580.490787,5,3559,3557,2,-2,123100,122500,16348,-282048,-281558
580.490787,6,0,0,0,0,123100,122500,0,0,0
580.702707,0,605,675,-70,70,122100,122500,32398,259402,276552
580.702707,1,557,631,-74,74,122100,122500,30139,95061,113191
580.702707,2,5294,5289,5,-5,122100,122500,24682,-480082,-481307
580.702707,3,704,729,-25,25,122100,122500,22343,160457,166582
580.702707,4,120,50,70,-70,122100,122500,-2139,-30461,-47611
580.702707,5,3569,3557,12,-12,122100,122500,16226,-282926,-285866
580.702707,6,0,0,0,0,122100,122500,0,0,0
581.032362,0,605,675,-70,70,122100,122500,32398,259402,276552
581.032362,1,557,631,-74,74,122100,122500,30139,95061,113191
581.032362,2,5294,5289,5,-5,122100,122500,24682,-480082,-481307
581.032362,3,704,729,-25,25,122100,122500,22343,160457,166582
581.032362,4,120,50,70,-70,122100,122500,-2139,-30461,-47611
581.032362,5,3569,3557,12,-12,122100,122500,16226,-282926,-285866
581.032362,6,0,0,0,0,122100,122500,0,0,0
581.258746,0,605,675,-70,70,122400,122500,32398,259402,266402
581.258746,1,557,631,-74,74,122400,122500,30139,95061,102461
581.258746,2,5297,5289,8,-8,122400,122500,24645,-480345,-481145
581.258746,3,704,729,-25,25,122400,122500,22343,160457,162957
581.258746,4,120,50,70,-70,122400,122500,-2139,-30461,-37461
581.258746,5,3569,3557,12,-12,122400,122500,16226,-282926,-284126
581.258746,6,0,0,0,0,122400,122500,0,0,0
581.469847,0,605,675,-70,70,122400,122500,32398,259402,266402
581.469847,1,557,631,-74,74,122400,122500,30139,95061,102461
581.469847,2,5307,5289,18,-18,122400,122500,24523,-480223,-482023
581.469847,3,704,729,-25,25,122400,122500,22343,160457,162957
581.469847,4,120,50,70,-70,122400,122500,-2139,-30461,-37461
581.469847,5,3569,3567,2,-2,122400,122500,16471,-285171,-285371
581.469847,6,0,0,0,0,122400,122500,0,0,0
581.741272,0,605,675,-70,70,122600,122500,32398,259402,252402
581.741272,1,557,631,-74,74,122600,122500,30139,95061,87661
581.741272,2,5307,5299,8,-8,122600,122500,24400,-481100,-480300
581.741272,3,707,729,-22,22,122600,122500,22417,160083,157883
581.741272,4,120,50,70,-70,122600,122500,-2139,-30461,-23461
581.741272,5,3579,3570,9,-9,122600,122500,16679,-286679,-285779
581.741272,6,0,0,0,0,122600,122500,0,0,0
581.976756,0,605,675,-70,70,122800,122500,32398,259402,242252
581.976756,1,557,631,-74,74,122800,122500,30139,95061,76931
581.976756,2,5307,5301,6,-6,122800,122500,24375,-481075,-479605
581.976756,3,711,729,-18,18,122800,122500,22515,158985,154575
581.976756,4,120,50,70,-70,122800,122500,-2139,-30461,-13311
581.976756,5,3579,3572,7,-7,122800,122500,16654,-286454,-284739
581.976756,6,0,0,0,0,122800,122500,0,0,0
582.209355,0,605,675,-70,70,122800,122500,32398,259402,242252
582.209355,1,557,631,-74,74,122800,122500,30139,95061,76931
582.209355,2,5307,5301,6,-6,122800,122500,24375,-481075,-479605
582.209355,3,711,729,-18,18,122800,122500,22515,158985,154575
582.209355,4,120,50,70,-70,122800,122500,-2139,-30461,-13311
582.209355,5,3579,3572,7,-7,122800,122500,16654,-286454,-284739
582.209355,6,0,0,0,0,122800,122500,0,0,0
582.520043,0,605,675,-70,70,122800,122500,32398,259402,242252
582.520043,1,557,631,-74,74,122800,122500,30139,95061,76931
582.520043,2,5307,5301,6,-6,122800,122500,24375,-481075,-479605
582.520043,3,711,729,-18,18,122800,122500,22515,158985,154575
582.520043,4,120,50,70,-70,122800,122500,-2139,-30461,-13311
582.520043,5,3579,3572,7,-7,122800,122500,16654,-286454,-284739
582.520043,6,0,0,0,0,122800,122500,0,0,0
582.717047,0,605,675,-70,70,122800,122500,32398,259402,242252
582.717047,1,557,631,-74,74,122800,122500,30139,95061,76931
582.717047,2,5307,5301,6,-6,122800,122500,24375,-481075,-479605
582.717047,3,711,729,-18,18,122800,122500,22515,158985,154575
582.717047,4,120,50,70,-70,122800,122500,-2139,-30461,-13311
582.717047,5,3579,3572,7,-7,122800,122500,16654,-286454,-284739
582.717047,6,0,0,0,0,122800,122500,0,0,0
582.985443,0,605,675,-70,70,122800,122500,32398,259402,242252
582.985443,1,557,631,-74,74,122800,122500,30139,95061,76931
582.985443,2,5307,5301,6,-6,122800,122500,24375,-481075,-479605
582.985443,3,711,729,-18,18,122800,122500,22515,158985,154575
582.985443,4,120,50,70,-70,122800,122500,-2139,-30461,-13311
582.985443,5,3579,3572,7,-7,122800,122500,16654,-286454,-284739
582.985443,6,0,0,0,0,122800,122500,0,0,0
583.239369,0,605,675,-70,70,122800,122500,32398,259402,242252
583.239369,1,557,631,-74,74,122800,122500,30139,95061,76931
583.239369,2,5317,5303,14,-14,122800,122500,24595,-481295,-477865
583.239369,3,713,729,-16,16,122800,122500,22564,158536,154616
583.239369,4,120,50,70,-70,122800,122500,-2139,-30461,-13311
583.239369,5,3579,3582,-3,3,122800,122500,16531,-288331,-289066
583.239369,6,0,0,0,0,122800,122500,0,0,0
583.522838,0,605,675,-70,70,123100,122500,32398,259402,242252
583.522838,1,557,631,-74,74,123100,122500,30139,95061,76931
583.522838,2,5317,5313,4,-4,123100,122500,24472,-483172,-482192
583.522838,3,713,729,-16,16,123100,122500,22564,158536,154616
583.522838,4,120,50,70,-70,123100,122500,-2139,-30461,-13311
583.522838,5,3579,3592,-13,13,123100,122500,16408,-288208,-291393
583.522838,6,0,0,0,0,123100,122500,0,0,0
583.727072,0,605,675,-70,70,123100,122500,32398,259402,242252
583.727072,1,557,631,-74,74,123100,122500,30139,95061,76931
583.727072,2,5317,5323,-6,6,123100,122500,24349,-483049,-484519
583.727072,3,713,729,-16,16,123100,122500,22564,158536,154616
583.727072,4,120,50,70,-70,123100,122500,-2139,-30461,-13311
583.727072,5,3579,3592,-13,13,123100,122500,16408,-288208,-291393
583.727072,6,0,0,0,0,123100,122500,0,0,0
584.018621,0,605,675,-70,70,122900,122500,32398,259402,242252
584.018621,1,557,631,-74,74,122900,122500,30139,95061,76931
584.018621,2,5317,5333,-16,16,122900,122500,24595,-481295,-485215
584.018621,3,713,729,-16,16,122900,122500,22564,158536,154616
584.018621,4,120,50,70,-70,122900,122500,-2139,-30461,-13311
584.018621,5,3589,3592,-3,3,122900,122500,16285,-291085,-291820
584.018621,6,0,0,0,0,122900,122500,0,0,0
584.228253,0,605,685,-80,80,122700,122500,32643,260157,244157
584.228253,1,557,631,-74,74,122700,122500,30139,95061,80261
584.228253,2,5327,5333,-6,6,122700,122500,24472,-484172,-485372
584.228253,3,713,729,-16,16,122700,122500,22564,158536,155336
584.228253,4,120,50,70,-70,122700,122500,-2139,-30461,-16461
584.228253,5,3589,3592,-3,3,122700,122500,16285,-291085,-291685
584.228253,6,0,0,0,0,122700,122500,0,0,0
584.514135,0,605,685,-80,80,122700,122500,32643,260157,244157
584.514135,1,557,631,-74,74,122700,122500,30139,95061,80261
584.514135,2,5327,5333,-6,6,122700,122500,24472,-484172,-485372
584.514135,3,713,729,-16,16,122700,122500,22564,158536,155336
584.514135,4,120,50,70,-70,122700,122500,-2139,-30461,-16461
584.514135,5,3589,3592,-3,3,122700,122500,16285,-291085,-291685
584.514135,6,0,0,0,0,122700,122500,0,0,0
584.704434,0,605,685,-80,80,122700,122500,32643,260157,244157
584.704434,1,557,631,-74,74,122700,122500,30139,95061,80261
584.704434,2,5327,5333,-6,6,122700,122500,24472,-484172,-485372
584.704434,3,713,729,-16,16,122700,122500,22564,158536,155336
584.704434,4,120,50,70,-70,122700,122500,-2139,-30461,-16461
584.704434,5,3589,3592,-3,3,122700,122500,16285,-291085,-291685
584.704434,6,0,0,0,0,122700,122500,0,0,0
585.025443,0,605,685,-80,80,122700,122400,32643,260157,240557
585.025443,1,557,631,-74,74,122700,122400,30139,95061,76931
585.025443,2,5327,5333,-6,6,122700,122400,24472,-484172,-485642
585.025443,3,713,729,-16,16,122700,122400,22564,158536,154616
585.025443,4,120,50,70,-70,122700,122400,-2139,-30461,-13311
585.025443,5,3589,3592,-3,3,122700,122400,16285,-291085,-291820
585.025443,6,0,0,0,0,122700,122400,0,0,0
585.271275,0,605,685,-80,80,122300,122400,32643,260157,268157
585.271275,1,557,631,-74,74,122300,122400,30139,95061,102461
585.271275,2,5347,5333,14,-14,122300,122400,24595,-488295,-489695
585.271275,3,713,729,-16,16,122300,122400,22564,158536,160136
585.271275,4,120,50,70,-70,122300,122400,-2139,-30461,-37461
585.271275,5,3609,3592,17,-17,122300,122400,16407,-296207,-297907
585.271275,6,0,0,0,0,122300,122400,0,0,0
585.510525,0,605,685,-80,80,121900,122400,32643,260157,279757
585.510525,1,580,631,-51,51,121900,122400,30702,96798,109293
585.510525,2,5357,5333,24,-24,121900,122400,24840,-487540,-493420
585.510525,3,717,729,-12,12,121900,122400,22589,159311,162251
585.510525,4,120,50,70,-70,121900,122400,-2139,-30461,-47611
585.510525,5,3619,3602,17,-17,121900,122400,16529,-297329,-301494
585.510525,6,0,0,0,0,121900,122400,0,0,0
585.737391,0,605,685,-80,80,122400,122400,32643,260157,260157
585.737391,1,580,631,-51,51,122400,122400,30702,96798,96798
585.737391,2,5357,5343,14,-14,122400,122400,24718,-489418,-489418
585.737391,3,721,729,-8,8,122400,122400,22687,159213,159213
585.737391,4,120,50,70,-70,122400,122400,-2139,-30461,-30461
585.737391,5,3629,3606,23,-23,122400,122400,16726,-298326,-298326
585.737391,6,0,0,0,0,122400,122400,0,0,0
585.973249,0,605,685,-80,80,122400,122400,32643,260157,260157
585.973249,1,580,631,-51,51,122400,122400,30702,96798,96798
585.973249,2,5357,5343,14,-14,122400,122400,24718,-489418,-489418
585.973249,3,721,729,-8,8,122400,122400,22687,159213,159213
585.973249,4,120,50,70,-70,122400,122400,-2139,-30461,-30461
585.973249,5,3629,3606,23,-23,122400,122400,16726,-298326,-298326
585.973249,6,0,0,0,0,122400,122400,0,0,0
586.299278,0,605,685,-80,80,122300,122400,32643,260157,268157
586.299278,1,580,631,-51,51,122300,122400,30702,96798,101898
586.299278,2,5367,5343,24,-24,122300,122400,24596,-489296,-491696
586.299278,3,721,729,-8,8,122300,122400,22687,159213,160013
586.299278,4,120,50,70,-70,122300,122400,-2139,-30461,-37461
586.299278,5,3629,3616,13,-13,122300,122400,16971,-300571,-301871
586.299278,6,0,0,0,0,122300,122400,0,0,0
586.501529,0,605,685,-80,80,122400,122400,32643,260157,260157
586.501529,1,586,631,-45,45,122400,122400,30849,97251,97251
586.501529,2,5367,5353,14,-14,122400,122400,24474,-491174,-491174
586.501529,3,725,729,-4,4,122400,122400,22785,159515,159515
586.501529,4,120,50,70,-70,122400,122400,-2139,-30461,-30461
586.501529,5,3639,3626,13,-13,122400,122400,17095,-301695,-301695
586.501529,6,0,0,0,0,122400,122400,0,0,0
586.722755,0,605,685,-80,80,123100,122400,32643,260157,240557
586.722755,1,586,631,-45,45,123100,122400,30849,97251,86226
586.722755,2,5367,5363,4,-4,123100,122400,24719,-492419,-491439
586.722755,3,727,731,-4,4,123100,122400,22809,158691,157711
586.722755,4,120,50,70,-70,123100,122400,-2139,-30461,-13311
586.722755,5,3649,3626,23,-23,123100,122400,16973,-302573,-296938
586.722755,6,0,0,0,0,123100,122400,0,0,0
586.96343,0,605,685,-80,80,123100,122400,32643,260157,240557
586.96343,1,586,631,-45,45,123100,122400,30849,97251,86226
586.96343,2,5367,5363,4,-4,123100,122400,24719,-492419,-491439
586.96343,3,727,731,-4,4,123100,122400,22809,158691,157711
586.96343,4,120,50,70,-70,123100,122400,-2139,-30461,-13311
586.96343,5,3649,3626,23,-23,123100,122400,16973,-302573,-296938
586.96343,6,0,0,0,0,123100,122400,0,0,0
587.214684,0,605,685,-80,80,123100,122400,32643,260157,240557
587.214684,1,586,631,-45,45,123100,122400,30849,97251,86226
587.214684,2,5367,5363,4,-4,123100,122400,24719,-492419,-491439
587.214684,3,727,731,-4,4,123100,122400,22809,158691,157711
587.214684,4,120,50,70,-70,123100,122400,-2139,-30461,-13311
587.214684,5,3649,3626,23,-23,123100,122400,16973,-302573,-296938
587.214684,6,0,0,0,0,123100,122400,0,0,0
587.480475,0,605,685,-80,80,123100,122400,32643,260157,240557
587.480475,1,586,631,-45,45,123100,122400,30849,97251,86226
587.480475,2,5367,5363,4,-4,123100,122400,24719,-492419,-491439
587.480475,3,727,731,-4,4,123100,122400,22809,158691,157711
587.480475,4,120,50,70,-70,123100,122400,-2139,-30461,-13311
587.480475,5,3649,3626,23,-23,123100,122400,16973,-302573,-296938
587.480475,6,0,0,0,0,123100,122400,0,0,0
587.78394,0,605,685,-80,80,123100,122100,32643,260157,240637
587.78394,1,586,631,-45,45,123100,122100,30849,97251,86271
587.78394,2,5367,5363,4,-4,123100,122100,24719,-492419,-491443
587.78394,3,727,731,-4,4,123100,122100,22809,158691,157715
587.78394,4,120,50,70,-70,123100,122100,-2139,-30461,-13381
587.78394,5,3649,3626,23,-23,123100,122100,16973,-302573,-296961
587.78394,6,0,0,0,0,123100,122100,0,0,0
588.046871,0,605,685,-80,80,123100,122100,32643,260157,240637
588.046871,1,586,631,-45,45,123100,122100,30849,97251,86271
588.046871,2,5367,5363,4,-4,123100,122100,24719,-492419,-491443
588.046871,3,727,731,-4,4,123100,122100,22809,158691,157715
588.046871,4,120,50,70,-70,123100,122100,-2139,-30461,-13381
588.046871,5,3649,3626,23,-23,123100,122100,16973,-302573,-296961
588.046871,6,0,0,0,0,123100,122100,0,0,0
588.277304,0,605,685,-80,80,122000,122100,32643,260157,268157
588.277304,1,586,631,-45,45,122000,122100,30849,97251,101751
588.277304,2,5377,5363,14,-14,122000,122100,24597,-492297,-493697
588.277304,3,727,731,-4,4,122000,122100,22809,158691,159091
588.277304,4,120,50,70,-70,122000,122100,-2139,-30461,-37461
588.277304,5,3649,3636,13,-13,122000,122100,17217,-303817,-305117
588.277304,6,0,0,0,0,122000,122100,0,0,0
588.503389,0,605,685,-80,80,122100,122100,32643,260157,260157
588.503389,1,586,631,-45,45,122100,122100,30849,97251,97251
588.503389,2,5377,5367,10,-10,122100,122100,24549,-492649,-492649
588.503389,3,731,731,0,0,122100,122100,22907,158593,158593
588.503389,4,120,50,70,-70,122100,122100,-2139,-30461,-30461
588.503389,5,3649,3636,13,-13,122100,122100,17217,-303817,-303817
588.503389,6,0,0,0,0,122100,122100,0,0,0
588.77112,0,605,685,-80,80,122100,122100,32643,260157,260157
588.77112,1,586,631,-45,45,122100,122100,30849,97251,97251
588.77112,2,5377,5367,10,-10,122100,122100,24549,-492649,-492649
588.77112,3,731,731,0,0,122100,122100,22907,158593,158593
588.77112,4,120,50,70,-70,122100,122100,-2139,-30461,-30461
588.77112,5,3649,3636,13,-13,122100,122100,17217,-303817,-303817
588.77112,6,0,0,0,0,122100,122100,0,0,0
589.014865,0,605,685,-80,80,122000,122100,32643,260157,268157
589.014865,1,586,631,-45,45,122000,122100,30849,97251,101751
589.014865,2,5377,5367,10,-10,122000,122100,24549,-492649,-493649
589.014865,3,731,731,0,0,122000,122100,22907,158593,158593
589.014865,4,120,50,70,-70,122000,122100,-2139,-30461,-37461
589.014865,5,3649,3646,3,-3,122000,122100,17095,-305695,-305995
589.014865,6,0,0,0,0,122000,122100,0,0,0
589.272211,0,605,685,-80,80,122000,122100,32643,260157,268157
589.272211,1,586,631,-45,45,122000,122100,30849,97251,101751
589.272211,2,5377,5377,0,0,122000,122100,24793,-494893,-494893
589.272211,3,731,731,0,0,122000,122100,22907,158593,158593
589.272211,4,120,50,70,-70,122000,122100,-2139,-30461,-37461
589.272211,5,3649,3646,3,-3,122000,122100,17095,-305695,-305995
589.272211,6,0,0,0,0,122000,122100,0,0,0
589.491382,0,605,685,-80,80,122000,122100,32643,260157,268157
589.491382,1,586,631,-45,45,122000,122100,30849,97251,101751
589.491382,2,5377,5377,0,0,122000,122100,24793,-494893,-494893
589.491382,3,731,731,0,0,122000,122100,22907,158593,158593
589.491382,4,120,50,70,-70,122000,122100,-2139,-30461,-37461
589.491382,5,3649,3646,3,-3,122000,122100,17095,-305695,-305995
589.491382,6,0,0,0,0,122000,122100,0,0,0
589.76729,0,605,685,-80,80,122000,122100,32643,260157,268157
589.76729,1,586,631,-45,45,122000,122100,30849,97251,101751
589.76729,2,5377,5377,0,0,122000,122100,24793,-494893,-494893
589.76729,3,731,731,0,0,122000,122100,22907,158593,158593
589.76729,4,120,50,70,-70,122000,122100,-2139,-30461,-37461
589.76729,5,3649,3646,3,-3,122000,122100,17095,-305695,-305995
589.76729,6,0,0,0,0,122000,122100,0,0,0
590.042196,0,605,685,-80,80,122000,122100,32643,260157,268157
590.042196,1,586,631,-45,45,122000,122100,30849,97251,101751
590.042196,2,5377,5377,0,0,122000,122100,24793,-494893,-494893
590.042196,3,731,731,0,0,122000,122100,22907,158593,158593
590.042196,4,120,50,70,-70,122000,122100,-2139,-30461,-37461
590.042196,5,3649,3646,3,-3,122000,122100,17095,-305695,-305995
590.042196,6,0,0,0,0,122000,122100,0,0,0
590.278933,0,605,685,-80,80,122000,122100,32643,260157,268157
590.278933,1,586,631,-45,45,122000,122100,30849,97251,101751
590.278933,2,5377,5387,-10,10,122000,122100,24671,-493771,-492771
590.278933,3,731,733,-2,2,122000,122100,22883,159417,159617
590.278933,4,120,50,70,-70,122000,122100,-2139,-30461,-37461
590.278933,5,3649,3666,-17,17,122000,122100,17217,-305817,-304117
590.278933,6,0,0,0,0,122000,122100,0,0,0
590.536214,0,605,685,-80,80,122100,122100,32643,260157,260157
590.536214,1,586,631,-45,45,122100,122100,30849,97251,97251
590.536214,2,5377,5397,-20,20,122100,122100,24549,-493649,-493649
590.536214,3,731,733,-2,2,122100,122100,22883,159417,159417
590.536214,4,120,50,70,-70,122100,122100,-2139,-30461,-30461
590.536214,5,3659,3666,-7,7,122100,122100,17461,-308061,-308061
590.536214,6,0,0,0,0,122100,122100,0,0,0
590.725472,0,605,685,-80,80,122100,122000,32643,260157,252157
590.725472,1,586,631,-45,45,122100,122000,30849,97251,92751
590.725472,2,5377,5397,-20,20,122100,122000,24549,-493649,-495649
590.725472,3,731,733,-2,2,122100,122000,22883,159417,159217
590.725472,4,120,50,70,-70,122100,122000,-2139,-30461,-23461
590.725472,5,3659,3666,-7,7,122100,122000,17461,-308061,-308761
590.725472,6,0,0,0,0,122100,122000,0,0,0
591.043426,0,605,685,-80,80,122100,121800,32643,260157,240637
591.043426,1,586,631,-45,45,122100,121800,30849,97251,86271
591.043426,2,5377,5397,-20,20,122100,121800,24549,-493649,-498529
591.043426,3,731,733,-2,2,122100,121800,22883,159417,158929
591.043426,4,120,50,70,-70,122100,121800,-2139,-30461,-13381
591.043426,5,3659,3666,-7,7,122100,121800,17461,-308061,-309769
591.043426,6,0,0,0,0,122100,121800,0,0,0
591.264228,0,605,705,-100,100,122100,121800,33131,263669,239269
591.264228,1,586,631,-45,45,122100,121800,30849,97251,86271
591.264228,2,5387,5397,-10,10,122100,121800,24427,-496527,-498967
591.264228,3,731,733,-2,2,122100,121800,22883,159417,158929
591.264228,4,120,50,70,-70,122100,121800,-2139,-30461,-13381
591.264228,5,3669,3666,3,-3,122100,121800,17339,-310939,-310207
591.264228,6,0,0,0,0,122100,121800,0,0,0
591.474864,0,605,705,-100,100,122000,121800,33131,263669,243669
591.474864,1,586,631,-45,45,122000,121800,30849,97251,88251
591.474864,2,5387,5397,-10,10,122000,121800,24427,-496527,-498527
591.474864,3,731,733,-2,2,122000,121800,22883,159417,159017
591.474864,4,120,50,70,-70,122000,121800,-2139,-30461,-16461
591.474864,5,3669,3666,3,-3,122000,121800,17339,-310939,-310339
591.474864,6,0,0,0,0,122000,121800,0,0,0
591.793159,0,605,705,-100,100,122000,121800,33131,263669,243669
591.793159,1,586,631,-45,45,122000,121800,30849,97251,88251
591.793159,2,5387,5397,-10,10,122000,121800,24427,-496527,-498527
591.793159,3,731,733,-2,2,122000,121800,22883,159417,159017
591.793159,4,120,50,70,-70,122000,121800,-2139,-30461,-16461
591.793159,5,3669,3666,3,-3,122000,121800,17339,-310939,-310339
591.793159,6,0,0,0,0,122000,121800,0,0,0
592.035744,0,605,705,-100,100,122000,121800,33131,263669,243669
592.035744,1,586,631,-45,45,122000,121800,30849,97251,88251
592.035744,2,5387,5397,-10,10,122000,121800,24427,-496527,-498527
592.035744,3,731,733,-2,2,122000,121800,22883,159417,159017
592.035744,4,120,50,70,-70,122000,121800,-2139,-30461,-16461
592.035744,5,3669,3666,3,-3,122000,121800,17339,-310939,-310339
592.035744,6,0,0,0,0,122000,121800,0,0,0
592.241602,0,605,705,-100,100,122000,121800,33131,263669,243669
592.241602,1,586,631,-45,45,122000,121800,30849,97251,88251
592.241602,2,5387,5397,-10,10,122000,121800,24427,-496527,-498527
592.241602,3,731,733,-2,2,122000,121800,22883,159417,159017
592.241602,4,120,50,70,-70,122000,121800,-2139,-30461,-16461
592.241602,5,3669,3666,3,-3,122000,121800,17339,-310939,-310339
592.241602,6,0,0,0,0,122000,121800,0,0,0
592.485719,0,605,705,-100,100,122000,121800,33131,263669,243669
592.485719,1,586,631,-45,45,122000,121800,30849,97251,88251
592.485719,2,5387,5397,-10,10,122000,121800,24427,-496527,-498527
592.485719,3,731,733,-2,2,122000,121800,22883,159417,159017
592.485719,4,120,50,70,-70,122000,121800,-2139,-30461,-16461
592.485719,5,3669,3666,3,-3,122000,121800,17339,-310939,-310339
592.485719,6,0,0,0,0,122000,121800,0,0,0
592.763968,0,605,705,-100,100,122000,121800,33131,263669,243669
592.763968,1,586,631,-45,45,122000,121800,30849,97251,88251
592.763968,2,5387,5397,-10,10,122000,121800,24427,-496527,-498527
592.763968,3,731,733,-2,2,122000,121800,22883,159417,159017
592.763968,4,120,50,70,-70,122000,121800,-2139,-30461,-16461
592.763968,5,3669,3676,-7,7,122000,121800,17583,-312183,-313583
592.763968,6,0,0,0,0,122000,121800,0,0,0
592.984039,0,605,705,-100,100,122000,121800,33131,263669,243669
592.984039,1,586,631,-45,45,122000,121800,30849,97251,88251
592.984039,2,5387,5397,-10,10,122000,121800,24427,-496527,-498527
592.984039,3,731,733,-2,2,122000,121800,22883,159417,159017
592.984039,4,120,50,70,-70,122000,121800,-2139,-30461,-16461
592.984039,5,3669,3676,-7,7,122000,121800,17583,-312183,-313583
592.984039,6,0,0,0,0,122000,121800,0,0,0
593.205506,0,605,705,-100,100,122000,121800,33131,263669,243669
593.205506,1,586,631,-45,45,122000,121800,30849,97251,88251
593.205506,2,5387,5397,-10,10,122000,121800,24427,-496527,-498527
593.205506,3,731,733,-2,2,122000,121800,22883,159417,159017
593.205506,4,120,50,70,-70,122000,121800,-2139,-30461,-16461
593.205506,5,3669,3676,-7,7,122000,121800,17583,-312183,-313583
593.205506,6,0,0,0,0,122000,121800,0,0,0
593.541884,0,605,705,-100,100,122000,121800,33131,263669,243669
593.541884,1,586,631,-45,45,122000,121800,30849,97251,88251
593.541884,2,5387,5397,-10,10,122000,121800,24427,-496527,-498527
593.541884,3,731,733,-2,2,122000,121800,22883,159417,159017
593.541884,4,120,50,70,-70,122000,121800,-2139,-30461,-16461
593.541884,5,3669,3676,-7,7,122000,121800,17583,-312183,-313583
593.541884,6,0,0,0,0,122000,121800,0,0,0
593.722621,0,605,705,-100,100,122000,121800,33131,263669,243669
593.722621,1,586,631,-45,45,122000,121800,30849,97251,88251
593.722621,2,5387,5397,-10,10,122000,121800,24427,-496527,-498527
593.722621,3,731,733,-2,2,122000,121800,22883,159417,159017
593.722621,4,120,50,70,-70,122000,121800,-2139,-30461,-16461
593.722621,5,3669,3676,-7,7,122000,121800,17583,-312183,-313583
593.722621,6,0,0,0,0,122000,121800,0,0,0
593.998977,0,605,705,-100,100,122000,121800,33131,263669,243669
593.998977,1,586,631,-45,45,122000,121800,30849,97251,88251
593.998977,2,5387,5397,-10,10,122000,121800,24427,-496527,-498527
593.998977,3,731,733,-2,2,122000,121800,22883,159417,159017
593.998977,4,120,50,70,-70,122000,121800,-2139,-30461,-16461
593.998977,5,3669,3676,-7,7,122000,121800,17583,-312183,-313583
593.998977,6,0,0,0,0,122000,121800,0,0,0
594.206536,0,605,705,-100,100,122000,121800,33131,263669,243669
594.206536,1,586,631,-45,45,122000,121800,30849,97251,88251
594.206536,2,5387,5397,-10,10,122000,121800,24427,-496527,-498527
594.206536,3,731,733,-2,2,122000,121800,22883,159417,159017
594.206536,4,120,50,70,-70,122000,121800,-2139,-30461,-16461
594.206536,5,3669,3676,-7,7,122000,121800,17583,-312183,-313583
594.206536,6,0,0,0,0,122000,121800,0,0,0
594.526028,0,605,705,-100,100,122200,121800,33131,263669,239269
594.526028,1,586,631,-45,45,122200,121800,30849,97251,86271
594.526028,2,5387,5407,-20,20,122200,121800,24305,-496405,-501285
594.526028,3,731,733,-2,2,122200,121800,22883,159417,158929
594.526028,4,120,50,70,-70,122200,121800,-2139,-30461,-13381
594.526028,5,3669,3686,-17,17,122200,121800,17461,-311061,-315209
594.526028,6,0,0,0,0,122200,121800,0,0,0
594.730955,0,605,705,-100,100,122200,121800,33131,263669,239269
594.730955,1,586,631,-45,45,122200,121800,30849,97251,86271
594.730955,2,5387,5407,-20,20,122200,121800,24305,-496405,-501285
594.730955,3,731,733,-2,2,122200,121800,22883,159417,158929
594.730955,4,120,50,70,-70,122200,121800,-2139,-30461,-13381
594.730955,5,3669,3686,-17,17,122200,121800,17461,-311061,-315209
594.730955,6,0,0,0,0,122200,121800,0,0,0
594.983327,0,605,705,-100,100,122200,121800,33131,263669,239269
594.983327,1,586,631,-45,45,122200,121800,30849,97251,86271
594.983327,2,5387,5407,-20,20,122200,121800,24305,-496405,-501285
594.983327,3,731,733,-2,2,122200,121800,22883,159417,158929
594.983327,4,120,50,70,-70,122200,121800,-2139,-30461,-13381
594.983327,5,3669,3686,-17,17,122200,121800,17461,-311061,-315209
594.983327,6,0,0,0,0,122200,121800,0,0,0
595.225612,0,605,705,-100,100,122200,121800,33131,263669,239269
595.225612,1,586,631,-45,45,122200,121800,30849,97251,86271
595.225612,2,5387,5407,-20,20,122200,121800,24305,-496405,-501285
595.225612,3,731,733,-2,2,122200,121800,22883,159417,158929
595.225612,4,120,50,70,-70,122200,121800,-2139,-30461,-13381
595.225612,5,3669,3686,-17,17,122200,121800,17461,-311061,-315209
595.225612,6,0,0,0,0,122200,121800,0,0,0
595.478553,0,605,705,-100,100,122600,121800,33131,263669,239269
595.478553,1,586,631,-45,45,122600,121800,30849,97251,86271
595.478553,2,5387,5417,-30,30,122600,121800,24183,-494283,-501603
595.478553,3,731,735,-4,4,122600,121800,22859,160041,159065
595.478553,4,120,50,70,-70,122600,121800,-2139,-30461,-13381
595.478553,5,3669,3696,-27,27,122600,121800,17339,-308939,-315527
595.478553,6,0,0,0,0,122600,121800,0,0,0
595.700879,0,605,705,-100,100,122600,121800,33131,263669,239269
595.700879,1,586,631,-45,45,122600,121800,30849,97251,86271
595.700879,2,5387,5417,-30,30,122600,121800,24183,-494283,-501603
595.700879,3,731,735,-4,4,122600,121800,22859,160041,159065
595.700879,4,120,50,70,-70,122600,121800,-2139,-30461,-13381
595.700879,5,3669,3696,-27,27,122600,121800,17339,-308939,-315527
595.700879,6,0,0,0,0,122600,121800,0,0,0
596.001772,0,605,705,-100,100,121800,121800,33131,263669,263669
596.001772,1,586,641,-55,55,121800,121800,31093,98007,98007
596.001772,2,5397,5417,-20,20,121800,121800,24061,-497161,-497161
596.001772,3,731,735,-4,4,121800,121800,22859,160041,160041
596.001772,4,120,50,70,-70,121800,121800,-2139,-30461,-30461
596.001772,5,3679,3696,-17,17,121800,121800,17217,-308817,-308817
596.001772,6,0,0,0,0,121800,121800,0,0,0
596.28207,0,621,705,-84,84,122500,121800,33521,268079,247583
596.28207,1,586,641,-55,55,122500,121800,31093,98007,84587
596.28207,2,5397,5417,-20,20,122500,121800,24061,-497161,-502041
596.28207,3,733,735,-2,2,122500,121800,22908,159192,158704
596.28207,4,120,50,70,-70,122500,121800,-2139,-30461,-13381
596.28207,5,3679,3698,-19,19,122500,121800,17193,-308393,-313029
596.28207,6,0,0,0,0,122500,121800,0,0,0
596.508345,0,621,705,-84,84,122500,121800,33521,268079,247583
596.508345,1,586,641,-55,55,122500,121800,31093,98007,84587
596.508345,2,5397,5417,-20,20,122500,121800,24061,-497161,-502041
596.508345,3,733,735,-2,2,122500,121800,22908,159192,158704
596.508345,4,120,50,70,-70,122500,121800,-2139,-30461,-13381
596.508345,5,3679,3698,-19,19,122500,121800,17193,-308393,-313029
596.508345,6,0,0,0,0,122500,121800,0,0,0
596.780498,0,621,705,-84,84,122500,121800,33521,268079,247583
596.780498,1,586,641,-55,55,122500,121800,31093,98007,84587
596.780498,2,5397,5417,-20,20,122500,121800,24061,-497161,-502041
596.780498,3,733,735,-2,2,122500,121800,22908,159192,158704
596.780498,4,120,50,70,-70,122500,121800,-2139,-30461,-13381
596.780498,5,3679,3698,-19,19,122500,121800,17193,-308393,-313029
596.780498,6,0,0,0,0,122500,121800,0,0,0
596.954813,0,621,705,-84,84,122500,121800,33521,268079,247583
596.954813,1,586,641,-55,55,122500,121800,31093,98007,84587
596.954813,2,5397,5417,-20,20,122500,121800,24061,-497161,-502041
596.954813,3,733,735,-2,2,122500,121800,22908,159192,158704
596.954813,4,120,50,70,-70,122500,121800,-2139,-30461,-13381
596.954813,5,3679,3698,-19,19,122500,121800,17193,-308393,-313029
596.954813,6,0,0,0,0,122500,121800,0,0,0
597.226832,0,621,705,-84,84,122500,121800,33521,268079,247583
597.226832,1,586,641,-55,55,122500,121800,31093,98007,84587
597.226832,2,5397,5417,-20,20,122500,121800,24061,-497161,-502041
597.226832,3,733,735,-2,2,122500,121800,22908,159192,158704
597.226832,4,120,50,70,-70,122500,121800,-2139,-30461,-13381
597.226832,5,3679,3698,-19,19,122500,121800,17193,-308393,-313029
597.226832,6,0,0,0,0,122500,121800,0,0,0
597.496292,0,621,715,-94,94,122400,121800,33766,269834,246898
597.496292,1,586,641,-55,55,122400,121800,31093,98007,84587
597.496292,2,5407,5417,-10,10,122400,121800,23939,-501039,-503479
597.496292,3,733,735,-2,2,122400,121800,22908,159192,158704
597.496292,4,120,50,70,-70,122400,121800,-2139,-30461,-13381
597.496292,5,3679,3698,-19,19,122400,121800,17193,-308393,-313029
597.496292,6,0,0,0,0,122400,121800,0,0,0
597.702424,0,621,721,-100,100,122200,121800,33913,271487,247087
597.702424,1,586,641,-55,55,122200,121800,31093,98007,84587
597.702424,2,5407,5427,-20,20,122200,121800,24183,-499283,-504163
597.702424,3,733,735,-2,2,122200,121800,22908,159192,158704
597.702424,4,120,50,70,-70,122200,121800,-2139,-30461,-13381
597.702424,5,3695,3698,-3,3,122200,121800,16998,-313598,-314330
597.702424,6,0,0,0,0,122200,121800,0,0,0
597.990249,0,621,721,-100,100,122200,121800,33913,271487,247087
597.990249,1,586,641,-55,55,122200,121800,31093,98007,84587
597.990249,2,5407,5427,-20,20,122200,121800,24183,-499283,-504163
597.990249,3,733,735,-2,2,122200,121800,22908,159192,158704
597.990249,4,120,50,70,-70,122200,121800,-2139,-30461,-13381
597.990249,5,3695,3698,-3,3,122200,121800,16998,-313598,-314330
597.990249,6,0,0,0,0,122200,121800,0,0,0
598.242894,0,621,721,-100,100,121600,121800,33913,271487,291487
598.242894,1,586,661,-75,75,121600,121800,31581,99519,114519
598.242894,2,5417,5427,-10,10,121600,121800,24061,-501161,-499161
598.242894,3,733,735,-2,2,121600,121800,22908,159192,159592
598.242894,4,120,50,70,-70,121600,121800,-2139,-30461,-44461
598.242894,5,3705,3698,7,-7,121600,121800,16876,-315476,-316876
598.242894,6,0,0,0,0,121600,121800,0,0,0
598.516321,0,621,721,-100,100,121600,121800,33913,271487,291487
598.516321,1,586,661,-75,75,121600,121800,31581,99519,114519
598.516321,2,5417,5427,-10,10,121600,121800,24061,-501161,-499161
598.516321,3,733,735,-2,2,121600,121800,22908,159192,159592
598.516321,4,120,50,70,-70,121600,121800,-2139,-30461,-44461
598.516321,5,3705,3698,7,-7,121600,121800,16876,-315476,-316876
598.516321,6,0,0,0,0,121600,121800,0,0,0
598.799417,0,621,721,-100,100,121600,121800,33913,271487,291487
598.799417,1,586,661,-75,75,121600,121800,31581,99519,114519
598.799417,2,5417,5427,-10,10,121600,121800,24061,-501161,-499161
598.799417,3,733,735,-2,2,121600,121800,22908,159192,159592
598.799417,4,120,50,70,-70,121600,121800,-2139,-30461,-44461
598.799417,5,3705,3698,7,-7,121600,121800,16876,-315476,-316876
598.799417,6,0,0,0,0,121600,121800,0,0,0
599.050719,0,621,721,-100,100,121600,121800,33913,271487,291487
599.050719,1,586,661,-75,75,121600,121800,31581,99519,114519
599.050719,2,5417,5427,-10,10,121600,121800,24061,-501161,-499161
599.050719,3,733,735,-2,2,121600,121800,22908,159192,159592
599.050719,4,120,50,70,-70,121600,121800,-2139,-30461,-44461
599.050719,5,3705,3698,7,-7,121600,121800,16876,-315476,-316876
599.050719,6,0,0,0,0,121600,121800,0,0,0
599.232556,0,621,721,-100,100,121600,121800,33913,271487,291487
599.232556,1,586,661,-75,75,121600,121800,31581,99519,114519
599.232556,2,5417,5427,-10,10,121600,121800,24061,-501161,-499161
599.232556,3,733,735,-2,2,121600,121800,22908,159192,159592
599.232556,4,120,50,70,-70,121600,121800,-2139,-30461,-44461
599.232556,5,3705,3698,7,-7,121600,121800,16876,-315476,-316876
599.232556,6,0,0,0,0,121600,121800,0,0,0
599.548915,0,621,721,-100,100,122600,121800,33913,271487,247087
599.548915,1,586,661,-75,75,122600,121800,31581,99519,81219
599.548915,2,5417,5437,-20,20,122600,121800,23939,-500039,-504919
599.548915,3,733,737,-4,4,122600,121800,22884,159816,158840
599.548915,4,120,50,70,-70,122600,121800,-2139,-30461,-13381
599.548915,5,3705,3698,7,-7,122600,121800,16876,-315476,-313768
599.548915,6,0,0,0,0,122600,121800,0,0,0
599.774943,0,621,721,-100,100,122200,121800,33913,271487,247087
599.774943,1,586,661,-75,75,122200,121800,31581,99519,81219
599.774943,2,5427,5437,-10,10,122200,121800,24183,-502283,-504723
599.774943,3,733,737,-4,4,122200,121800,22884,159816,158840
599.774943,4,120,50,70,-70,122200,121800,-2139,-30461,-13381
599.774943,5,3705,3708,-3,3,122200,121800,16754,-314354,-315086
599.774943,6,0,0,0,0,122200,121800,0,0,0
600.006212,0,621,721,-100,100,121600,121800,33913,271487,291487
600.006212,1,586,661,-75,75,121600,121800,31581,99519,114519
600.006212,2,5427,5437,-10,10,121600,121800,24183,-502283,-500283
600.006212,3,735,737,-2,2,121600,121800,22860,160440,160840
600.006212,4,120,50,70,-70,121600,121800,-2139,-30461,-44461
600.006212,5,3715,3708,7,-7,121600,121800,16632,-314232,-315632
600.006212,6,0,0,0,0,121600,121800,0,0,0
600.22446,0,621,721,-100,100,121600,121800,33913,271487,291487
600.22446,1,586,661,-75,75,121600,121800,31581,99519,114519
600.22446,2,5427,5437,-10,10,121600,121800,24183,-502283,-500283
600.22446,3,735,737,-2,2,121600,121800,22860,160440,160840
600.22446,4,120,50,70,-70,121600,121800,-2139,-30461,-44461
600.22446,5,3715,3708,7,-7,121600,121800,16632,-314232,-315632
600.22446,6,0,0,0,0,121600,121800,0,0,0
600.450875,0,621,721,-100,100,121600,121600,33913,271487,271487
600.450875,1,586,661,-75,75,121600,121600,31581,99519,99519
600.450875,2,5427,5437,-10,10,121600,121600,24183,-502283,-502283
600.450875,3,735,737,-2,2,121600,121600,22860,160440,160440
600.450875,4,120,50,70,-70,121600,121600,-2139,-30461,-30461
600.450875,5,3715,3708,7,-7,121600,121600,16632,-314232,-314232
600.450875,6,0,0,0,0,121600,121600,0,0,0
600.700256,0,621,721,-100,100,122000,121600,33913,271487,247187
600.700256,1,586,661,-75,75,122000,121600,31581,99519,81294
600.700256,2,5427,5447,-20,20,122000,121600,24427,-499527,-504387
600.700256,3,735,739,-4,4,122000,121600,22909,160991,160019
600.700256,4,120,50,70,-70,122000,121600,-2139,-30461,-13451
600.700256,5,3715,3708,7,-7,122000,121600,16632,-314232,-312531
600.700256,6,0,0,0,0,122000,121600,0,0,0
601.0002,0,621,721,-100,100,122000,121600,33913,271487,247187
601.0002,1,586,681,-95,95,122000,121600,32069,105031,81946
601.0002,2,5427,5457,-30,30,122000,121600,24671,-496771,-504061
601.0002,3,735,741,-6,6,122000,121600,22958,161542,160084
601.0002,4,120,50,70,-70,122000,121600,-2139,-30461,-13451
601.0002,5,3715,3708,7,-7,122000,121600,16632,-314232,-312531
601.0002,6,0,0,0,0,122000,121600,0,0,0
601.235633,0,621,721,-100,100,122000,121600,33913,271487,247187
601.235633,1,586,681,-95,95,122000,121600,32069,105031,81946
601.235633,2,5427,5467,-40,40,122000,121600,24915,-494015,-503735
601.235633,3,735,742,-7,7,122000,121600,22982,161818,160117
601.235633,4,120,50,70,-70,122000,121600,-2139,-30461,-13451
601.235633,5,3715,3708,7,-7,122000,121600,16632,-314232,-312531
601.235633,6,0,0,0,0,122000,121600,0,0,0
601.493137,0,621,721,-100,100,121600,121700,33913,271487,281487
601.493137,1,586,681,-95,95,121600,121700,32069,105031,114531
601.493137,2,5437,5467,-30,30,121600,121700,24829,-497929,-494929
601.493137,3,735,743,-8,8,121600,121700,22970,162130,162930
601.493137,4,120,50,70,-70,121600,121700,-2139,-30461,-37461
601.493137,5,3725,3708,17,-17,121600,121700,16510,-315110,-316810
601.493137,6,0,0,0,0,121600,121700,0,0,0
601.751404,0,621,721,-100,100,121600,121700,33913,271487,281487
601.751404,1,586,681,-95,95,121600,121700,32069,105031,114531
601.751404,2,5437,5467,-30,30,121600,121700,24829,-497929,-494929
601.751404,3,735,743,-8,8,121600,121700,22970,162130,162930
601.751404,4,120,50,70,-70,121600,121700,-2139,-30461,-37461
601.751404,5,3725,3708,17,-17,121600,121700,16510,-315110,-316810
601.751404,6,0,0,0,0,121600,121700,0,0,0
602.000988,0,621,721,-100,100,122000,121700,33913,271487,247187
602.000988,1,586,681,-95,95,122000,121700,32069,105031,81946
602.000988,2,5447,5467,-20,20,122000,121700,24707,-503807,-508667
602.000988,3,735,743,-8,8,122000,121700,22970,162130,160186
602.000988,4,120,50,70,-70,122000,121700,-2139,-30461,-13451
602.000988,5,3725,3708,17,-17,122000,121700,16510,-315110,-310979
602.000988,6,0,0,0,0,122000,121700,0,0,0
602.288991,0,621,721,-100,100,121700,121700,33913,271487,271487
602.288991,1,586,681,-95,95,121700,121700,32069,105031,105031
602.288991,2,5447,5477,-30,30,121700,121700,24950,-502050,-502050
602.288991,3,735,743,-8,8,121700,121700,22970,162130,162130
602.288991,4,120,50,70,-70,121700,121700,-2139,-30461,-30461
602.288991,5,3735,3708,27,-27,121700,121700,16388,-318988,-318988
602.288991,6,0,0,0,0,121700,121700,0,0,0
602.459698,0,621,721,-100,100,121600,121700,33913,271487,281487
602.459698,1,586,681,-95,95,121600,121700,32069,105031,114531
602.459698,2,5447,5477,-30,30,121600,121700,24950,-502050,-499050
602.459698,3,735,745,-10,10,121600,121700,23019,162281,163281
602.459698,4,120,50,70,-70,121600,121700,-2139,-30461,-37461
602.459698,5,3735,3708,27,-27,121600,121700,16388,-318988,-321688
602.459698,6,0,0,0,0,121600,121700,0,0,0
602.722087,0,621,721,-100,100,121800,121700,33913,271487,261487
602.722087,1,586,681,-95,95,121800,121700,32069,105031,95531
602.722087,2,5449,5477,-28,28,121800,121700,24999,-502699,-505499
602.722087,3,735,747,-12,12,121800,121700,22995,162705,161505
602.722087,4,120,50,70,-70,121800,121700,-2139,-30461,-23461
602.722087,5,3735,3708,27,-27,121800,121700,16388,-318988,-316288
602.722087,6,0,0,0,0,121800,121700,0,0,0
602.981289,0,621,721,-100,100,121500,121700,33913,271487,291487
602.981289,1,586,681,-95,95,121500,121700,32069,105031,124031
602.981289,2,5457,5477,-20,20,121500,121700,24902,-505002,-501002
602.981289,3,735,747,-12,12,121500,121700,22995,162705,165105
602.981289,4,120,50,70,-70,121500,121700,-2139,-30461,-44461
602.981289,5,3735,3708,27,-27,121500,121700,16388,-318988,-324388
602.981289,6,0,0,0,0,121500,121700,0,0,0
603.259533,0,621,721,-100,100,121700,121700,33913,271487,271487
603.259533,1,586,681,-95,95,121700,121700,32069,105031,105031
603.259533,2,5467,5477,-10,10,121700,121700,24780,-506880,-506880
603.259533,3,735,747,-12,12,121700,121700,22995,162705,162705
603.259533,4,120,50,70,-70,121700,121700,-2139,-30461,-30461
603.259533,5,3735,3718,17,-17,121700,121700,16631,-319231,-319231
603.259533,6,0,0,0,0,121700,121700,0,0,0
603.509595,0,621,721,-100,100,121700,121700,33913,271487,271487
603.509595,1,586,681,-95,95,121700,121700,32069,105031,105031
603.509595,2,5467,5477,-10,10,121700,121700,24780,-506880,-506880
603.509595,3,735,747,-12,12,121700,121700,22995,162705,162705
603.509595,4,120,50,70,-70,121700,121700,-2139,-30461,-30461
603.509595,5,3735,3718,17,-17,121700,121700,16631,-319231,-319231
603.509595,6,0,0,0,0,121700,121700,0,0,0
603.782041,0,621,721,-100,100,121500,121700,33913,271487,291487
603.782041,1,586,681,-95,95,121500,121700,32069,105031,124031
603.782041,2,5467,5477,-10,10,121500,121700,24780,-506880,-504880
603.782041,3,735,747,-12,12,121500,121700,22995,162705,165105
603.782041,4,120,50,70,-70,121500,121700,-2139,-30461,-44461
603.782041,5,3735,3728,7,-7,121500,121700,16874,-320474,-321874
603.782041,6,0,0,0,0,121500,121700,0,0,0
603.987471,0,621,721,-100,100,121500,121700,33913,271487,291487
603.987471,1,586,681,-95,95,121500,121700,32069,105031,124031
603.987471,2,5467,5477,-10,10,121500,121700,24780,-506880,-504880
603.987471,3,735,747,-12,12,121500,121700,22995,162705,165105
603.987471,4,120,50,70,-70,121500,121700,-2139,-30461,-44461
603.987471,5,3735,3738,-3,3,121500,121700,17117,-320717,-320117
603.987471,6,0,0,0,0,121500,121700,0,0,0
604.285952,0,621,721,-100,100,121500,121700,33913,271487,291487
604.285952,1,586,681,-95,95,121500,121700,32069,105031,124031
604.285952,2,5467,5477,-10,10,121500,121700,24780,-506880,-504880
604.285952,3,735,747,-12,12,121500,121700,22995,162705,165105
604.285952,4,120,50,70,-70,121500,121700,-2139,-30461,-44461
604.285952,5,3735,3738,-3,3,121500,121700,17117,-320717,-320117
604.285952,6,0,0,0,0,121500,121700,0,0,0
604.462621,0,621,721,-100,100,121500,121700,33913,271487,291487
604.462621,1,586,681,-95,95,121500,121700,32069,105031,124031
604.462621,2,5467,5477,-10,10,121500,121700,24780,-506880,-504880
604.462621,3,735,747,-12,12,121500,121700,22995,162705,165105
604.462621,4,120,50,70,-70,121500,121700,-2139,-30461,-44461
604.462621,5,3735,3738,-3,3,121500,121700,17117,-320717,-320117
604.462621,6,0,0,0,0,121500,121700,0,0,0
604.748001,0,621,721,-100,100,122100,121700,33913,271487,247187
604.748001,1,586,681,-95,95,122100,121700,32069,105031,81946
604.748001,2,5467,5487,-20,20,122100,121700,24658,-507758,-512618
604.748001,3,735,749,-14,14,122100,121700,22971,162929,159527
604.748001,4,120,50,70,-70,122100,121700,-2139,-30461,-13451
604.748001,5,3735,3748,-13,13,122100,121700,16995,-320595,-323754
604.748001,6,0,0,0,0,122100,121700,0,0,0
604.986033,0,621,721,-100,100,122000,121900,33913,271487,261487
604.986033,1,586,681,-95,95,122000,121900,32069,105031,95531
604.986033,2,5467,5489,-22,22,122000,121900,24634,-507334,-509534
604.986033,3,737,751,-14,14,122000,121900,23069,162231,160831
604.986033,4,120,50,70,-70,122000,121900,-2139,-30461,-23461
604.986033,5,3735,3748,-13,13,122000,121900,16995,-320595,-321895
604.986033,6,0,0,0,0,122000,121900,0,0,0
605.279273,0,621,721,-100,100,122000,121900,33913,271487,261487
605.279273,1,586,681,-95,95,122000,121900,32069,105031,95531
605.279273,2,5467,5489,-22,22,122000,121900,24634,-507334,-509534
605.279273,3,737,751,-14,14,122000,121900,23069,162231,160831
605.279273,4,120,50,70,-70,122000,121900,-2139,-30461,-23461
605.279273,5,3735,3748,-13,13,122000,121900,16995,-320595,-321895
605.279273,6,0,0,0,0,122000,121900,0,0,0
605.544706,0,621,721,-100,100,122200,121900,33913,271487,247087
605.544706,1,586,681,-95,95,122200,121900,32069,105031,81851
605.544706,2,5467,5499,-32,32,122200,121900,24512,-504212,-512020
605.544706,3,737,753,-16,16,122200,121900,23045,162855,158951
605.544706,4,120,50,70,-70,122200,121900,-2139,-30461,-13381
605.544706,5,3735,3758,-23,23,122200,121900,16873,-317473,-323085
605.544706,6,0,0,0,0,122200,121900,0,0,0
605.707907,0,621,721,-100,100,122200,121900,33913,271487,247087
605.707907,1,586,681,-95,95,122200,121900,32069,105031,81851
605.707907,2,5467,5499,-32,32,122200,121900,24512,-504212,-512020
605.707907,3,737,755,-18,18,122200,121900,23094,163406,159014
605.707907,4,120,50,70,-70,122200,121900,-2139,-30461,-13381
605.707907,5,3735,3758,-23,23,122200,121900,16873,-317473,-323085
605.707907,6,0,0,0,0,122200,121900,0,0,0
606.043729,0,621,721,-100,100,122300,121900,33913,271487,247087
606.043729,1,586,681,-95,95,122300,121900,32069,105031,81851
606.043729,2,5477,5499,-22,22,122300,121900,24757,-508457,-513825
606.043729,3,737,755,-18,18,122300,121900,23094,163406,159014
606.043729,4,120,50,70,-70,122300,121900,-2139,-30461,-13381
606.043729,5,3735,3768,-33,33,122300,121900,16751,-315351,-323403
606.043729,6,0,0,0,0,122300,121900,0,0,0
606.246323,0,621,721,-100,100,122200,121900,33913,271487,247087
606.246323,1,586,681,-95,95,122200,121900,32069,105031,81851
606.246323,2,5477,5499,-22,22,122200,121900,24757,-508457,-513825
606.246323,3,737,757,-20,20,122200,121900,23143,163757,158877
606.246323,4,120,50,70,-70,122200,121900,-2139,-30461,-13381
606.246323,5,3735,3768,-33,33,122200,121900,16751,-315351,-323403
606.246323,6,0,0,0,0,122200,121900,0,0,0
606.469521,0,621,721,-100,100,122200,121900,33913,271487,247087
606.469521,1,586,681,-95,95,122200,121900,32069,105031,81851
606.469521,2,5477,5499,-22,22,122200,121900,24757,-508457,-513825
606.469521,3,737,757,-20,20,122200,121900,23143,163757,158877
606.469521,4,120,50,70,-70,122200,121900,-2139,-30461,-13381
606.469521,5,3735,3768,-33,33,122200,121900,16751,-315351,-323403
606.469521,6,0,0,0,0,122200,121900,0,0,0
606.728889,0,621,721,-100,100,122200,121900,33913,271487,247087
606.728889,1,586,681,-95,95,122200,121900,32069,105031,81851
606.728889,2,5477,5499,-22,22,122200,121900,24757,-508457,-513825
606.728889,3,737,757,-20,20,122200,121900,23143,163757,158877
606.728889,4,120,50,70,-70,122200,121900,-2139,-30461,-13381
606.728889,5,3735,3768,-33,33,122200,121900,16751,-315351,-323403
606.728889,6,0,0,0,0,122200,121900,0,0,0
607.025223,0,621,721,-100,100,122200,122100,33913,271487,261487
607.025223,1,586,681,-95,95,122200,122100,32069,105031,95531
607.025223,2,5477,5499,-22,22,122200,122100,24757,-508457,-510657
607.025223,3,737,757,-20,20,122200,122100,23143,163757,161757
607.025223,4,120,50,70,-70,122200,122100,-2139,-30461,-23461
607.025223,5,3735,3768,-33,33,122200,122100,16751,-315351,-318651
607.025223,6,0,0,0,0,122200,122100,0,0,0
607.220695,0,621,721,-100,100,122200,122100,33913,271487,261487
607.220695,1,586,681,-95,95,122200,122100,32069,105031,95531
607.220695,2,5477,5499,-22,22,122200,122100,24757,-508457,-510657
607.220695,3,737,757,-20,20,122200,122100,23143,163757,161757
607.220695,4,120,50,70,-70,122200,122100,-2139,-30461,-23461
607.220695,5,3735,3768,-33,33,122200,122100,16751,-315351,-318651
607.220695,6,0,0,0,0,122200,122100,0,0,0
607.528144,0,621,721,-100,100,122300,122100,33913,271487,251487
607.528144,1,586,681,-95,95,122300,122100,32069,105031,86031
607.528144,2,5477,5509,-32,32,122300,122100,24635,-505335,-511735
607.528144,3,737,757,-20,20,122300,122100,23143,163757,159757
607.528144,4,120,50,70,-70,122300,122100,-2139,-30461,-16461
607.528144,5,3745,3768,-23,23,122300,122100,16996,-319596,-324196
607.528144,6,0,0,0,0,122300,122100,0,0,0
607.725518,0,621,721,-100,100,122300,122100,33913,271487,251487
607.725518,1,586,681,-95,95,122300,122100,32069,105031,86031
607.725518,2,5487,5509,-22,22,122300,122100,24880,-509580,-513980
607.725518,3,737,759,-22,22,122300,122100,23119,164381,159981
607.725518,4,120,50,70,-70,122300,122100,-2139,-30461,-16461
607.725518,5,3745,3776,-31,31,122300,122100,16898,-317098,-323298
607.725518,6,0,0,0,0,122300,122100,0,0,0
607.981302,0,621,721,-100,100,122300,121900,33913,271487,247087
607.981302,1,586,681,-95,95,122300,121900,32069,105031,81851
607.981302,2,5487,5509,-22,22,122300,121900,24880,-509580,-514948
607.981302,3,737,759,-22,22,122300,121900,23119,164381,159013
607.981302,4,120,50,70,-70,122300,121900,-2139,-30461,-13381
607.981302,5,3745,3776,-31,31,122300,121900,16898,-317098,-324662
607.981302,6,0,0,0,0,122300,121900,0,0,0
608.287799,0,621,721,-100,100,122200,121900,33913,271487,247087
608.287799,1,586,681,-95,95,122200,121900,32069,105031,81851
608.287799,2,5487,5509,-22,22,122200,121900,24880,-509580,-514948
608.287799,3,737,761,-24,24,122200,121900,23168,164732,158876
608.287799,4,120,50,70,-70,122200,121900,-2139,-30461,-13381
608.287799,5,3745,3776,-31,31,122200,121900,16898,-317098,-324662
608.287799,6,0,0,0,0,122200,121900,0,0,0
608.504902,0,621,721,-100,100,122200,121900,33913,271487,247087
608.504902,1,586,681,-95,95,122200,121900,32069,105031,81851
608.504902,2,5487,5509,-22,22,122200,121900,24880,-509580,-514948
608.504902,3,737,761,-24,24,122200,121900,23168,164732,158876
608.504902,4,120,50,70,-70,122200,121900,-2139,-30461,-13381
608.504902,5,3745,3776,-31,31,122200,121900,16898,-317098,-324662
608.504902,6,0,0,0,0,122200,121900,0,0,0
608.739132,0,621,721,-100,100,122200,121900,33913,271487,247087
608.739132,1,586,681,-95,95,122200,121900,32069,105031,81851
608.739132,2,5487,5509,-22,22,122200,121900,24880,-509580,-514948
608.739132,3,737,763,-26,26,122200,121900,23217,164883,158539
608.739132,4,120,50,70,-70,122200,121900,-2139,-30461,-13381
608.739132,5,3745,3776,-31,31,122200,121900,16898,-317098,-324662
608.739132,6,0,0,0,0,122200,121900,0,0,0
608.956924,0,621,721,-100,100,122200,121900,33913,271487,247087
608.956924,1,586,681,-95,95,122200,121900,32069,105031,81851
608.956924,2,5487,5509,-22,22,122200,121900,24880,-509580,-514948
608.956924,3,737,763,-26,26,122200,121900,23217,164883,158539
608.956924,4,120,50,70,-70,122200,121900,-2139,-30461,-13381
608.956924,5,3745,3776,-31,31,122200,121900,16898,-317098,-324662
608.956924,6,0,0,0,0,122200,121900,0,0,0
609.239518,0,621,721,-100,100,122200,122000,33913,271487,251487
609.239518,1,586,681,-95,95,122200,122000,32069,105031,86031
609.239518,2,5487,5509,-22,22,122200,122000,24880,-509580,-513980
609.239518,3,737,763,-26,26,122200,122000,23217,164883,159683
609.239518,4,120,50,70,-70,122200,122000,-2139,-30461,-16461
609.239518,5,3745,3776,-31,31,122200,122000,16898,-317098,-323298
609.239518,6,0,0,0,0,122200,122000,0,0,0
609.50946,0,621,721,-100,100,122600,122000,33913,271487,247087
609.50946,1,586,681,-95,95,122600,122000,32069,105031,81851
609.50946,2,5487,5519,-32,32,122600,122000,24758,-506458,-514266
609.50946,3,737,765,-28,28,122600,122000,23193,165507,158675
609.50946,4,120,50,70,-70,122600,122000,-2139,-30461,-13381
609.50946,5,3745,3786,-41,41,122600,122000,16775,-312975,-322979
609.50946,6,0,0,0,0,122600,122000,0,0,0
609.767622,0,621,721,-100,100,122600,122000,33913,271487,247087
609.767622,1,586,681,-95,95,122600,122000,32069,105031,81851
609.767622,2,5487,5519,-32,32,122600,122000,24758,-506458,-514266
609.767622,3,737,765,-28,28,122600,122000,23193,165507,158675
609.767622,4,120,50,70,-70,122600,122000,-2139,-30461,-13381
609.767622,5,3745,3786,-41,41,122600,122000,16775,-312975,-322979
609.767622,6,0,0,0,0,122600,122000,0,0,0
610.049231,0,621,721,-100,100,122200,122000,33913,271487,251487
610.049231,1,586,681,-95,95,122200,122000,32069,105031,86031
610.049231,2,5493,5527,-34,34,122200,122000,24587,-507087,-513887
610.049231,3,737,771,-34,34,122200,122000,23267,167433,160633
610.049231,4,120,50,70,-70,122200,122000,-2139,-30461,-16461
610.049231,5,3755,3786,-31,31,122200,122000,17020,-319020,-325220
610.049231,6,0,0,0,0,122200,122000,0,0,0
610.288846,0,621,721,-100,100,122000,122000,33913,271487,271487
610.288846,1,586,681,-95,95,122000,122000,32069,105031,105031
610.288846,2,5493,5537,-44,44,122000,122000,24831,-503331,-503331
610.288846,3,737,773,-36,36,122000,122000,23316,168184,168184
610.288846,4,120,50,70,-70,122000,122000,-2139,-30461,-30461
610.288846,5,3755,3786,-31,31,122000,122000,17020,-319020,-319020
610.288846,6,0,0,0,0,122000,122000,0,0,0
610.4992,0,621,721,-100,100,122000,122000,33913,271487,271487
610.4992,1,586,681,-95,95,122000,122000,32069,105031,105031
610.4992,2,5493,5537,-44,44,122000,122000,24831,-503331,-503331
610.4992,3,737,775,-38,38,122000,122000,23365,168735,168735
610.4992,4,120,50,70,-70,122000,122000,-2139,-30461,-30461
610.4992,5,3755,3786,-31,31,122000,122000,17020,-319020,-319020
610.4992,6,0,0,0,0,122000,122000,0,0,0
610.795687,0,621,721,-100,100,122200,122000,33913,271487,251487
610.795687,1,586,681,-95,95,122200,122000,32069,105031,86031
610.795687,2,5497,5537,-40,40,122200,122000,24783,-505283,-513283
610.795687,3,737,779,-42,42,122200,122000,23463,169837,161437
610.795687,4,120,50,70,-70,122200,122000,-2139,-30461,-16461
610.795687,5,3755,3786,-31,31,122200,122000,17020,-319020,-325220
610.795687,6,0,0,0,0,122200,122000,0,0,0
611.00034,0,621,721,-100,100,122000,121900,33913,271487,261487
611.00034,1,586,681,-95,95,122000,121900,32069,105031,95531
611.00034,2,5507,5537,-30,30,122000,121900,24661,-508161,-511161
611.00034,3,737,779,-42,42,122000,121900,23463,169837,165637
611.00034,4,120,50,70,-70,122000,121900,-2139,-30461,-23461
611.00034,5,3755,3786,-31,31,122000,121900,17020,-319020,-322120
611.00034,6,0,0,0,0,122000,121900,0,0,0
611.258939,0,621,721,-100,100,122100,121900,33913,271487,251487
611.258939,1,586,681,-95,95,122100,121900,32069,105031,86031
611.258939,2,5509,5537,-28,28,122100,121900,24637,-508737,-514337
611.258939,3,737,781,-44,44,122100,121900,23512,170188,161388
611.258939,4,120,50,70,-70,122100,121900,-2139,-30461,-16461
611.258939,5,3755,3786,-31,31,122100,121900,17020,-319020,-325220
611.258939,6,0,0,0,0,122100,121900,0,0,0
611.533346,0,621,721,-100,100,122100,121900,33913,271487,251487
611.533346,1,586,681,-95,95,122100,121900,32069,105031,86031
611.533346,2,5509,5537,-28,28,122100,121900,24637,-508737,-514337
611.533346,3,737,781,-44,44,122100,121900,23512,170188,161388
611.533346,4,120,50,70,-70,122100,121900,-2139,-30461,-16461
611.533346,5,3755,3786,-31,31,122100,121900,17020,-319020,-325220
611.533346,6,0,0,0,0,122100,121900,0,0,0
611.729573,0,621,721,-100,100,122100,122100,33913,271487,271487
611.729573,1,586,681,-95,95,122100,122100,32069,105031,105031
611.729573,2,5509,5537,-28,28,122100,122100,24637,-508737,-508737
611.729573,3,737,781,-44,44,122100,122100,23512,170188,170188
611.729573,4,120,50,70,-70,122100,122100,-2139,-30461,-30461
611.729573,5,3755,3786,-31,31,122100,122100,17020,-319020,-319020
611.729573,6,0,0,0,0,122100,122100,0,0,0
611.977272,0,621,721,-100,100,122200,122100,33913,271487,261487
611.977272,1,586,681,-95,95,122200,122100,32069,105031,95531
611.977272,2,5509,5545,-36,36,122200,122100,24539,-507839,-511439
611.977272,3,737,783,-46,46,122200,122100,23488,170412,165812
611.977272,4,120,50,70,-70,122200,122100,-2139,-30461,-23461
611.977272,5,3765,3786,-21,21,122200,122100,17264,-322264,-324364
611.977272,6,0,0,0,0,122200,122100,0,0,0
612.231765,0,621,721,-100,100,122600,122100,33913,271487,247087
612.231765,1,586,681,-95,95,122600,122100,32069,105031,81851
612.231765,2,5509,5555,-46,46,122600,122100,24417,-503717,-514941
612.231765,3,737,785,-48,48,122600,122100,23464,171036,159324
612.231765,4,120,50,70,-70,122600,122100,-2139,-30461,-13381
612.231765,5,3765,3796,-31,31,122600,122100,17142,-318142,-325706
612.231765,6,0,0,0,0,122600,122100,0,0,0
612.516502,0,621,721,-100,100,122000,122100,33913,271487,281487
612.516502,1,586,681,-95,95,122000,122100,32069,105031,114531
612.516502,2,5519,5555,-36,36,122000,122100,24295,-507795,-504195
612.516502,3,737,787,-50,50,122000,122100,23513,171587,176587
612.516502,4,120,50,70,-70,122000,122100,-2139,-30461,-37461
612.516502,5,3775,3796,-21,21,122000,122100,17020,-320020,-317920
612.516502,6,0,0,0,0,122000,122100,0,0,0
612.743879,0,621,721,-100,100,122300,122100,33913,271487,251487
612.743879,1,586,681,-95,95,122300,122100,32069,105031,86031
612.743879,2,5529,5555,-26,34,122300,122100,24173,-1488473,-516873
612.743879,3,737,789,-52,52,122300,122100,23562,172138,161738
612.743879,4,120,50,70,-70,122300,122100,-2139,-30461,-16461
612.743879,5,3785,3796,-11,21,122300,122100,16898,-1542898,-324098
612.743879,6,0,0,0,0,122300,122100,0,0,0
612.987972,0,621,721,-100,100,122300,122200,33913,271487,261487
612.987972,1,586,681,-95,95,122300,122200,32069,105031,95531
612.987972,2,5539,5555,-16,16,122300,122200,24418,-513918,-515518
612.987972,3,737,789,-52,52,122300,122200,23562,172138,166938
612.987972,4,120,50,70,-70,122300,122200,-2139,-30461,-23461
612.987972,5,3785,3796,-11,11,122300,122200,16898,-321898,-322998
612.987972,6,0,0,0,0,122300,122200,0,0,0
613.210215,0,621,721,-100,100,122300,122200,33913,271487,261487
613.210215,1,586,681,-95,95,122300,122200,32069,105031,95531
613.210215,2,5549,5555,-6,6,122300,122200,24663,-516163,-516763
613.210215,3,737,789,-52,52,122300,122200,23562,172138,166938
613.210215,4,120,50,70,-70,122300,122200,-2139,-30461,-23461
613.210215,5,3785,3796,-11,11,122300,122200,16898,-321898,-322998
613.210215,6,0,0,0,0,122300,122200,0,0,0
613.482835,0,621,721,-100,100,122300,122200,33913,271487,261487
613.482835,1,586,681,-95,95,122300,122200,32069,105031,95531
613.482835,2,5559,5555,4,-4,122300,122200,24908,-517408,-517008
613.482835,3,737,789,-52,52,122300,122200,23562,172138,166938
613.482835,4,120,50,70,-70,122300,122200,-2139,-30461,-23461
613.482835,5,3795,3796,-1,1,122300,122200,17143,-323143,-323243
613.482835,6,0,0,0,0,122300,122200,0,0,0
613.719597,0,621,721,-100,100,122500,122500,33913,271487,271487
613.719597,1,586,681,-95,95,122500,122500,32069,105031,105031
613.719597,2,5569,5565,4,-4,122500,122500,25031,-520531,-520531
613.719597,3,747,789,-42,42,122500,122500,23806,171894,171894
613.719597,4,120,50,70,-70,122500,122500,-2139,-30461,-30461
613.719597,5,3795,3801,-6,6,122500,122500,17082,-324082,-324082
613.719597,6,0,0,0,0,122500,122500,0,0,0
613.953367,0,621,721,-100,100,123200,122500,33913,271487,246987
613.953367,1,586,681,-95,95,123200,122500,32069,105031,81756
613.953367,2,5569,5575,-6,6,123200,122500,25276,-519776,-521246
613.953367,3,751,789,-38,38,123200,122500,23905,168595,159285
613.953367,4,120,50,70,-70,123200,122500,-2139,-30461,-13311
613.953367,5,3805,3801,4,-4,123200,122500,16959,-325959,-324979
613.953367,6,0,0,0,0,123200,122500,0,0,0
614.237508,0,621,721,-100,100,123200,122500,33913,271487,246987
614.237508,1,586,681,-95,95,123200,122500,32069,105031,81756
614.237508,2,5569,5575,-6,6,123200,122500,25276,-519776,-521246
614.237508,3,751,789,-38,38,123200,122500,23905,168595,159285
614.237508,4,120,50,70,-70,123200,122500,-2139,-30461,-13311
614.237508,5,3805,3801,4,-4,123200,122500,16959,-325959,-324979
614.237508,6,0,0,0,0,123200,122500,0,0,0
614.537745,0,621,721,-100,100,122800,122200,33913,271487,247087
614.537745,1,586,681,-95,95,122800,122200,32069,105031,81851
614.537745,2,5569,5585,-16,16,122800,122200,25153,-516653,-520557
614.537745,3,751,791,-40,40,122800,122200,23880,169620,159860
614.537745,4,120,50,70,-70,122800,122200,-2139,-30461,-13381
614.537745,5,3805,3801,4,-4,122800,122200,16959,-325959,-324983
614.537745,6,0,0,0,0,122800,122200,0,0,0
614.764922,0,621,721,-100,100,122800,122200,33913,271487,247087
614.764922,1,586,681,-95,95,122800,122200,32069,105031,81851
614.764922,2,5569,5585,-16,16,122800,122200,25153,-516653,-520557
614.764922,3,751,791,-40,40,122800,122200,23880,169620,159860
614.764922,4,120,50,70,-70,122800,122200,-2139,-30461,-13381
614.764922,5,3805,3801,4,-4,122800,122200,16959,-325959,-324983
614.764922,6,0,0,0,0,122800,122200,0,0,0
614.965973,0,621,721,-100,100,122800,122200,33913,271487,247087
614.965973,1,586,681,-95,95,122800,122200,32069,105031,81851
614.965973,2,5569,5585,-16,16,122800,122200,25153,-516653,-520557
614.965973,3,751,791,-40,40,122800,122200,23880,169620,159860
614.965973,4,120,50,70,-70,122800,122200,-2139,-30461,-13381
614.965973,5,3805,3801,4,-4,122800,122200,16959,-325959,-324983
614.965973,6,0,0,0,0,122800,122200,0,0,0
615.213366,0,621,721,-100,100,122400,122200,33913,271487,251487
615.213366,1,586,681,-95,95,122400,122200,32069,105031,86031
615.213366,2,5579,5585,-6,6,122400,122200,25031,-518531,-519731
615.213366,3,751,791,-40,40,122400,122200,23880,169620,161620
615.213366,4,120,50,70,-70,122400,122200,-2139,-30461,-16461
615.213366,5,3805,3811,-6,6,122400,122200,17204,-326204,-327404
615.213366,6,0,0,0,0,122400,122200,0,0,0
615.520877,0,621,721,-100,100,122400,122200,33913,271487,251487
615.520877,1,586,681,-95,95,122400,122200,32069,105031,86031
615.520877,2,5579,5585,-6,6,122400,122200,25031,-518531,-519731
615.520877,3,751,791,-40,40,122400,122200,23880,169620,161620
615.520877,4,120,50,70,-70,122400,122200,-2139,-30461,-16461
615.520877,5,3805,3811,-6,6,122400,122200,17204,-326204,-327404
615.520877,6,0,0,0,0,122400,122200,0,0,0
615.795752,0,621,721,-100,100,122000,122200,33913,271487,291487
615.795752,1,586,681,-95,95,122000,122200,32069,105031,124031
615.795752,2,5589,5585,4,-4,122000,122200,24909,-519409,-520209
615.795752,3,751,791,-40,40,122000,122200,23880,169620,177620
615.795752,4,120,50,70,-70,122000,122200,-2139,-30461,-44461
615.795752,5,3815,3811,4,-4,122000,122200,17082,-327082,-327882
615.795752,6,0,0,0,0,122000,122200,0,0,0
616.04887,0,621,721,-100,100,122000,122200,33913,271487,291487
616.04887,1,586,681,-95,95,122000,122200,32069,105031,124031
616.04887,2,5589,5585,4,-4,122000,122200,24909,-519409,-520209
616.04887,3,751,791,-40,40,122000,122200,23880,169620,177620
616.04887,4,120,50,70,-70,122000,122200,-2139,-30461,-44461
616.04887,5,3815,3811,4,-4,122000,122200,17082,-327082,-327882
616.04887,6,0,0,0,0,122000,122200,0,0,0
616.29342,0,621,721,-100,100,122600,122500,33913,271487,261487
616.29342,1,586,681,-95,95,122600,122500,32069,105031,95531
616.29342,2,5589,5589,0,0,122600,122500,24860,-518960,-518960
616.29342,3,755,791,-36,36,122600,122500,23978,168322,164722
616.29342,4,120,50,70,-70,122600,122500,-2139,-30461,-23461
616.29342,5,3815,3811,4,-4,122600,122500,17082,-327082,-326682
616.29342,6,0,0,0,0,122600,122500,0,0,0
616.52779,0,621,721,-100,100,122000,122500,33913,271487,295987
616.52779,1,586,681,-95,95,122000,122500,32069,105031,128306
616.52779,2,5599,5589,10,-10,122000,122500,24738,-518838,-521288
616.52779,3,757,791,-34,34,122000,122500,23954,168946,177276
616.52779,4,120,50,70,-70,122000,122500,-2139,-30461,-47611
616.52779,5,3825,3811,14,-14,122000,122500,16960,-326960,-330390
616.52779,6,0,0,0,0,122000,122500,0,0,0
616.775176,0,621,721,-100,100,122000,122600,33913,271487,295987
616.775176,1,586,681,-95,95,122000,122600,32069,105031,128306
616.775176,2,5599,5589,10,-10,122000,122600,24738,-518838,-521288
616.775176,3,757,791,-34,34,122000,122600,23954,168946,177276
616.775176,4,120,50,70,-70,122000,122600,-2139,-30461,-47611
616.775176,5,3825,3811,14,-14,122000,122600,16960,-326960,-330390
616.775176,6,0,0,0,0,122000,122600,0,0,0
616.962351,0,621,721,-100,100,122500,122600,33913,271487,281487
616.962351,1,586,681,-95,95,122500,122600,32069,105031,114531
616.962351,2,5599,5589,10,-10,122500,122600,24738,-518838,-519838
616.962351,3,760,791,-31,31,122500,122600,24028,168572,171672
616.962351,4,120,50,70,-70,122500,122600,-2139,-30461,-37461
616.962351,5,3825,3814,11,-11,122500,122600,16923,-327223,-328323
616.962351,6,0,0,0,0,122500,122600,0,0,0
617.238789,0,621,721,-100,100,122500,122600,33913,271487,281487
617.238789,1,586,681,-95,95,122500,122600,32069,105031,114531
617.238789,2,5599,5589,10,-10,122500,122600,24738,-518838,-519838
617.238789,3,760,791,-31,31,122500,122600,24028,168572,171672
617.238789,4,120,50,70,-70,122500,122600,-2139,-30461,-37461
617.238789,5,3825,3814,11,-11,122500,122600,16923,-327223,-328323
617.238789,6,0,0,0,0,122500,122600,0,0,0
617.466359,0,621,721,-100,100,122500,122600,33913,271487,281487
617.466359,1,586,681,-95,95,122500,122600,32069,105031,114531
617.466359,2,5599,5589,10,-10,122500,122600,24738,-518838,-519838
617.466359,3,760,791,-31,31,122500,122600,24028,168572,171672
617.466359,4,120,50,70,-70,122500,122600,-2139,-30461,-37461
617.466359,5,3825,3814,11,-11,122500,122600,16923,-327223,-328323
617.466359,6,0,0,0,0,122500,122600,0,0,0
617.711485,0,621,721,-100,100,122500,122600,33913,271487,281487
617.711485,1,586,681,-95,95,122500,122600,32069,105031,114531
617.711485,2,5599,5589,10,-10,122500,122600,24738,-518838,-519838
617.711485,3,760,791,-31,31,122500,122600,24028,168572,171672
617.711485,4,120,50,70,-70,122500,122600,-2139,-30461,-37461
617.711485,5,3825,3814,11,-11,122500,122600,16923,-327223,-328323
617.711485,6,0,0,0,0,122500,122600,0,0,0
618.016268,0,621,721,-100,100,122400,122600,33913,271487,291487
618.016268,1,586,681,-95,95,122400,122600,32069,105031,124031
618.016268,2,5599,5592,7,-7,122400,122600,24701,-519701,-521101
618.016268,3,763,791,-28,28,122400,122600,24101,168799,174399
618.016268,4,120,50,70,-70,122400,122600,-2139,-30461,-44461
618.016268,5,3825,3814,11,-11,122400,122600,16923,-327223,-329423
618.016268,6,0,0,0,0,122400,122600,0,0,0
618.265366,0,621,721,-100,100,122400,122600,33913,271487,291487
618.265366,1,586,681,-95,95,122400,122600,32069,105031,124031
618.265366,2,5599,5592,7,-7,122400,122600,24701,-519701,-521101
618.265366,3,763,791,-28,28,122400,122600,24101,168799,174399
618.265366,4,120,50,70,-70,122400,122600,-2139,-30461,-44461
618.265366,5,3825,3814,11,-11,122400,122600,16923,-327223,-329423
618.265366,6,0,0,0,0,122400,122600,0,0,0
618.53136,0,621,721,-100,100,121900,122600,33913,271487,295987
618.53136,1,586,681,-95,95,121900,122600,32069,105031,128306
618.53136,2,5609,5592,17,-17,121900,122600,24579,-519579,-523744
618.53136,3,765,791,-26,26,121900,122600,24077,169423,175793
618.53136,4,120,50,70,-70,121900,122600,-2139,-30461,-47611
618.53136,5,3835,3814,21,-21,121900,122600,16801,-326101,-331246
618.53136,6,0,0,0,0,121900,122600,0,0,0
618.748901,0,621,721,-100,100,121900,122600,33913,271487,295987
618.748901,1,586,681,-95,95,121900,122600,32069,105031,128306
618.748901,2,5609,5592,17,-17,121900,122600,24579,-519579,-523744
618.748901,3,765,791,-26,26,121900,122600,24077,169423,175793
618.748901,4,120,50,70,-70,121900,122600,-2139,-30461,-47611
618.748901,5,3835,3814,21,-21,121900,122600,16801,-326101,-331246
618.748901,6,0,0,0,0,121900,122600,0,0,0
618.982884,0,621,721,-100,100,121900,122600,33913,271487,295987
618.982884,1,586,681,-95,95,121900,122600,32069,105031,128306
618.982884,2,5609,5592,17,-17,121900,122600,24579,-519579,-523744
618.982884,3,765,791,-26,26,121900,122600,24077,169423,175793
618.982884,4,120,50,70,-70,121900,122600,-2139,-30461,-47611
618.982884,5,3835,3814,21,-21,121900,122600,16801,-326101,-331246
618.982884,6,0,0,0,0,121900,122600,0,0,0
619.260108,0,621,721,-100,100,121900,122600,33913,271487,295987
619.260108,1,586,681,-95,95,121900,122600,32069,105031,128306
619.260108,2,5609,5592,17,-17,121900,122600,24579,-519579,-523744
619.260108,3,765,791,-26,26,121900,122600,24077,169423,175793
619.260108,4,120,50,70,-70,121900,122600,-2139,-30461,-47611
619.260108,5,3835,3814,21,-21,121900,122600,16801,-326101,-331246
619.260108,6,0,0,0,0,121900,122600,0,0,0
619.503038,0,621,721,-100,100,121900,122600,33913,271487,295987
619.503038,1,586,681,-95,95,121900,122600,32069,105031,128306
619.503038,2,5609,5592,17,-17,121900,122600,24579,-519579,-523744
619.503038,3,765,791,-26,26,121900,122600,24077,169423,175793
619.503038,4,120,50,70,-70,121900,122600,-2139,-30461,-47611
619.503038,5,3835,3814,21,-21,121900,122600,16801,-326101,-331246
619.503038,6,0,0,0,0,121900,122600,0,0,0
619.792294,0,621,721,-100,100,121900,122600,33913,271487,295987
619.792294,1,586,681,-95,95,121900,122600,32069,105031,128306
619.792294,2,5609,5592,17,-17,121900,122600,24579,-519579,-523744
619.792294,3,765,791,-26,26,121900,122600,24077,169423,175793
619.792294,4,120,50,70,-70,121900,122600,-2139,-30461,-47611
619.792294,5,3835,3814,21,-21,121900,122600,16801,-326101,-331246
619.792294,6,0,0,0,0,121900,122600,0,0,0
620.025332,0,621,721,-100,100,121900,122600,33913,271487,295987
620.025332,1,586,681,-95,95,121900,122600,32069,105031,128306
620.025332,2,5609,5592,17,-17,121900,122600,24579,-519579,-523744
620.025332,3,765,791,-26,26,121900,122600,24077,169423,175793
620.025332,4,120,50,70,-70,121900,122600,-2139,-30461,-47611
620.025332,5,3835,3814,21,-21,121900,122600,16801,-326101,-331246
620.025332,6,0,0,0,0,121900,122600,0,0,0
620.224593,0,621,721,-100,100,121900,122600,33913,271487,295987
620.224593,1,586,681,-95,95,121900,122600,32069,105031,128306
620.224593,2,5609,5592,17,-17,121900,122600,24579,-519579,-523744
620.224593,3,765,791,-26,26,121900,122600,24077,169423,175793
620.224593,4,120,50,70,-70,121900,122600,-2139,-30461,-47611
620.224593,5,3835,3814,21,-21,121900,122600,16801,-326101,-331246
620.224593,6,0,0,0,0,121900,122600,0,0,0
620.477338,0,621,721,-100,100,121900,122600,33913,271487,295987
620.477338,1,586,681,-95,95,121900,122600,32069,105031,128306
620.477338,2,5609,5592,17,-17,121900,122600,24579,-519579,-523744
620.477338,3,765,791,-26,26,121900,122600,24077,169423,175793
620.477338,4,120,50,70,-70,121900,122600,-2139,-30461,-47611
620.477338,5,3835,3814,21,-21,121900,122600,16801,-326101,-331246
620.477338,6,0,0,0,0,121900,122600,0,0,0
620.786709,0,621,721,-100,100,121900,122600,33913,271487,295987
620.786709,1,586,681,-95,95,121900,122600,32069,105031,128306
620.786709,2,5609,5592,17,-17,121900,122600,24579,-519579,-523744
620.786709,3,765,791,-26,26,121900,122600,24077,169423,175793
620.786709,4,120,50,70,-70,121900,122600,-2139,-30461,-47611
620.786709,5,3835,3814,21,-21,121900,122600,16801,-326101,-331246
620.786709,6,0,0,0,0,121900,122600,0,0,0
621.042851,0,621,721,-100,100,121900,122600,33913,271487,295987
621.042851,1,586,681,-95,95,121900,122600,32069,105031,128306
621.042851,2,5609,5592,17,-17,121900,122600,24579,-519579,-523744
621.042851,3,765,791,-26,26,121900,122600,24077,169423,175793
621.042851,4,120,50,70,-70,121900,122600,-2139,-30461,-47611
621.042851,5,3835,3814,21,-21,121900,122600,16801,-326101,-331246
621.042851,6,0,0,0,0,121900,122600,0,0,0
621.244503,0,621,721,-100,100,122900,122600,33913,271487,246987
621.244503,1,586,681,-95,95,122900,122600,32069,105031,81756
621.244503,2,5609,5602,7,-7,122900,122600,24457,-519457,-517742
621.244503,3,765,793,-28,28,122900,122600,24052,170248,163388
621.244503,4,120,50,70,-70,122900,122600,-2139,-30461,-13311
621.244503,5,3835,3814,21,-21,122900,122600,16801,-326101,-320956
621.244503,6,0,0,0,0,122900,122600,0,0,0
621.473639,0,621,721,-100,100,122900,122600,33913,271487,246987
621.473639,1,586,681,-95,95,122900,122600,32069,105031,81756
621.473639,2,5609,5602,7,-7,122900,122600,24457,-519457,-517742
621.473639,3,765,793,-28,28,122900,122600,24052,170248,163388
621.473639,4,120,50,70,-70,122900,122600,-2139,-30461,-13311
621.473639,5,3835,3814,21,-21,122900,122600,16801,-326101,-320956
621.473639,6,0,0,0,0,122900,122600,0,0,0
621.739049,0,621,721,-100,100,122900,122100,33913,271487,247087
621.739049,1,586,681,-95,95,122900,122100,32069,105031,81851
621.739049,2,5609,5602,7,-7,122900,122100,24457,-519457,-517749
621.739049,3,765,793,-28,28,122900,122100,24052,170248,163416
621.739049,4,120,50,70,-70,122900,122100,-2139,-30461,-13381
621.739049,5,3835,3814,21,-21,122900,122100,16801,-326101,-320977
621.739049,6,0,0,0,0,122900,122100,0,0,0
622.00477,0,621,721,-100,100,122900,122000,33913,271487,247087
622.00477,1,586,681,-95,95,122900,122000,32069,105031,81851
622.00477,2,5609,5602,7,-7,122900,122000,24457,-519457,-517749
622.00477,3,765,793,-28,28,122900,122000,24052,170248,163416
622.00477,4,120,50,70,-70,122900,122000,-2139,-30461,-13381
622.00477,5,3835,3814,21,-21,122900,122000,16801,-326101,-320977
622.00477,6,0,0,0,0,122900,122000,0,0,0
622.269542,0,621,721,-100,100,122900,122000,33913,271487,247087
622.269542,1,586,681,-95,95,122900,122000,32069,105031,81851
622.269542,2,5609,5602,7,-7,122900,122000,24457,-519457,-517749
622.269542,3,765,793,-28,28,122900,122000,24052,170248,163416
622.269542,4,120,50,70,-70,122900,122000,-2139,-30461,-13381
622.269542,5,3835,3814,21,-21,122900,122000,16801,-326101,-320977
622.269542,6,0,0,0,0,122900,122000,0,0,0
622.452819,0,621,721,-100,100,121900,122000,33913,271487,281487
622.452819,1,586,681,-95,95,121900,122000,32069,105031,114531
622.452819,2,5619,5602,17,-17,121900,122000,24335,-519335,-521035
622.452819,3,765,793,-28,28,121900,122000,24052,170248,173048
622.452819,4,120,50,70,-70,121900,122000,-2139,-30461,-37461
622.452819,5,3835,3824,11,-11,121900,122000,17045,-327345,-328445
622.452819,6,0,0,0,0,121900,122000,0,0,0
622.766804,0,621,721,-100,100,121400,122000,33913,271487,295887
622.766804,1,586,681,-95,95,121400,122000,32069,105031,128211
622.766804,2,5629,5612,17,-17,121400,122000,24457,-520457,-524605
622.766804,3,767,793,-26,26,121400,122000,24028,170672,177016
622.766804,4,120,50,70,-70,121400,122000,-2139,-30461,-47541
622.766804,5,3845,3824,21,-21,121400,122000,16923,-327223,-332347
622.766804,6,0,0,0,0,121400,122000,0,0,0
622.98509,0,621,721,-100,100,121400,122000,33913,271487,295887
622.98509,1,586,681,-95,95,121400,122000,32069,105031,128211
622.98509,2,5629,5612,17,-17,121400,122000,24457,-520457,-524605
622.98509,3,767,793,-26,26,121400,122000,24028,170672,177016
622.98509,4,120,50,70,-70,121400,122000,-2139,-30461,-47541
622.98509,5,3845,3824,21,-21,121400,122000,16923,-327223,-332347
622.98509,6,0,0,0,0,121400,122000,0,0,0
623.299895,0,621,721,-100,100,121400,122000,33913,271487,295887
623.299895,1,586,681,-95,95,121400,122000,32069,105031,128211
623.299895,2,5629,5612,17,-17,121400,122000,24457,-520457,-524605
623.299895,3,767,793,-26,26,121400,122000,24028,170672,177016
623.299895,4,120,50,70,-70,121400,122000,-2139,-30461,-47541
623.299895,5,3845,3824,21,-21,121400,122000,16923,-327223,-332347
623.299895,6,0,0,0,0,121400,122000,0,0,0
623.515889,0,621,721,-100,100,121400,121400,33913,271487,271487
623.515889,1,586,681,-95,95,121400,121400,32069,105031,105031
623.515889,2,5629,5612,17,-17,121400,121400,24457,-520457,-520457
623.515889,3,767,793,-26,26,121400,121400,24028,170672,170672
623.515889,4,120,50,70,-70,121400,121400,-2139,-30461,-30461
623.515889,5,3845,3824,21,-21,121400,121400,16923,-327223,-327223
623.515889,6,0,0,0,0,121400,121400,0,0,0
623.720165,0,621,721,-100,100,121400,121500,33913,271487,281487
623.720165,1,586,681,-95,95,121400,121500,32069,105031,114531
623.720165,2,5633,5622,11,-11,121400,121500,24652,-522652,-523752
623.720165,3,767,797,-30,30,121400,121500,24126,172174,175174
623.720165,4,120,50,70,-70,121400,121500,-2139,-30461,-37461
623.720165,5,3845,3824,21,-21,121400,121500,16923,-327223,-329323
623.720165,6,0,0,0,0,121400,121500,0,0,0
624.016883,0,621,721,-100,100,122000,121500,33913,271487,247187
624.016883,1,586,681,-95,95,122000,121500,32069,105031,81946
624.016883,2,5633,5632,1,-1,122000,121500,24530,-524530,-524287
624.016883,3,767,797,-30,30,122000,121500,24126,172174,164884
624.016883,4,120,50,70,-70,122000,121500,-2139,-30461,-13451
624.016883,5,3845,3834,11,-11,122000,121500,16801,-329101,-326428
624.016883,6,0,0,0,0,122000,121500,0,0,0
624.239668,0,621,721,-100,100,122300,121500,33913,271487,247187
624.239668,1,586,681,-95,95,122300,121500,32069,105031,81946
624.239668,2,5633,5642,-9,9,122300,121500,24408,-524408,-526595
624.239668,3,767,799,-32,32,122300,121500,24102,172798,165022
624.239668,4,120,50,70,-70,122300,121500,-2139,-30461,-13451
624.239668,5,3845,3844,1,-1,122300,121500,16679,-328979,-328736
624.239668,6,0,0,0,0,122300,121500,0,0,0
624.524916,0,621,721,-100,100,122300,121500,33913,271487,247187
624.524916,1,586,681,-95,95,122300,121500,32069,105031,81946
624.524916,2,5633,5642,-9,9,122300,121500,24408,-524408,-526595
624.524916,3,767,799,-32,32,122300,121500,24102,172798,165022
624.524916,4,120,50,70,-70,122300,121500,-2139,-30461,-13451
624.524916,5,3845,3844,1,-1,122300,121500,16679,-328979,-328736
624.524916,6,0,0,0,0,122300,121500,0,0,0
624.716329,0,621,721,-100,100,122300,121500,33913,271487,247187
624.716329,1,586,681,-95,95,122300,121500,32069,105031,81946
624.716329,2,5633,5642,-9,9,122300,121500,24408,-524408,-526595
624.716329,3,767,799,-32,32,122300,121500,24102,172798,165022
624.716329,4,120,50,70,-70,122300,121500,-2139,-30461,-13451
624.716329,5,3845,3844,1,-1,122300,121500,16679,-328979,-328736
624.716329,6,0,0,0,0,122300,121500,0,0,0
625.030627,0,621,721,-100,100,122300,121500,33913,271487,247187
625.030627,1,586,681,-95,95,122300,121500,32069,105031,81946
625.030627,2,5633,5642,-9,9,122300,121500,24408,-524408,-526595
625.030627,3,767,799,-32,32,122300,121500,24102,172798,165022
625.030627,4,120,50,70,-70,122300,121500,-2139,-30461,-13451
625.030627,5,3845,3844,1,-1,122300,121500,16679,-328979,-328736
625.030627,6,0,0,0,0,122300,121500,0,0,0
625.223902,0,621,721,-100,100,122300,121500,33913,271487,247187
625.223902,1,586,681,-95,95,122300,121500,32069,105031,81946
625.223902,2,5633,5642,-9,9,122300,121500,24408,-524408,-526595
625.223902,3,767,799,-32,32,122300,121500,24102,172798,165022
625.223902,4,120,50,70,-70,122300,121500,-2139,-30461,-13451
625.223902,5,3845,3844,1,-1,122300,121500,16679,-328979,-328736
625.223902,6,0,0,0,0,122300,121500,0,0,0
625.456235,0,621,721,-100,100,122300,121500,33913,271487,247187
625.456235,1,586,681,-95,95,122300,121500,32069,105031,81946
625.456235,2,5633,5642,-9,9,122300,121500,24408,-524408,-526595
625.456235,3,767,799,-32,32,122300,121500,24102,172798,165022
625.456235,4,120,50,70,-70,122300,121500,-2139,-30461,-13451
625.456235,5,3845,3844,1,-1,122300,121500,16679,-328979,-328736
625.456235,6,0,0,0,0,122300,121500,0,0,0
625.783921,0,621,721,-100,100,122300,121500,33913,271487,247187
625.783921,1,586,681,-95,95,122300,121500,32069,105031,81946
625.783921,2,5633,5642,-9,9,122300,121500,24408,-524408,-526595
625.783921,3,767,799,-32,32,122300,121500,24102,172798,165022
625.783921,4,120,50,70,-70,122300,121500,-2139,-30461,-13451
625.783921,5,3845,3844,1,-1,122300,121500,16679,-328979,-328736
625.783921,6,0,0,0,0,122300,121500,0,0,0
625.959855,0,621,721,-100,100,122300,121500,33913,271487,247187
625.959855,1,586,681,-95,95,122300,121500,32069,105031,81946
625.959855,2,5633,5642,-9,9,122300,121500,24408,-524408,-526595
625.959855,3,767,799,-32,32,122300,121500,24102,172798,165022
625.959855,4,120,50,70,-70,122300,121500,-2139,-30461,-13451
625.959855,5,3845,3844,1,-1,122300,121500,16679,-328979,-328736
625.959855,6,0,0,0,0,122300,121500,0,0,0
626.205562,0,621,721,-100,100,122400,121500,33913,271487,247187
626.205562,1,586,681,-95,95,122400,121500,32069,105031,81946
626.205562,2,5633,5652,-19,19,122400,121500,24286,-523286,-527903
626.205562,3,767,799,-32,32,122400,121500,24102,172798,165022
626.205562,4,120,50,70,-70,122400,121500,-2139,-30461,-13451
626.205562,5,3845,3854,-9,9,122400,121500,16557,-328857,-331044
626.205562,6,0,0,0,0,122400,121500,0,0,0
626.4831,0,621,721,-100,100,122400,121500,33913,271487,247187
626.4831,1,586,681,-95,95,122400,121500,32069,105031,81946
626.4831,2,5633,5652,-19,19,122400,121500,24286,-523286,-527903
626.4831,3,767,799,-32,32,122400,121500,24102,172798,165022
626.4831,4,120,50,70,-70,122400,121500,-2139,-30461,-13451
626.4831,5,3845,3854,-9,9,122400,121500,16557,-328857,-331044
626.4831,6,0,0,0,0,122400,121500,0,0,0
626.800125,0,621,721,-100,100,121700,121500,33913,271487,251487
626.800125,1,586,681,-95,95,121700,121500,32069,105031,86031
626.800125,2,5639,5652,-13,13,121700,121500,24213,-524413,-527013
626.800125,3,767,799,-32,32,121700,121500,24102,172798,166398
626.800125,4,120,50,70,-70,121700,121500,-2139,-30461,-16461
626.800125,5,3845,3854,-9,9,121700,121500,16557,-328857,-330657
626.800125,6,0,0,0,0,121700,121500,0,0,0
627.037236,0,621,721,-100,100,121700,121200,33913,271487,247287
627.037236,1,586,681,-95,95,121700,121200,32069,105031,82041
627.037236,2,5639,5652,-13,13,121700,121200,24213,-524413,-527559
627.037236,3,767,799,-32,32,121700,121200,24102,172798,165054
627.037236,4,120,50,70,-70,121700,121200,-2139,-30461,-13521
627.037236,5,3845,3854,-9,9,121700,121200,16557,-328857,-331035
627.037236,6,0,0,0,0,121700,121200,0,0,0
627.228775,0,621,721,-100,100,121400,121200,33913,271487,251487
627.228775,1,586,681,-95,95,121400,121200,32069,105031,86031
627.228775,2,5639,5662,-23,23,121400,121200,24456,-522656,-527256
627.228775,3,767,799,-32,32,121400,121200,24102,172798,166398
627.228775,4,120,50,70,-70,121400,121200,-2139,-30461,-16461
627.228775,5,3845,3854,-9,9,121400,121200,16557,-328857,-330657
627.228775,6,0,0,0,0,121400,121200,0,0,0
627.490837,0,621,721,-100,100,121800,121200,33913,271487,247287
627.490837,1,586,681,-95,95,121800,121200,32069,105031,82041
627.490837,2,5643,5672,-29,29,121800,121200,24359,-520759,-527777
627.490837,3,767,805,-38,38,121800,121200,24103,174197,165001
627.490837,4,120,50,70,-70,121800,121200,-2139,-30461,-13521
627.490837,5,3845,3854,-9,9,121800,121200,16557,-328857,-331035
627.490837,6,0,0,0,0,121800,121200,0,0,0
627.766026,0,621,721,-100,100,121800,121300,33913,271487,247187
627.766026,1,586,681,-95,95,121800,121300,32069,105031,81946
627.766026,2,5643,5672,-29,29,121800,121300,24359,-520759,-527806
627.766026,3,767,805,-38,38,121800,121300,24103,174197,164963
627.766026,4,120,50,70,-70,121800,121300,-2139,-30461,-13451
627.766026,5,3845,3854,-9,9,121800,121300,16557,-328857,-331044
627.766026,6,0,0,0,0,121800,121300,0,0,0
628.015464,0,621,721,-100,100,121500,121300,33913,271487,251487
628.015464,1,586,681,-95,95,121500,121300,32069,105031,86031
628.015464,2,5653,5672,-19,19,121500,121300,24237,-523637,-527437
628.015464,3,767,805,-38,38,121500,121300,24103,174197,166597
628.015464,4,120,50,70,-70,121500,121300,-2139,-30461,-16461
628.015464,5,3845,3864,-19,19,121500,121300,16800,-328100,-331900
628.015464,6,0,0,0,0,121500,121300,0,0,0
628.217425,0,621,721,-100,100,121600,121300,33913,271487,247187
628.217425,1,586,681,-95,95,121600,121300,32069,105031,81946
628.217425,2,5653,5682,-29,29,121600,121300,24480,-521880,-528927
628.217425,3,767,807,-40,40,121600,121300,24152,174548,164828
628.217425,4,120,50,70,-70,121600,121300,-2139,-30461,-13451
628.217425,5,3845,3864,-19,19,121600,121300,16800,-328100,-332717
628.217425,6,0,0,0,0,121600,121300,0,0,0
628.533478,0,621,721,-100,100,121600,121300,33913,271487,247187
628.533478,1,586,681,-95,95,121600,121300,32069,105031,81946
628.533478,2,5653,5682,-29,29,121600,121300,24480,-521880,-528927
628.533478,3,767,807,-40,40,121600,121300,24152,174548,164828
628.533478,4,120,50,70,-70,121600,121300,-2139,-30461,-13451
628.533478,5,3845,3874,-29,29,121600,121300,17043,-327343,-334390
628.533478,6,0,0,0,0,121600,121300,0,0,0
628.751332,0,621,721,-100,100,121800,121300,33913,271487,247187
628.751332,1,586,681,-95,95,121800,121300,32069,105031,81946
628.751332,2,5662,5692,-30,30,121800,121300,24249,-522249,-529539
628.751332,3,767,809,-42,42,121800,121300,24128,175172,164966
628.751332,4,120,50,70,-70,121800,121300,-2139,-30461,-13451
628.751332,5,3845,3884,-39,39,121800,121300,17286,-325586,-335063
628.751332,6,0,0,0,0,121800,121300,0,0,0
628.980617,0,621,721,-100,100,121800,121300,33913,271487,247187
628.980617,1,586,681,-95,95,121800,121300,32069,105031,81946
628.980617,2,5662,5702,-40,40,121800,121300,24493,-519493,-529213
628.980617,3,767,809,-42,42,121800,121300,24128,175172,164966
628.980617,4,120,50,70,-70,121800,121300,-2139,-30461,-13451
628.980617,5,3855,3884,-29,29,121800,121300,17164,-330464,-337511
628.980617,6,0,0,0,0,121800,121300,0,0,0
629.297161,0,621,721,-100,100,122000,121300,33913,271487,247187
629.297161,1,586,681,-95,95,122000,121300,32069,105031,81946
629.297161,2,5662,5712,-50,50,122000,121300,24371,-514371,-526521
629.297161,3,767,811,-44,44,122000,121300,24104,175996,165304
629.297161,4,120,50,70,-70,122000,121300,-2139,-30461,-13451
629.297161,5,3855,3884,-29,29,122000,121300,17164,-330464,-337511
629.297161,6,0,0,0,0,122000,121300,0,0,0
629.529011,0,621,721,-100,100,121800,121300,33913,271487,247187
629.529011,1,586,681,-95,95,121800,121300,32069,105031,81946
629.529011,2,5664,5712,-48,48,121800,121300,24347,-515347,-527011
629.529011,3,767,813,-46,46,121800,121300,24153,176547,165369
629.529011,4,120,50,70,-70,121800,121300,-2139,-30461,-13451
629.529011,5,3855,3884,-29,29,121800,121300,17164,-330464,-337511
629.529011,6,0,0,0,0,121800,121300,0,0,0
629.76745,0,621,721,-100,100,121700,121500,33913,271487,251487
629.76745,1,586,681,-95,95,121700,121500,32069,105031,86031
629.76745,2,5672,5712,-40,40,121700,121500,24250,-519250,-527250
629.76745,3,767,815,-48,48,121700,121500,24202,177298,167698
629.76745,4,120,50,70,-70,121700,121500,-2139,-30461,-16461
629.76745,5,3863,3884,-21,21,121700,121500,17067,-333567,-337767
629.76745,6,0,0,0,0,121700,121500,0,0,0
629.974582,0,621,721,-100,100,121700,121500,33913,271487,251487
629.974582,1,586,681,-95,95,121700,121500,32069,105031,86031
629.974582,2,5672,5712,-40,40,121700,121500,24250,-519250,-527250
629.974582,3,767,815,-48,48,121700,121500,24202,177298,167698
629.974582,4,120,50,70,-70,121700,121500,-2139,-30461,-16461
629.974582,5,3863,3884,-21,21,121700,121500,17067,-333567,-337767
629.974582,6,0,0,0,0,121700,121500,0,0,0
630.237072,0,621,721,-100,100,122000,121600,33913,271487,247187
630.237072,1,586,681,-95,95,122000,121600,32069,105031,81946
630.237072,2,5684,5712,-28,28,122000,121600,24177,-522977,-529781
630.237072,3,767,817,-50,50,122000,121600,24178,177722,165572
630.237072,4,120,50,70,-70,122000,121600,-2139,-30461,-13451
630.237072,5,3873,3884,-11,11,122000,121600,16945,-334445,-337118
630.237072,6,0,0,0,0,122000,121600,0,0,0
630.531718,0,621,721,-100,100,121900,121600,33913,271487,247187
630.531718,1,586,681,-95,95,121900,121600,32069,105031,81946
630.531718,2,5694,5712,-18,18,121900,121600,24055,-525855,-530229
630.531718,3,767,817,-50,50,121900,121600,24178,177722,165572
630.531718,4,120,50,70,-70,121900,121600,-2139,-30461,-13451
630.531718,5,3873,3884,-11,11,121900,121600,16945,-334445,-337118
630.531718,6,0,0,0,0,121900,121600,0,0,0
630.749872,0,621,721,-100,100,121900,121600,33913,271487,247187
630.749872,1,586,681,-95,95,121900,121600,32069,105031,81946
630.749872,2,5694,5712,-18,18,121900,121600,24055,-525855,-530229
630.749872,3,767,817,-50,50,121900,121600,24178,177722,165572
630.749872,4,120,50,70,-70,121900,121600,-2139,-30461,-13451
630.749872,5,3873,3884,-11,11,121900,121600,16945,-334445,-337118
630.749872,6,0,0,0,0,121900,121600,0,0,0
630.993202,0,621,721,-100,100,122000,121600,33913,271487,247187
630.993202,1,586,681,-95,95,122000,121600,32069,105031,81946
630.993202,2,5694,5720,-26,26,122000,121600,23957,-524957,-531275
630.993202,3,767,817,-50,50,122000,121600,24178,177722,165572
630.993202,4,120,50,70,-70,122000,121600,-2139,-30461,-13451
630.993202,5,3873,3884,-11,11,122000,121600,16945,-334445,-337118
630.993202,6,0,0,0,0,122000,121600,0,0,0
631.257677,0,621,721,-100,100,122000,121600,33913,271487,247187
631.257677,1,586,681,-95,95,122000,121600,32069,105031,81946
631.257677,2,5694,5720,-26,26,122000,121600,23957,-524957,-531275
631.257677,3,767,817,-50,50,122000,121600,24178,177722,165572
631.257677,4,120,50,70,-70,122000,121600,-2139,-30461,-13451
631.257677,5,3873,3884,-11,11,122000,121600,16945,-334445,-337118
631.257677,6,0,0,0,0,122000,121600,0,0,0
631.520052,0,621,721,-100,100,122100,121600,33913,271487,247187
631.520052,1,586,681,-95,95,122100,121600,32069,105031,81946
631.520052,2,5704,5720,-16,16,122100,121600,24201,-528201,-532089
631.520052,3,767,819,-52,52,122100,121600,24154,178146,165510
631.520052,4,120,50,70,-70,122100,121600,-2139,-30461,-13451
631.520052,5,3873,3892,-19,19,122100,121600,16847,-332747,-337364
631.520052,6,0,0,0,0,122100,121600,0,0,0
631.718845,0,621,721,-100,100,122100,121600,33913,271487,247187
631.718845,1,586,681,-95,95,122100,121600,32069,105031,81946
631.718845,2,5704,5720,-16,16,122100,121600,24201,-528201,-532089
631.718845,3,767,819,-52,52,122100,121600,24154,178146,165510
631.718845,4,120,50,70,-70,122100,121600,-2139,-30461,-13451
631.718845,5,3873,3892,-19,19,122100,121600,16847,-332747,-337364
631.718845,6,0,0,0,0,122100,121600,0,0,0
632.012681,0,621,721,-100,100,122100,121600,33913,271487,247187
632.012681,1,586,681,-95,95,122100,121600,32069,105031,81946
632.012681,2,5704,5720,-16,16,122100,121600,24201,-528201,-532089
632.012681,3,767,819,-52,52,122100,121600,24154,178146,165510
632.012681,4,120,50,70,-70,122100,121600,-2139,-30461,-13451
632.012681,5,3873,3892,-19,19,122100,121600,16847,-332747,-337364
632.012681,6,0,0,0,0,122100,121600,0,0,0
632.281631,0,621,721,-100,100,122100,121600,33913,271487,247187
632.281631,1,586,681,-95,95,122100,121600,32069,105031,81946
632.281631,2,5704,5720,-16,16,122100,121600,24201,-528201,-532089
632.281631,3,767,819,-52,52,122100,121600,24154,178146,165510
632.281631,4,120,50,70,-70,122100,121600,-2139,-30461,-13451
632.281631,5,3873,3892,-19,19,122100,121600,16847,-332747,-337364
632.281631,6,0,0,0,0,122100,121600,0,0,0
632.550881,0,621,721,-100,100,122100,121600,33913,271487,247187
632.550881,1,586,681,-95,95,122100,121600,32069,105031,81946
632.550881,2,5704,5720,-16,16,122100,121600,24201,-528201,-532089
632.550881,3,767,819,-52,52,122100,121600,24154,178146,165510
632.550881,4,120,50,70,-70,122100,121600,-2139,-30461,-13451
632.550881,5,3873,3892,-19,19,122100,121600,16847,-332747,-337364
632.550881,6,0,0,0,0,122100,121600,0,0,0
632.701797,0,621,721,-100,100,122100,121600,33913,271487,247187
632.701797,1,586,681,-95,95,122100,121600,32069,105031,81946
632.701797,2,5704,5720,-16,16,122100,121600,24201,-528201,-532089
632.701797,3,767,819,-52,52,122100,121600,24154,178146,165510
632.701797,4,120,50,70,-70,122100,121600,-2139,-30461,-13451
632.701797,5,3873,3892,-19,19,122100,121600,16847,-332747,-337364
632.701797,6,0,0,0,0,122100,121600,0,0,0
633.021808,0,621,721,-100,100,122100,121600,33913,271487,247187
633.021808,1,586,681,-95,95,122100,121600,32069,105031,81946
633.021808,2,5704,5720,-16,16,122100,121600,24201,-528201,-532089
633.021808,3,767,819,-52,52,122100,121600,24154,178146,165510
633.021808,4,120,50,70,-70,122100,121600,-2139,-30461,-13451
633.021808,5,3873,3892,-19,19,122100,121600,16847,-332747,-337364
633.021808,6,0,0,0,0,122100,121600,0,0,0
633.284167,0,621,721,-100,100,121900,121600,33913,271487,247187
633.284167,1,586,681,-95,95,121900,121600,32069,105031,81946
633.284167,2,5714,5720,-6,6,121900,121600,24079,-529079,-530537
633.284167,3,767,819,-52,52,121900,121600,24154,178146,165510
633.284167,4,120,50,70,-70,121900,121600,-2139,-30461,-13451
633.284167,5,3883,3892,-9,9,121900,121600,16725,-333625,-335812
633.284167,6,0,0,0,0,121900,121600,0,0,0
633.474688,0,621,721,-100,100,121900,121600,33913,271487,247187
633.474688,1,586,681,-95,95,121900,121600,32069,105031,81946
633.474688,2,5724,5720,4,-4,121900,121600,24323,-530323,-529351
633.474688,3,767,819,-52,52,121900,121600,24154,178146,165510
633.474688,4,120,50,70,-70,121900,121600,-2139,-30461,-13451
633.474688,5,3883,3892,-9,9,121900,121600,16725,-333625,-335812
633.474688,6,0,0,0,0,121900,121600,0,0,0
633.702835,0,621,721,-100,100,121900,122100,33913,271487,291487
633.702835,1,586,681,-95,95,121900,122100,32069,105031,124031
633.702835,2,5724,5720,4,-4,121900,122100,24323,-530323,-531123
633.702835,3,767,819,-52,52,121900,122100,24154,178146,188546
633.702835,4,120,50,70,-70,121900,122100,-2139,-30461,-44461
633.702835,5,3883,3892,-9,9,121900,122100,16725,-333625,-331825
633.702835,6,0,0,0,0,121900,122100,0,0,0
633.960011,0,621,721,-100,100,121900,122100,33913,271487,291487
633.960011,1,586,681,-95,95,121900,122100,32069,105031,124031
633.960011,2,5724,5720,4,-4,121900,122100,24323,-530323,-531123
633.960011,3,767,819,-52,52,121900,122100,24154,178146,188546
633.960011,4,120,50,70,-70,121900,122100,-2139,-30461,-44461
633.960011,5,3883,3892,-9,9,121900,122100,16725,-333625,-331825
633.960011,6,0,0,0,0,121900,122100,0,0,0
634.276663,0,621,721,-100,100,121400,122100,33913,271487,295887
634.276663,1,586,681,-95,95,121400,122100,32069,105031,128211
634.276663,2,5734,5720,14,-14,121400,122100,24201,-530201,-533617
634.276663,3,769,819,-50,50,121400,122100,24130,178370,190570
634.276663,4,120,50,70,-70,121400,122100,-2139,-30461,-47541
634.276663,5,3893,3892,1,-1,121400,122100,16603,-333503,-333747
634.276663,6,0,0,0,0,121400,122100,0,0,0
634.488871,0,621,721,-100,100,121400,122100,33913,271487,295887
634.488871,1,586,681,-95,95,121400,122100,32069,105031,128211
634.488871,2,5734,5720,14,-14,121400,122100,24201,-530201,-533617
634.488871,3,769,819,-50,50,121400,122100,24130,178370,190570
634.488871,4,120,50,70,-70,121400,122100,-2139,-30461,-47541
634.488871,5,3893,3892,1,-1,121400,122100,16603,-333503,-333747
634.488871,6,0,0,0,0,121400,122100,0,0,0
634.73372,0,621,721,-100,100,121900,122100,33913,271487,291487
634.73372,1,586,681,-95,95,121900,122100,32069,105031,124031
634.73372,2,5734,5720,14,-14,121900,122100,24201,-530201,-533001
634.73372,3,774,819,-45,45,121900,122100,24252,177248,186248
634.73372,4,120,50,70,-70,121900,122100,-2139,-30461,-44461
634.73372,5,3893,3892,1,-1,121900,122100,16603,-333503,-333703
634.73372,6,0,0,0,0,121900,122100,0,0,0
635.008998,0,621,721,-100,100,121900,122100,33913,271487,291487
635.008998,1,586,681,-95,95,121900,122100,32069,105031,124031
635.008998,2,5734,5720,14,-14,121900,122100,24201,-530201,-533001
635.008998,3,774,819,-45,45,121900,122100,24252,177248,186248
635.008998,4,120,50,70,-70,121900,122100,-2139,-30461,-44461
635.008998,5,3893,3892,1,-1,121900,122100,16603,-333503,-333703
635.008998,6,0,0,0,0,121900,122100,0,0,0
635.261155,0,621,721,-100,100,121900,122100,33913,271487,291487
635.261155,1,586,681,-95,95,121900,122100,32069,105031,124031
635.261155,2,5734,5720,14,-14,121900,122100,24201,-530201,-533001
635.261155,3,774,819,-45,45,121900,122100,24252,177248,186248
635.261155,4,120,50,70,-70,121900,122100,-2139,-30461,-44461
635.261155,5,3893,3892,1,-1,121900,122100,16603,-333503,-333703
635.261155,6,0,0,0,0,121900,122100,0,0,0
635.535769,0,621,721,-100,100,121800,122100,33913,271487,295887
635.535769,1,586,681,-95,95,121800,122100,32069,105031,128211
635.535769,2,5734,5724,10,-10,121800,122100,24152,-530552,-532992
635.535769,3,778,819,-41,41,121800,122100,24349,177151,187155
635.535769,4,120,50,70,-70,121800,122100,-2139,-30461,-47541
635.535769,5,3893,3892,1,-1,121800,122100,16603,-333503,-333747
635.535769,6,0,0,0,0,121800,122100,0,0,0
635.7255,0,621,721,-100,100,121700,122100,33913,271487,295887
635.7255,1,586,681,-95,95,121700,122100,32069,105031,128211
635.7255,2,5734,5734,0,0,121700,122100,24395,-531795,-531795
635.7255,3,778,819,-41,41,121700,122100,24349,177151,187155
635.7255,4,120,50,70,-70,121700,122100,-2139,-30461,-47541
635.7255,5,3903,3892,11,-11,121700,122100,16481,-334381,-337065
635.7255,6,0,0,0,0,121700,122100,0,0,0
635.978438,0,621,721,-100,100,121700,122100,33913,271487,295887
635.978438,1,586,681,-95,95,121700,122100,32069,105031,128211
635.978438,2,5734,5734,0,0,121700,122100,24395,-531795,-531795
635.978438,3,778,819,-41,41,121700,122100,24349,177151,187155
635.978438,4,120,50,70,-70,121700,122100,-2139,-30461,-47541
635.978438,5,3903,3892,11,-11,121700,122100,16481,-334381,-337065
635.978438,6,0,0,0,0,121700,122100,0,0,0
636.21706,0,621,721,-100,100,121900,122100,33913,271487,291487
636.21706,1,586,681,-95,95,121900,122100,32069,105031,124031
636.21706,2,5734,5744,-10,10,121900,122100,24273,-531673,-529673
636.21706,3,778,819,-41,41,121900,122100,24349,177151,185351
636.21706,4,120,50,70,-70,121900,122100,-2139,-30461,-44461
636.21706,5,3903,3902,1,-1,121900,122100,16359,-335259,-335459
636.21706,6,0,0,0,0,121900,122100,0,0,0
636.538504,0,621,721,-100,100,121900,122100,33913,271487,291487
636.538504,1,586,681,-95,95,121900,122100,32069,105031,124031
636.538504,2,5734,5744,-10,10,121900,122100,24273,-531673,-529673
636.538504,3,782,819,-37,37,121900,122100,24447,176253,183653
636.538504,4,120,50,70,-70,121900,122100,-2139,-30461,-44461
636.538504,5,3903,3902,1,-1,121900,122100,16359,-335259,-335459
636.538504,6,0,0,0,0,121900,122100,0,0,0
636.713401,0,621,721,-100,100,121900,122100,33913,271487,291487
636.713401,1,586,681,-95,95,121900,122100,32069,105031,124031
636.713401,2,5734,5744,-10,10,121900,122100,24273,-531673,-529673
636.713401,3,782,819,-37,37,121900,122100,24447,176253,183653
636.713401,4,120,50,70,-70,121900,122100,-2139,-30461,-44461
636.713401,5,3903,3902,1,-1,121900,122100,16359,-335259,-335459
636.713401,6,0,0,0,0,121900,122100,0,0,0
636.951919,0,621,721,-100,100,121900,121500,33913,271487,247187
636.951919,1,586,681,-95,95,121900,121500,32069,105031,81946
636.951919,2,5734,5744,-10,10,121900,121500,24273,-531673,-534103
636.951919,3,782,819,-37,37,121900,121500,24447,176253,167262
636.951919,4,120,50,70,-70,121900,121500,-2139,-30461,-13451
636.951919,5,3903,3902,1,-1,121900,121500,16359,-335259,-335016
636.951919,6,0,0,0,0,121900,121500,0,0,0
637.245766,0,621,721,-100,100,121600,121500,33913,271487,261487
637.245766,1,586,681,-95,95,121600,121500,32069,105031,95531
637.245766,2,5734,5754,-20,20,121600,121500,24516,-529916,-531916
637.245766,3,782,819,-37,37,121600,121500,24447,176253,172553
637.245766,4,120,50,70,-70,121600,121500,-2139,-30461,-23461
637.245766,5,3913,3902,11,-11,121600,121500,16237,-338137,-337037
637.245766,6,0,0,0,0,121600,121500,0,0,0
637.475177,0,621,721,-100,100,121600,121500,33913,271487,261487
637.475177,1,586,681,-95,95,121600,121500,32069,105031,95531
637.475177,2,5734,5754,-20,20,121600,121500,24516,-529916,-531916
637.475177,3,782,819,-37,37,121600,121500,24447,176253,172553
637.475177,4,120,50,70,-70,121600,121500,-2139,-30461,-23461
637.475177,5,3913,3902,11,-11,121600,121500,16237,-338137,-337037
637.475177,6,0,0,0,0,121600,121500,0,0,0
637.770687,0,621,721,-100,100,121600,121500,33913,271487,261487
637.770687,1,586,681,-95,95,121600,121500,32069,105031,95531
637.770687,2,5734,5754,-20,20,121600,121500,24516,-529916,-531916
637.770687,3,782,819,-37,37,121600,121500,24447,176253,172553
637.770687,4,120,50,70,-70,121600,121500,-2139,-30461,-23461
637.770687,5,3913,3902,11,-11,121600,121500,16237,-338137,-337037
637.770687,6,0,0,0,0,121600,121500,0,0,0
638.024796,0,621,721,-100,100,121600,121500,33913,271487,261487
638.024796,1,586,681,-95,95,121600,121500,32069,105031,95531
638.024796,2,5734,5754,-20,20,121600,121500,24516,-529916,-531916
638.024796,3,782,819,-37,37,121600,121500,24447,176253,172553
638.024796,4,120,50,70,-70,121600,121500,-2139,-30461,-23461
638.024796,5,3913,3902,11,-11,121600,121500,16237,-338137,-337037
638.024796,6,0,0,0,0,121600,121500,0,0,0
638.238984,0,621,721,-100,100,121500,121500,33913,271487,271487
638.238984,1,586,681,-95,95,121500,121500,32069,105031,105031
638.238984,2,5744,5754,-10,10,121500,121500,24394,-530794,-530794
638.238984,3,782,819,-37,37,121500,121500,24447,176253,176253
638.238984,4,120,50,70,-70,121500,121500,-2139,-30461,-30461
638.238984,5,3913,3912,1,-1,121500,121500,16480,-339380,-339380
638.238984,6,0,0,0,0,121500,121500,0,0,0
638.478304,0,621,721,-100,100,121500,121500,33913,271487,271487
638.478304,1,586,681,-95,95,121500,121500,32069,105031,105031
638.478304,2,5744,5754,-10,10,121500,121500,24394,-530794,-530794
638.478304,3,782,819,-37,37,121500,121500,24447,176253,176253
638.478304,4,120,50,70,-70,121500,121500,-2139,-30461,-30461
638.478304,5,3913,3912,1,-1,121500,121500,16480,-339380,-339380
638.478304,6,0,0,0,0,121500,121500,0,0,0
638.775923,0,621,721,-100,100,121500,121500,33913,271487,271487
638.775923,1,586,681,-95,95,121500,121500,32069,105031,105031
638.775923,2,5744,5754,-10,10,121500,121500,24394,-530794,-530794
638.775923,3,782,819,-37,37,121500,121500,24447,176253,176253
638.775923,4,120,50,70,-70,121500,121500,-2139,-30461,-30461
638.775923,5,3913,3912,1,-1,121500,121500,16480,-339380,-339380
638.775923,6,0,0,0,0,121500,121500,0,0,0
638.984064,0,621,721,-100,100,121900,121500,33913,271487,247187
638.984064,1,586,681,-95,95,121900,121500,32069,105031,81946
638.984064,2,5744,5764,-20,20,121900,121500,24272,-529672,-534532
638.984064,3,782,819,-37,37,121900,121500,24447,176253,167262
638.984064,4,120,50,70,-70,121900,121500,-2139,-30461,-13451
638.984064,5,3913,3922,-9,9,121900,121500,16358,-338258,-340445
638.984064,6,0,0,0,0,121900,121500,0,0,0
639.249309,0,621,721,-100,100,121900,121500,33913,271487,247187
639.249309,1,586,681,-95,95,121900,121500,32069,105031,81946
639.249309,2,5744,5764,-20,20,121900,121500,24272,-529672,-534532
639.249309,3,782,819,-37,37,121900,121500,24447,176253,167262
639.249309,4,120,50,70,-70,121900,121500,-2139,-30461,-13451
639.249309,5,3913,3922,-9,9,121900,121500,16358,-338258,-340445
639.249309,6,0,0,0,0,121900,121500,0,0,0
639.506608,0,621,721,-100,100,121800,121500,33913,271487,247187
639.506608,1,586,681,-95,95,121800,121500,32069,105031,81946
639.506608,2,5754,5764,-10,10,121800,121500,24516,-531916,-534346
639.506608,3,782,819,-37,37,121800,121500,24447,176253,167262
639.506608,4,120,50,70,-70,121800,121500,-2139,-30461,-13451
639.506608,5,3913,3932,-19,19,121800,121500,16236,-337136,-341753
639.506608,6,0,0,0,0,121800,121500,0,0,0
639.734515,0,621,721,-100,100,121700,121500,33913,271487,251487
639.734515,1,586,681,-95,95,121700,121500,32069,105031,86031
639.734515,2,5754,5774,-20,20,121700,121500,24759,-531159,-535159
639.734515,3,782,819,-37,37,121700,121500,24447,176253,168853
639.734515,4,120,50,70,-70,121700,121500,-2139,-30461,-16461
639.734515,5,3923,3932,-9,9,121700,121500,16114,-340014,-341814
639.734515,6,0,0,0,0,121700,121500,0,0,0
640.026891,0,621,721,-100,100,121700,121500,33913,271487,251487
640.026891,1,586,681,-95,95,121700,121500,32069,105031,86031
640.026891,2,5754,5774,-20,20,121700,121500,24759,-531159,-535159
640.026891,3,782,819,-37,37,121700,121500,24447,176253,168853
640.026891,4,120,50,70,-70,121700,121500,-2139,-30461,-16461
640.026891,5,3923,3932,-9,9,121700,121500,16114,-340014,-341814
640.026891,6,0,0,0,0,121700,121500,0,0,0
640.219652,0,621,721,-100,100,121700,121500,33913,271487,251487
640.219652,1,586,681,-95,95,121700,121500,32069,105031,86031
640.219652,2,5754,5774,-20,20,121700,121500,24759,-531159,-535159
640.219652,3,782,819,-37,37,121700,121500,24447,176253,168853
640.219652,4,120,50,70,-70,121700,121500,-2139,-30461,-16461
640.219652,5,3923,3932,-9,9,121700,121500,16114,-340014,-341814
640.219652,6,0,0,0,0,121700,121500,0,0,0
640.535448,0,621,721,-100,100,121700,121400,33913,271487,247187
640.535448,1,586,681,-95,95,121700,121400,32069,105031,81946
640.535448,2,5754,5774,-20,20,121700,121400,24759,-531159,-536019
640.535448,3,782,819,-37,37,121700,121400,24447,176253,167262
640.535448,4,120,50,70,-70,121700,121400,-2139,-30461,-13451
640.535448,5,3923,3932,-9,9,121700,121400,16114,-340014,-342201
640.535448,6,0,0,0,0,121700,121400,0,0,0
640.783457,0,621,721,-100,100,121700,121400,33913,271487,247187
640.783457,1,586,681,-95,95,121700,121400,32069,105031,81946
640.783457,2,5754,5774,-20,20,121700,121400,24759,-531159,-536019
640.783457,3,782,819,-37,37,121700,121400,24447,176253,167262
640.783457,4,120,50,70,-70,121700,121400,-2139,-30461,-13451
640.783457,5,3923,3932,-9,9,121700,121400,16114,-340014,-342201
640.783457,6,0,0,0,0,121700,121400,0,0,0
641.039074,0,621,721,-100,100,121700,121400,33913,271487,247187
641.039074,1,586,681,-95,95,121700,121400,32069,105031,81946
641.039074,2,5754,5774,-20,20,121700,121400,24759,-531159,-536019
641.039074,3,782,819,-37,37,121700,121400,24447,176253,167262
641.039074,4,120,50,70,-70,121700,121400,-2139,-30461,-13451
641.039074,5,3923,3932,-9,9,121700,121400,16114,-340014,-342201
641.039074,6,0,0,0,0,121700,121400,0,0,0
641.24868,0,621,721,-100,100,121600,121400,33913,271487,251487
641.24868,1,586,681,-95,95,121600,121400,32069,105031,86031
641.24868,2,5764,5774,-10,10,121600,121400,25002,-533402,-535402
641.24868,3,782,819,-37,37,121600,121400,24447,176253,168853
641.24868,4,120,50,70,-70,121600,121400,-2139,-30461,-16461
641.24868,5,3923,3942,-19,19,121600,121400,15992,-340892,-344692
641.24868,6,0,0,0,0,121600,121400,0,0,0
641.502,0,621,721,-100,100,121600,121400,33913,271487,251487
641.502,1,586,681,-95,95,121600,121400,32069,105031,86031
641.502,2,5764,5774,-10,10,121600,121400,25002,-533402,-535402
641.502,3,782,819,-37,37,121600,121400,24447,176253,168853
641.502,4,120,50,70,-70,121600,121400,-2139,-30461,-16461
641.502,5,3923,3942,-19,19,121600,121400,15992,-340892,-344692
641.502,6,0,0,0,0,121600,121400,0,0,0
641.71584,0,621,721,-100,100,121700,121400,33913,271487,247187
641.71584,1,586,681,-95,95,121700,121400,32069,105031,81946
641.71584,2,5764,5784,-20,20,121700,121400,24880,-532280,-537140
641.71584,3,782,819,-37,37,121700,121400,24447,176253,167262
641.71584,4,120,50,70,-70,121700,121400,-2139,-30461,-13451
641.71584,5,3933,3942,-9,9,121700,121400,16235,-344135,-346322
641.71584,6,0,0,0,0,121700,121400,0,0,0
641.959521,0,621,721,-100,100,121500,121400,33913,271487,261487
641.959521,1,586,681,-95,95,121500,121400,32069,105031,95531
641.959521,2,5768,5784,-16,16,121500,121400,24831,-533031,-534631
641.959521,3,782,819,-37,37,121500,121400,24447,176253,172553
641.959521,4,120,50,70,-70,121500,121400,-2139,-30461,-23461
641.959521,5,3933,3942,-9,9,121500,121400,16235,-344135,-345035
641.959521,6,0,0,0,0,121500,121400,0,0,0
642.215655,0,621,721,-100,100,121500,121400,33913,271487,261487
642.215655,1,586,681,-95,95,121500,121400,32069,105031,95531
642.215655,2,5768,5784,-16,16,121500,121400,24831,-533031,-534631
642.215655,3,782,819,-37,37,121500,121400,24447,176253,172553
642.215655,4,120,50,70,-70,121500,121400,-2139,-30461,-23461
642.215655,5,3933,3942,-9,9,121500,121400,16235,-344135,-345035
642.215655,6,0,0,0,0,121500,121400,0,0,0
642.458925,0,621,721,-100,100,121500,121400,33913,271487,261487
642.458925,1,586,681,-95,95,121500,121400,32069,105031,95531
642.458925,2,5768,5784,-16,16,121500,121400,24831,-533031,-534631
642.458925,3,782,819,-37,37,121500,121400,24447,176253,172553
642.458925,4,120,50,70,-70,121500,121400,-2139,-30461,-23461
642.458925,5,3933,3942,-9,9,121500,121400,16235,-344135,-345035
642.458925,6,0,0,0,0,121500,121400,0,0,0
642.736763,0,621,721,-100,100,121500,121400,33913,271487,261487
642.736763,1,586,681,-95,95,121500,121400,32069,105031,95531
642.736763,2,5768,5784,-16,16,121500,121400,24831,-533031,-534631
642.736763,3,782,819,-37,37,121500,121400,24447,176253,172553
642.736763,4,120,50,70,-70,121500,121400,-2139,-30461,-23461
642.736763,5,3933,3942,-9,9,121500,121400,16235,-344135,-345035
642.736763,6,0,0,0,0,121500,121400,0,0,0
643.03126,0,621,721,-100,100,121500,121400,33913,271487,261487
643.03126,1,586,681,-95,95,121500,121400,32069,105031,95531
643.03126,2,5768,5784,-16,16,121500,121400,24831,-533031,-534631
643.03126,3,782,819,-37,37,121500,121400,24447,176253,172553
643.03126,4,120,50,70,-70,121500,121400,-2139,-30461,-23461
643.03126,5,3933,3942,-9,9,121500,121400,16235,-344135,-345035
643.03126,6,0,0,0,0,121500,121400,0,0,0
643.227691,0,621,721,-100,100,122100,121400,33913,271487,247187
643.227691,1,586,681,-95,95,122100,121400,32069,105031,81946
643.227691,2,5768,5794,-26,26,122100,121400,24709,-531909,-538227
643.227691,3,782,821,-39,39,122100,121400,24423,176677,167200
643.227691,4,120,50,70,-70,122100,121400,-2139,-30461,-13451
643.227691,5,3933,3952,-19,19,122100,121400,16113,-344013,-348630
643.227691,6,0,0,0,0,122100,121400,0,0,0
643.502909,0,621,721,-100,100,122100,121400,33913,271487,247187
643.502909,1,586,681,-95,95,122100,121400,32069,105031,81946
643.502909,2,5768,5794,-26,26,122100,121400,24709,-531909,-538227
643.502909,3,782,821,-39,39,122100,121400,24423,176677,167200
643.502909,4,120,50,70,-70,122100,121400,-2139,-30461,-13451
643.502909,5,3933,3952,-19,19,122100,121400,16113,-344013,-348630
643.502909,6,0,0,0,0,122100,121400,0,0,0
643.763217,0,621,721,-100,100,121900,121400,33913,271487,247187
643.763217,1,586,681,-95,95,121900,121400,32069,105031,81946
643.763217,2,5770,5794,-24,24,121900,121400,24685,-532485,-538317
643.763217,3,782,823,-41,41,121900,121400,24472,176828,166865
643.763217,4,120,50,70,-70,121900,121400,-2139,-30461,-13451
643.763217,5,3933,3952,-19,19,121900,121400,16113,-344013,-348630
643.763217,6,0,0,0,0,121900,121400,0,0,0
643.972817,0,621,721,-100,100,121900,121900,33913,271487,271487
643.972817,1,586,681,-95,95,121900,121900,32069,105031,105031
643.972817,2,5770,5794,-24,24,121900,121900,24685,-532485,-532485
643.972817,3,782,823,-41,41,121900,121900,24472,176828,176828
643.972817,4,120,50,70,-70,121900,121900,-2139,-30461,-30461
643.972817,5,3933,3952,-19,19,121900,121900,16113,-344013,-344013
643.972817,6,0,0,0,0,121900,121900,0,0,0
644.300391,0,621,721,-100,100,122100,121900,33913,271487,251487
644.300391,1,586,681,-95,95,122100,121900,32069,105031,86031
644.300391,2,5780,5794,-14,14,122100,121900,24929,-534729,-537529
644.300391,3,782,823,-41,41,122100,121900,24472,176828,168628
644.300391,4,120,50,70,-70,122100,121900,-2139,-30461,-16461
644.300391,5,3933,3952,-19,19,122100,121900,16113,-344013,-347813
644.300391,6,0,0,0,0,122100,121900,0,0,0
644.550232,0,621,721,-100,100,122400,121900,33913,271487,247087
644.550232,1,586,681,-95,95,122400,121900,32069,105031,81851
644.550232,2,5780,5804,-24,24,122400,121900,24807,-532607,-538463
644.550232,3,782,827,-45,45,122400,121900,24497,177603,166623
644.550232,4,120,50,70,-70,122400,121900,-2139,-30461,-13381
644.550232,5,3935,3952,-17,17,122400,121900,16089,-344589,-348737
644.550232,6,0,0,0,0,122400,121900,0,0,0
644.718517,0,621,721,-100,100,121900,121900,33913,271487,271487
644.718517,1,586,681,-95,95,121900,121900,32069,105031,105031
644.718517,2,5790,5804,-14,14,121900,121900,24685,-535485,-535485
644.718517,3,782,827,-45,45,121900,121900,24497,177603,177603
644.718517,4,120,50,70,-70,121900,121900,-2139,-30461,-30461
644.718517,5,3945,3952,-7,7,121900,121900,15967,-347467,-347467
644.718517,6,0,0,0,0,121900,121900,0,0,0
644.958126,0,621,721,-100,100,121400,121900,33913,271487,295887
644.958126,1,586,681,-95,95,121400,121900,32069,105031,128211
644.958126,2,5800,5804,-4,4,121400,121900,24563,-537363,-536387
644.958126,3,782,827,-45,45,121400,121900,24497,177603,188583
644.958126,4,120,50,70,-70,121400,121900,-2139,-30461,-47541
644.958126,5,3955,3952,3,-3,121400,121900,15845,-349345,-350077
644.958126,6,0,0,0,0,121400,121900,0,0,0
645.284793,0,651,721,-70,70,121900,121900,34641,279759,279759
645.284793,1,586,681,-95,95,121900,121900,32069,105031,105031
645.284793,2,5800,5804,-4,4,121900,121900,24563,-537363,-537363
645.284793,3,786,827,-41,41,121900,121900,24595,176705,176705
645.284793,4,120,50,70,-70,121900,121900,-2139,-30461,-30461
645.284793,5,3959,3952,7,-7,121900,121900,15942,-348242,-348242
645.284793,6,0,0,0,0,121900,121900,0,0,0
645.453357,0,651,721,-70,70,122000,121900,34641,279759,272759
645.453357,1,586,681,-95,95,122000,121900,32069,105031,95531
645.453357,2,5810,5807,3,-3,122000,121900,24404,-537904,-537604
645.453357,3,790,827,-37,37,122000,121900,24692,175508,171808
645.453357,4,120,50,70,-70,122000,121900,-2139,-30461,-23461
645.453357,5,3959,3962,-3,3,122000,121900,16186,-349486,-349786
645.453357,6,0,0,0,0,122000,121900,0,0,0
645.757634,0,651,721,-70,70,122000,121900,34641,279759,272759
645.757634,1,586,681,-95,95,122000,121900,32069,105031,95531
645.757634,2,5810,5807,3,-3,122000,121900,24404,-537904,-537604
645.757634,3,790,827,-37,37,122000,121900,24692,175508,171808
645.757634,4,120,50,70,-70,122000,121900,-2139,-30461,-23461
645.757634,5,3959,3962,-3,3,122000,121900,16186,-349486,-349786
645.757634,6,0,0,0,0,122000,121900,0,0,0
645.962748,0,651,721,-70,70,122000,121900,34641,279759,272759
645.962748,1,586,681,-95,95,122000,121900,32069,105031,95531
645.962748,2,5810,5807,3,-3,122000,121900,24404,-537904,-537604
645.962748,3,790,827,-37,37,122000,121900,24692,175508,171808
645.962748,4,120,50,70,-70,122000,121900,-2139,-30461,-23461
645.962748,5,3959,3962,-3,3,122000,121900,16186,-349486,-349786
645.962748,6,0,0,0,0,122000,121900,0,0,0
646.287852,0,651,721,-70,70,122000,121900,34641,279759,272759
646.287852,1,586,681,-95,95,122000,121900,32069,105031,95531
646.287852,2,5810,5807,3,-3,122000,121900,24404,-537904,-537604
646.287852,3,790,827,-37,37,122000,121900,24692,175508,171808
646.287852,4,120,50,70,-70,122000,121900,-2139,-30461,-23461
646.287852,5,3959,3962,-3,3,122000,121900,16186,-349486,-349786
646.287852,6,0,0,0,0,122000,121900,0,0,0
646.550526,0,651,721,-70,70,122000,121900,34641,279759,272759
646.550526,1,586,681,-95,95,122000,121900,32069,105031,95531
646.550526,2,5810,5811,-1,1,122000,121900,24355,-537855,-537955
646.550526,3,794,827,-33,33,122000,121900,24790,174610,171310
646.550526,4,120,50,70,-70,122000,121900,-2139,-30461,-23461
646.550526,5,3959,3962,-3,3,122000,121900,16186,-349486,-349786
646.550526,6,0,0,0,0,122000,121900,0,0,0
646.744029,0,651,721,-70,70,122100,121900,34641,279759,265759
646.744029,1,586,681,-95,95,122100,121900,32069,105031,86031
646.744029,2,5810,5814,-4,4,122100,121900,24318,-537818,-538618
646.744029,3,794,827,-33,33,122100,121900,24790,174610,168010
646.744029,4,120,50,70,-70,122100,121900,-2139,-30461,-16461
646.744029,5,3959,3972,-13,13,122100,121900,16064,-349364,-351964
646.744029,6,0,0,0,0,122100,121900,0,0,0
646.962469,0,651,721,-70,70,122100,121900,34641,279759,265759
646.962469,1,586,681,-95,95,122100,121900,32069,105031,86031
646.962469,2,5810,5814,-4,4,122100,121900,24318,-537818,-538618
646.962469,3,794,827,-33,33,122100,121900,24790,174610,168010
646.962469,4,120,50,70,-70,122100,121900,-2139,-30461,-16461
646.962469,5,3959,3972,-13,13,122100,121900,16064,-349364,-351964
646.962469,6,0,0,0,0,122100,121900,0,0,0
647.210872,0,651,721,-70,70,122100,121900,34641,279759,265759
647.210872,1,586,681,-95,95,122100,121900,32069,105031,86031
647.210872,2,5810,5814,-4,4,122100,121900,24318,-537818,-538618
647.210872,3,794,827,-33,33,122100,121900,24790,174610,168010
647.210872,4,120,50,70,-70,122100,121900,-2139,-30461,-16461
647.210872,5,3959,3972,-13,13,122100,121900,16064,-349364,-351964
647.210872,6,0,0,0,0,122100,121900,0,0,0
647.541583,0,651,721,-70,70,122100,121900,34641,279759,265759
647.541583,1,586,681,-95,95,122100,121900,32069,105031,86031
647.541583,2,5810,5814,-4,4,122100,121900,24318,-537818,-538618
647.541583,3,794,827,-33,33,122100,121900,24790,174610,168010
647.541583,4,120,50,70,-70,122100,121900,-2139,-30461,-16461
647.541583,5,3959,3972,-13,13,122100,121900,16064,-349364,-351964
647.541583,6,0,0,0,0,122100,121900,0,0,0
647.727001,0,651,721,-70,70,122000,121900,34641,279759,272759
647.727001,1,586,681,-95,95,122000,121900,32069,105031,95531
647.727001,2,5810,5824,-14,14,122000,121900,24562,-537062,-538462
647.727001,3,794,827,-33,33,122000,121900,24790,174610,171310
647.727001,4,120,50,70,-70,122000,121900,-2139,-30461,-23461
647.727001,5,3969,3972,-3,3,122000,121900,15942,-351242,-351542
647.727001,6,0,0,0,0,122000,121900,0,0,0
648.021283,0,651,721,-70,70,122000,121900,34641,279759,272759
648.021283,1,586,681,-95,95,122000,121900,32069,105031,95531
648.021283,2,5810,5824,-14,14,122000,121900,24562,-537062,-538462
648.021283,3,794,827,-33,33,122000,121900,24790,174610,171310
648.021283,4,120,50,70,-70,122000,121900,-2139,-30461,-23461
648.021283,5,3969,3972,-3,3,122000,121900,15942,-351242,-351542
648.021283,6,0,0,0,0,122000,121900,0,0,0
648.246521,0,651,721,-70,70,122000,121900,34641,279759,272759
648.246521,1,586,681,-95,95,122000,121900,32069,105031,95531
648.246521,2,5810,5824,-14,14,122000,121900,24562,-537062,-538462
648.246521,3,794,827,-33,33,122000,121900,24790,174610,171310
648.246521,4,120,50,70,-70,122000,121900,-2139,-30461,-23461
648.246521,5,3969,3972,-3,3,122000,121900,15942,-351242,-351542
648.246521,6,0,0,0,0,122000,121900,0,0,0
648.451016,0,651,721,-70,70,122000,121900,34641,279759,272759
648.451016,1,586,681,-95,95,122000,121900,32069,105031,95531
648.451016,2,5810,5824,-14,14,122000,121900,24562,-537062,-538462
648.451016,3,794,827,-33,33,122000,121900,24790,174610,171310
648.451016,4,120,50,70,-70,122000,121900,-2139,-30461,-23461
648.451016,5,3969,3972,-3,3,122000,121900,15942,-351242,-351542
648.451016,6,0,0,0,0,122000,121900,0,0,0
648.758839,0,651,721,-70,70,122600,121900,34641,279759,262679
648.758839,1,586,681,-95,95,122600,121900,32069,105031,81851
648.758839,2,5810,5834,-24,24,122600,121900,24440,-534940,-540796
648.758839,3,794,829,-35,35,122600,121900,24766,175234,166694
648.758839,4,120,50,70,-70,122600,121900,-2139,-30461,-13381
648.758839,5,3969,3982,-13,13,122600,121900,15820,-349120,-352292
648.758839,6,0,0,0,0,122600,121900,0,0,0
649.005125,0,651,721,-70,70,122600,121900,34641,279759,262679
649.005125,1,586,681,-95,95,122600,121900,32069,105031,81851
649.005125,2,5810,5834,-24,24,122600,121900,24440,-534940,-540796
649.005125,3,794,829,-35,35,122600,121900,24766,175234,166694
649.005125,4,120,50,70,-70,122600,121900,-2139,-30461,-13381
649.005125,5,3969,3982,-13,13,122600,121900,15820,-349120,-352292
649.005125,6,0,0,0,0,122600,121900,0,0,0
649.254264,0,651,731,-80,80,122300,121900,34886,281514,261994
649.254264,1,586,681,-95,95,122300,121900,32069,105031,81851
649.254264,2,5820,5834,-14,14,122300,121900,24318,-538818,-542234
649.254264,3,794,829,-35,35,122300,121900,24766,175234,166694
649.254264,4,120,50,70,-70,122300,121900,-2139,-30461,-13381
649.254264,5,3969,3982,-13,13,122300,121900,15820,-349120,-352292
649.254264,6,0,0,0,0,122300,121900,0,0,0
649.47107,0,651,741,-90,90,122200,121700,35130,283270,261400
649.47107,1,586,681,-95,95,122200,121700,32069,105031,81946
649.47107,2,5830,5834,-4,4,122200,121700,24196,-542696,-543668
649.47107,3,794,829,-35,35,122200,121700,24766,175234,166729
649.47107,4,120,50,70,-70,122200,121700,-2139,-30461,-13451
649.47107,5,3969,3982,-13,13,122200,121700,15820,-349120,-352279
649.47107,6,0,0,0,0,122200,121700,0,0,0
649.710968,0,651,751,-100,100,121900,121700,35374,285026,265026
649.710968,1,586,681,-95,95,121900,121700,32069,105031,86031
649.710968,2,5840,5844,-4,4,121900,121700,24318,-545818,-546618
649.710968,3,794,829,-35,35,121900,121700,24766,175234,168234
649.710968,4,120,50,70,-70,121900,121700,-2139,-30461,-16461
649.710968,5,3979,3982,-3,3,121900,121700,15698,-351998,-352598
649.710968,6,0,0,0,0,121900,121700,0,0,0
650.047807,0,651,751,-100,100,121900,121700,35374,285026,265026
650.047807,1,586,681,-95,95,121900,121700,32069,105031,86031
650.047807,2,5840,5844,-4,4,121900,121700,24318,-545818,-546618
650.047807,3,794,829,-35,35,121900,121700,24766,175234,168234
650.047807,4,120,50,70,-70,121900,121700,-2139,-30461,-16461
650.047807,5,3979,3982,-3,3,121900,121700,15698,-351998,-352598
650.047807,6,0,0,0,0,121900,121700,0,0,0
650.216678,0,651,751,-100,100,121900,121700,35374,285026,265026
650.216678,1,586,681,-95,95,121900,121700,32069,105031,86031
650.216678,2,5840,5844,-4,4,121900,121700,24318,-545818,-546618
650.216678,3,794,829,-35,35,121900,121700,24766,175234,168234
650.216678,4,120,50,70,-70,121900,121700,-2139,-30461,-16461
650.216678,5,3979,3982,-3,3,121900,121700,15698,-351998,-352598
650.216678,6,0,0,0,0,121900,121700,0,0,0
650.496227,0,651,751,-100,100,121900,121700,35374,285026,265026
650.496227,1,586,681,-95,95,121900,121700,32069,105031,86031
650.496227,2,5840,5844,-4,4,121900,121700,24318,-545818,-546618
650.496227,3,794,829,-35,35,121900,121700,24766,175234,168234
650.496227,4,120,50,70,-70,121900,121700,-2139,-30461,-16461
650.496227,5,3979,3982,-3,3,121900,121700,15698,-351998,-352598
650.496227,6,0,0,0,0,121900,121700,0,0,0
650.703545,0,651,751,-100,100,121900,121800,35374,285026,275026
650.703545,1,586,681,-95,95,121900,121800,32069,105031,95531
650.703545,2,5840,5844,-4,4,121900,121800,24318,-545818,-546218
650.703545,3,794,829,-35,35,121900,121800,24766,175234,171734
650.703545,4,120,50,70,-70,121900,121800,-2139,-30461,-23461
650.703545,5,3979,3982,-3,3,121900,121800,15698,-351998,-352298
650.703545,6,0,0,0,0,121900,121800,0,0,0
650.9779,0,651,751,-100,100,121900,121900,35374,285026,285026
650.9779,1,586,681,-95,95,121900,121900,32069,105031,105031
650.9779,2,5840,5844,-4,4,121900,121900,24318,-545818,-545818
650.9779,3,794,829,-35,35,121900,121900,24766,175234,175234
650.9779,4,120,50,70,-70,121900,121900,-2139,-30461,-30461
650.9779,5,3979,3982,-3,3,121900,121900,15698,-351998,-351998
650.9779,6,0,0,0,0,121900,121900,0,0,0
651.292123,0,651,751,-100,100,121900,121900,35374,285026,285026
651.292123,1,586,681,-95,95,121900,121900,32069,105031,105031
651.292123,2,5840,5844,-4,4,121900,121900,24318,-545818,-545818
651.292123,3,794,829,-35,35,121900,121900,24766,175234,175234
651.292123,4,120,50,70,-70,121900,121900,-2139,-30461,-30461
651.292123,5,3979,3982,-3,3,121900,121900,15698,-351998,-351998
651.292123,6,0,0,0,0,121900,121900,0,0,0
651.504934,0,651,751,-100,100,121900,121900,35374,285026,285026
651.504934,1,586,681,-95,95,121900,121900,32069,105031,105031
651.504934,2,5840,5844,-4,4,121900,121900,24318,-545818,-545818
651.504934,3,794,829,-35,35,121900,121900,24766,175234,175234
651.504934,4,120,50,70,-70,121900,121900,-2139,-30461,-30461
651.504934,5,3979,3982,-3,3,121900,121900,15698,-351998,-351998
651.504934,6,0,0,0,0,121900,121900,0,0,0
651.723941,0,651,751,-100,100,121900,121900,35374,285026,285026
651.723941,1,586,681,-95,95,121900,121900,32069,105031,105031
651.723941,2,5840,5844,-4,4,121900,121900,24318,-545818,-545818
651.723941,3,794,829,-35,35,121900,121900,24766,175234,175234
651.723941,4,120,50,70,-70,121900,121900,-2139,-30461,-30461
651.723941,5,3979,3982,-3,3,121900,121900,15698,-351998,-351998
651.723941,6,0,0,0,0,121900,121900,0,0,0
652.04241,0,651,751,-100,100,121700,121900,35374,285026,305026
652.04241,1,586,681,-95,95,121700,121900,32069,105031,124031
652.04241,2,5850,5844,6,-6,121700,121900,24196,-546696,-547896
652.04241,3,794,829,-35,35,121700,121900,24766,175234,182234
652.04241,4,120,50,70,-70,121700,121900,-2139,-30461,-44461
652.04241,5,3989,3982,7,-7,121700,121900,15576,-351876,-353276
652.04241,6,0,0,0,0,121700,121900,0,0,0
652.221401,0,651,751,-100,100,121700,121900,35374,285026,305026
652.221401,1,586,681,-95,95,121700,121900,32069,105031,124031
652.221401,2,5850,5844,6,-6,121700,121900,24196,-546696,-547896
652.221401,3,794,829,-35,35,121700,121900,24766,175234,182234
652.221401,4,120,50,70,-70,121700,121900,-2139,-30461,-44461
652.221401,5,3989,3982,7,-7,121700,121900,15576,-351876,-353276
652.221401,6,0,0,0,0,121700,121900,0,0,0
652.486685,0,651,751,-100,100,121700,121600,35374,285026,275026
652.486685,1,586,681,-95,95,121700,121600,32069,105031,95531
652.486685,2,5850,5844,6,-6,121700,121600,24196,-546696,-546096
652.486685,3,794,829,-35,35,121700,121600,24766,175234,171734
652.486685,4,120,50,70,-70,121700,121600,-2139,-30461,-23461
652.486685,5,3989,3982,7,-7,121700,121600,15576,-351876,-351176
652.486685,6,0,0,0,0,121700,121600,0,0,0
652.755862,0,651,751,-100,100,121700,121600,35374,285026,275026
652.755862,1,586,681,-95,95,121700,121600,32069,105031,95531
652.755862,2,5850,5844,6,-6,121700,121600,24196,-546696,-546096
652.755862,3,794,829,-35,35,121700,121600,24766,175234,171734
652.755862,4,120,50,70,-70,121700,121600,-2139,-30461,-23461
652.755862,5,3989,3982,7,-7,121700,121600,15576,-351876,-351176
652.755862,6,0,0,0,0,121700,121600,0,0,0
652.979392,0,651,751,-100,100,121700,121600,35374,285026,275026
652.979392,1,586,681,-95,95,121700,121600,32069,105031,95531
652.979392,2,5850,5844,6,-6,121700,121600,24196,-546696,-546096
652.979392,3,794,829,-35,35,121700,121600,24766,175234,171734
652.979392,4,120,50,70,-70,121700,121600,-2139,-30461,-23461
652.979392,5,3989,3982,7,-7,121700,121600,15576,-351876,-351176
652.979392,6,0,0,0,0,121700,121600,0,0,0
653.28662,0,651,751,-100,100,121700,121600,35374,285026,275026
653.28662,1,586,681,-95,95,121700,121600,32069,105031,95531
653.28662,2,5850,5844,6,-6,121700,121600,24196,-546696,-546096
653.28662,3,794,829,-35,35,121700,121600,24766,175234,171734
653.28662,4,120,50,70,-70,121700,121600,-2139,-30461,-23461
653.28662,5,3989,3982,7,-7,121700,121600,15576,-351876,-351176
653.28662,6,0,0,0,0,121700,121600,0,0,0
653.489432,0,651,751,-100,100,121700,121600,35374,285026,275026
653.489432,1,586,681,-95,95,121700,121600,32069,105031,95531
653.489432,2,5850,5844,6,-6,121700,121600,24196,-546696,-546096
653.489432,3,794,829,-35,35,121700,121600,24766,175234,171734
653.489432,4,120,50,70,-70,121700,121600,-2139,-30461,-23461
653.489432,5,3989,3982,7,-7,121700,121600,15576,-351876,-351176
653.489432,6,0,0,0,0,121700,121600,0,0,0
653.727454,0,651,751,-100,100,121700,121600,35374,285026,275026
653.727454,1,586,681,-95,95,121700,121600,32069,105031,95531
653.727454,2,5850,5844,6,-6,121700,121600,24196,-546696,-546096
653.727454,3,794,829,-35,35,121700,121600,24766,175234,171734
653.727454,4,120,50,70,-70,121700,121600,-2139,-30461,-23461
653.727454,5,3989,3982,7,-7,121700,121600,15576,-351876,-351176
653.727454,6,0,0,0,0,121700,121600,0,0,0
653.988689,0,651,751,-100,100,121700,121600,35374,285026,275026
653.988689,1,586,681,-95,95,121700,121600,32069,105031,95531
653.988689,2,5850,5844,6,-6,121700,121600,24196,-546696,-546096
653.988689,3,794,829,-35,35,121700,121600,24766,175234,171734
653.988689,4,120,50,70,-70,121700,121600,-2139,-30461,-23461
653.988689,5,3989,3982,7,-7,121700,121600,15576,-351876,-351176
653.988689,6,0,0,0,0,121700,121600,0,0,0
654.257686,0,651,751,-100,100,121600,121600,35374,285026,285026
654.257686,1,606,681,-75,75,121600,121600,32555,106545,106545
654.257686,2,5860,5844,16,-16,121600,121600,24439,-545939,-545939
654.257686,3,797,829,-32,32,121600,121600,24839,175461,175461
654.257686,4,120,50,70,-70,121600,121600,-2139,-30461,-30461
654.257686,5,3999,3982,17,-17,121600,121600,15819,-351119,-351119
654.257686,6,0,0,0,0,121600,121600,0,0,0
654.511497,0,651,751,-100,100,122300,121800,35374,285026,260626
654.511497,1,606,681,-75,75,122300,121800,32555,106545,88245
654.511497,2,5860,5854,6,-6,122300,121800,24317,-547817,-546353
654.511497,3,797,831,-34,34,122300,121800,24815,175885,167589
654.511497,4,120,50,70,-70,122300,121800,-2139,-30461,-13381
654.511497,5,3999,3992,7,-7,122300,121800,15697,-351997,-350289
654.511497,6,0,0,0,0,122300,121800,0,0,0
654.736897,0,651,751,-100,100,122200,121800,35374,285026,260626
654.736897,1,606,701,-95,95,122200,121800,33043,112057,88877
654.736897,2,5860,5864,-4,4,122200,121800,24561,-545061,-546037
654.736897,3,797,833,-36,36,122200,121800,24864,176436,167652
654.736897,4,120,50,70,-70,122200,121800,-2139,-30461,-13381
654.736897,5,3999,4002,-3,3,122200,121800,15941,-349241,-349973
654.736897,6,0,0,0,0,122200,121800,0,0,0
654.978371,0,651,751,-100,100,122200,121800,35374,285026,260626
654.978371,1,606,701,-95,95,122200,121800,33043,112057,88877
654.978371,2,5860,5874,-14,14,122200,121800,24805,-542305,-545721
654.978371,3,797,837,-40,40,122200,121800,24962,177538,167778
654.978371,4,120,50,70,-70,122200,121800,-2139,-30461,-13381
654.978371,5,3999,4012,-13,13,122200,121800,16185,-346485,-349657
654.978371,6,0,0,0,0,122200,121800,0,0,0
655.250868,0,651,751,-100,100,122200,121800,35374,285026,260626
655.250868,1,606,701,-95,95,122200,121800,33043,112057,88877
655.250868,2,5860,5874,-14,14,122200,121800,24805,-542305,-545721
655.250868,3,797,837,-40,40,122200,121800,24962,177538,167778
655.250868,4,120,50,70,-70,122200,121800,-2139,-30461,-13381
655.250868,5,3999,4019,-20,20,122200,121800,16356,-344556,-349436
655.250868,6,0,0,0,0,122200,121800,0,0,0
655.502064,0,651,751,-100,100,122200,121800,35374,285026,260626
655.502064,1,606,701,-95,95,122200,121800,33043,112057,88877
655.502064,2,5860,5874,-14,14,122200,121800,24805,-542305,-545721
655.502064,3,797,837,-40,40,122200,121800,24962,177538,167778
655.502064,4,120,50,70,-70,122200,121800,-2139,-30461,-13381
655.502064,5,3999,4019,-20,20,122200,121800,16356,-344556,-349436
655.502064,6,0,0,0,0,122200,121800,0,0,0
655.709004,0,651,751,-100,100,122200,121800,35374,285026,260626
655.709004,1,606,701,-95,95,122200,121800,33043,112057,88877
655.709004,2,5860,5874,-14,14,122200,121800,24805,-542305,-545721
655.709004,3,797,837,-40,40,122200,121800,24962,177538,167778
655.709004,4,120,50,70,-70,122200,121800,-2139,-30461,-13381
655.709004,5,3999,4019,-20,20,122200,121800,16356,-344556,-349436
655.709004,6,0,0,0,0,122200,121800,0,0,0
655.981616,0,651,751,-100,100,122200,121800,35374,285026,260626
655.981616,1,606,701,-95,95,122200,121800,33043,112057,88877
655.981616,2,5860,5874,-14,14,122200,121800,24805,-542305,-545721
655.981616,3,797,837,-40,40,122200,121800,24962,177538,167778
655.981616,4,120,50,70,-70,122200,121800,-2139,-30461,-13381
655.981616,5,3999,4019,-20,20,122200,121800,16356,-344556,-349436
655.981616,6,0,0,0,0,122200,121800,0,0,0
656.290245,0,651,751,-100,100,122200,121800,35374,285026,260626
656.290245,1,606,701,-95,95,122200,121800,33043,112057,88877
656.290245,2,5860,5874,-14,14,122200,121800,24805,-542305,-545721
656.290245,3,797,837,-40,40,122200,121800,24962,177538,167778
656.290245,4,120,50,70,-70,122200,121800,-2139,-30461,-13381
656.290245,5,3999,4019,-20,20,122200,121800,16356,-344556,-349436
656.290245,6,0,0,0,0,122200,121800,0,0,0
656.451466,0,651,751,-100,100,121500,121800,35374,285026,309426
656.451466,1,606,701,-95,95,121500,121800,33043,112057,135237
656.451466,2,5870,5874,-4,4,121500,121800,24683,-544183,-543207
656.451466,3,799,837,-38,38,121500,121800,24938,178162,187434
656.451466,4,120,50,70,-70,121500,121800,-2139,-30461,-47541
656.451466,5,4009,4019,-10,10,121500,121800,16234,-345434,-342994
656.451466,6,0,0,0,0,121500,121800,0,0,0
656.780222,0,651,751,-100,100,121500,121800,35374,285026,309426
656.780222,1,606,701,-95,95,121500,121800,33043,112057,135237
656.780222,2,5880,5874,6,-6,121500,121800,24561,-545061,-546525
656.780222,3,801,837,-36,36,121500,121800,24914,178786,187570
656.780222,4,120,50,70,-70,121500,121800,-2139,-30461,-47541
656.780222,5,4019,4019,0,0,121500,121800,16112,-345312,-345312
656.780222,6,0,0,0,0,121500,121800,0,0,0
656.980509,0,651,751,-100,100,121500,121800,35374,285026,309426
656.980509,1,606,701,-95,95,121500,121800,33043,112057,135237
656.980509,2,5890,5874,16,-16,121500,121800,24439,-544939,-548843
656.980509,3,803,837,-34,34,121500,121800,24890,179410,187706
656.980509,4,120,50,70,-70,121500,121800,-2139,-30461,-47541
656.980509,5,4029,4019,10,-10,121500,121800,15990,-344190,-346630
656.980509,6,0,0,0,0,121500,121800,0,0,0
657.287603,0,651,751,-100,100,121500,121800,35374,285026,309426
657.287603,1,606,701,-95,95,121500,121800,33043,112057,135237
657.287603,2,5890,5874,16,-16,121500,121800,24439,-544939,-548843
657.287603,3,803,837,-34,34,121500,121800,24890,179410,187706
657.287603,4,120,50,70,-70,121500,121800,-2139,-30461,-47541
657.287603,5,4029,4019,10,-10,121500,121800,15990,-344190,-346630
657.287603,6,0,0,0,0,121500,121800,0,0,0
657.453535,0,651,751,-100,100,121500,121800,35374,285026,309426
657.453535,1,606,701,-95,95,121500,121800,33043,112057,135237
657.453535,2,5890,5874,16,-16,121500,121800,24439,-544939,-548843
657.453535,3,803,837,-34,34,121500,121800,24890,179410,187706
657.453535,4,120,50,70,-70,121500,121800,-2139,-30461,-47541
657.453535,5,4029,4019,10,-10,121500,121800,15990,-344190,-346630
657.453535,6,0,0,0,0,121500,121800,0,0,0
657.739433,0,651,751,-100,100,121500,121800,35374,285026,309426
657.739433,1,606,701,-95,95,121500,121800,33043,112057,135237
657.739433,2,5890,5874,16,-16,121500,121800,24439,-544939,-548843
657.739433,3,803,837,-34,34,121500,121800,24890,179410,187706
657.739433,4,120,50,70,-70,121500,121800,-2139,-30461,-47541
657.739433,5,4029,4019,10,-10,121500,121800,15990,-344190,-346630
657.739433,6,0,0,0,0,121500,121800,0,0,0
657.967581,0,651,751,-100,100,121500,121800,35374,285026,309426
657.967581,1,606,701,-95,95,121500,121800,33043,112057,135237
657.967581,2,5890,5874,16,-16,121500,121800,24439,-544939,-548843
657.967581,3,803,837,-34,34,121500,121800,24890,179410,187706
657.967581,4,120,50,70,-70,121500,121800,-2139,-30461,-47541
657.967581,5,4029,4019,10,-10,121500,121800,15990,-344190,-346630
657.967581,6,0,0,0,0,121500,121800,0,0,0
658.292885,0,651,751,-100,100,121500,122000,35374,285026,309426
658.292885,1,606,701,-95,95,121500,122000,33043,112057,135237
658.292885,2,5890,5874,16,-16,121500,122000,24439,-544939,-548843
658.292885,3,803,837,-34,34,121500,122000,24890,179410,187706
658.292885,4,120,50,70,-70,121500,122000,-2139,-30461,-47541
658.292885,5,4029,4019,10,-10,121500,122000,15990,-344190,-346630
658.292885,6,0,0,0,0,121500,122000,0,0,0
658.479675,0,651,751,-100,100,121800,122000,35374,285026,305026
658.479675,1,606,701,-95,95,121800,122000,33043,112057,131057
658.479675,2,5890,5876,14,-14,121800,122000,24488,-545188,-547988
658.479675,3,805,837,-32,32,121800,122000,24866,179234,185634
658.479675,4,120,50,70,-70,121800,122000,-2139,-30461,-44461
658.479675,5,4029,4019,10,-10,121800,122000,15990,-344190,-346190
658.479675,6,0,0,0,0,121800,122000,0,0,0
658.783782,0,651,751,-100,100,121800,122000,35374,285026,305026
658.783782,1,606,701,-95,95,121800,122000,33043,112057,131057
658.783782,2,5890,5876,14,-14,121800,122000,24488,-545188,-547988
658.783782,3,805,837,-32,32,121800,122000,24866,179234,185634
658.783782,4,120,50,70,-70,121800,122000,-2139,-30461,-44461
658.783782,5,4029,4019,10,-10,121800,122000,15990,-344190,-346190
658.783782,6,0,0,0,0,121800,122000,0,0,0
659.043721,0,651,751,-100,100,121700,122000,35374,285026,309426
659.043721,1,606,701,-95,95,121700,122000,33043,112057,135237
659.043721,2,5890,5886,4,-4,121700,122000,24731,-546431,-547407
659.043721,3,805,837,-32,32,121700,122000,24866,179234,187042
659.043721,4,120,50,70,-70,121700,122000,-2139,-30461,-47541
659.043721,5,4039,4019,20,-20,121700,122000,15868,-344068,-348948
659.043721,6,0,0,0,0,121700,122000,0,0,0
659.2302,0,651,751,-100,100,121700,121900,35374,285026,305026
659.2302,1,606,701,-95,95,121700,121900,33043,112057,131057
659.2302,2,5890,5886,4,-4,121700,121900,24731,-546431,-547231
659.2302,3,805,837,-32,32,121700,121900,24866,179234,185634
659.2302,4,120,50,70,-70,121700,121900,-2139,-30461,-44461
659.2302,5,4039,4019,20,-20,121700,121900,15868,-344068,-348068
659.2302,6,0,0,0,0,121700,121900,0,0,0
659.507697,0,651,751,-100,100,121700,121900,35374,285026,305026
659.507697,1,606,701,-95,95,121700,121900,33043,112057,131057
659.507697,2,5900,5886,14,-14,121700,121900,24609,-546309,-549109
659.507697,3,805,837,-32,32,121700,121900,24866,179234,185634
659.507697,4,120,50,70,-70,121700,121900,-2139,-30461,-44461
659.507697,5,4039,4029,10,-10,121700,121900,16111,-346311,-348311
659.507697,6,0,0,0,0,121700,121900,0,0,0
659.769233,0,651,751,-100,100,121300,121900,35374,285026,309426
659.769233,1,606,701,-95,95,121300,121900,33043,112057,135237
659.769233,2,5910,5886,24,-24,121300,121900,24487,-545187,-551043
659.769233,3,807,837,-30,30,121300,121900,24842,179858,187178
659.769233,4,120,50,70,-70,121300,121900,-2139,-30461,-47541
659.769233,5,4049,4029,20,-20,121300,121900,15989,-345189,-350069
659.769233,6,0,0,0,0,121300,121900,0,0,0
660.002539,0,651,751,-100,100,121300,121900,35374,285026,309426
660.002539,1,606,701,-95,95,121300,121900,33043,112057,135237
660.002539,2,5910,5886,24,-24,121300,121900,24487,-545187,-551043
660.002539,3,807,837,-30,30,121300,121900,24842,179858,187178
660.002539,4,120,50,70,-70,121300,121900,-2139,-30461,-47541
660.002539,5,4049,4029,20,-20,121300,121900,15989,-345189,-350069
660.002539,6,0,0,0,0,121300,121900,0,0,0
660.231998,0,651,751,-100,100,121700,121900,35374,285026,305026
660.231998,1,606,701,-95,95,121700,121900,33043,112057,131057
660.231998,2,5910,5889,21,-21,121700,121900,24450,-546050,-550250
660.231998,3,810,837,-27,27,121700,121900,24915,180085,185485
660.231998,4,120,50,70,-70,121700,121900,-2139,-30461,-44461
660.231998,5,4049,4029,20,-20,121700,121900,15989,-345189,-349189
660.231998,6,0,0,0,0,121700,121900,0,0,0
660.486371,0,651,751,-100,100,121700,121900,35374,285026,305026
660.486371,1,606,701,-95,95,121700,121900,33043,112057,131057
660.486371,2,5910,5893,17,-17,121700,121900,24401,-546401,-549801
660.486371,3,810,837,-27,27,121700,121900,24915,180085,185485
660.486371,4,120,50,70,-70,121700,121900,-2139,-30461,-44461
660.486371,5,4049,4029,20,-20,121700,121900,15989,-345189,-349189
660.486371,6,0,0,0,0,121700,121900,0,0,0
660.793444,0,651,751,-100,100,121300,121700,35374,285026,309326
660.793444,1,606,701,-95,95,121300,121700,33043,112057,135142
660.793444,2,5920,5896,24,-24,121300,121700,24242,-547542,-553374
660.793444,3,818,837,-19,19,121300,121700,25037,178363,182980
660.793444,4,120,50,70,-70,121300,121700,-2139,-30461,-47471
660.793444,5,4059,4029,30,-30,121300,121700,15867,-346067,-353357
660.793444,6,0,0,0,0,121300,121700,0,0,0
661.050751,0,651,751,-100,100,122200,121400,35374,285026,260726
661.050751,1,606,701,-95,95,122200,121400,33043,112057,88972
661.050751,2,5920,5906,14,-14,122200,121400,24121,-548421,-545019
661.050751,3,818,839,-21,21,122200,121400,25013,179187,174084
661.050751,4,120,50,70,-70,122200,121400,-2139,-30461,-13451
661.050751,5,4059,4029,30,-30,122200,121400,15867,-346067,-338777
661.050751,6,0,0,0,0,122200,121400,0,0,0
661.256865,0,651,751,-100,100,121800,121400,35374,285026,260726
661.256865,1,606,701,-95,95,121800,121400,33043,112057,88972
661.256865,2,5920,5916,4,-4,121800,121400,24365,-545665,-544693
661.256865,3,818,843,-25,25,121800,121400,25111,180289,174214
661.256865,4,120,50,70,-70,121800,121400,-2139,-30461,-13451
661.256865,5,4059,4029,30,-30,121800,121400,15867,-346067,-338777
661.256865,6,0,0,0,0,121800,121400,0,0,0
661.473046,0,651,751,-100,100,121800,121400,35374,285026,260726
661.473046,1,606,701,-95,95,121800,121400,33043,112057,88972
661.473046,2,5920,5916,4,-4,121800,121400,24365,-545665,-544693
661.473046,3,818,843,-25,25,121800,121400,25111,180289,174214
661.473046,4,120,50,70,-70,121800,121400,-2139,-30461,-13451
661.473046,5,4059,4029,30,-30,121800,121400,15867,-346067,-338777
661.473046,6,0,0,0,0,121800,121400,0,0,0
661.764647,0,651,751,-100,100,121300,121400,35374,285026,295026
661.764647,1,606,701,-95,95,121300,121400,33043,112057,121557
661.764647,2,5920,5916,4,-4,121300,121400,24365,-545665,-546065
661.764647,3,818,843,-25,25,121300,121400,25111,180289,182789
661.764647,4,120,50,70,-70,121300,121400,-2139,-30461,-37461
661.764647,5,4059,4029,30,-30,121300,121400,15867,-346067,-349067
661.764647,6,0,0,0,0,121300,121400,0,0,0
662.030105,0,651,751,-100,100,121300,121300,35374,285026,285026
662.030105,1,606,701,-95,95,121300,121300,33043,112057,112057
662.030105,2,5920,5916,4,-4,121300,121300,24365,-545665,-545665
662.030105,3,818,843,-25,25,121300,121300,25111,180289,180289
662.030105,4,120,50,70,-70,121300,121300,-2139,-30461,-30461
662.030105,5,4059,4029,30,-30,121300,121300,15867,-346067,-346067
662.030105,6,0,0,0,0,121300,121300,0,0,0
662.247698,0,651,751,-100,100,121300,121300,35374,285026,285026
662.247698,1,606,701,-95,95,121300,121300,33043,112057,112057
662.247698,2,5920,5916,4,-4,121300,121300,24365,-545665,-545665
662.247698,3,818,843,-25,25,121300,121300,25111,180289,180289
662.247698,4,120,50,70,-70,121300,121300,-2139,-30461,-30461
662.247698,5,4059,4029,30,-30,121300,121300,15867,-346067,-346067
662.247698,6,0,0,0,0,121300,121300,0,0,0
662.457054,0,651,751,-100,100,121800,121300,35374,285026,260726
662.457054,1,606,701,-95,95,121800,121300,33043,112057,88972
662.457054,2,5930,5926,4,-4,121800,121300,24486,-545786,-544814
662.457054,3,821,845,-24,24,121800,121300,25160,180840,175008
662.457054,4,120,50,70,-70,121800,121300,-2139,-30461,-13451
662.457054,5,4059,4029,30,-30,121800,121300,15867,-346067,-338777
662.457054,6,0,0,0,0,121800,121300,0,0,0
662.746704,0,651,751,-100,100,121800,121300,35374,285026,260726
662.746704,1,606,701,-95,95,121800,121300,33043,112057,88972
662.746704,2,5930,5936,-6,6,121800,121300,24730,-543030,-544488
662.746704,3,821,847,-26,26,121800,121300,25209,181391,175073
662.746704,4,120,50,70,-70,121800,121300,-2139,-30461,-13451
662.746704,5,4059,4029,30,-30,121800,121300,15867,-346067,-338777
662.746704,6,0,0,0,0,121800,121300,0,0,0
663.01662,0,651,751,-100,100,121800,121300,35374,285026,260726
663.01662,1,606,701,-95,95,121800,121300,33043,112057,88972
663.01662,2,5930,5946,-16,16,121800,121300,24974,-540274,-544162
663.01662,3,821,849,-28,28,121800,121300,25258,181942,175138
663.01662,4,120,50,70,-70,121800,121300,-2139,-30461,-13451
663.01662,5,4059,4029,30,-30,121800,121300,15867,-346067,-338777
663.01662,6,0,0,0,0,121800,121300,0,0,0
663.229213,0,651,751,-100,100,121800,121300,35374,285026,260726
663.229213,1,606,701,-95,95,121800,121300,33043,112057,88972
663.229213,2,5930,5956,-26,26,121800,121300,25218,-537518,-543836
663.229213,3,821,851,-30,30,121800,121300,25307,182493,175203
663.229213,4,120,50,70,-70,121800,121300,-2139,-30461,-13451
663.229213,5,4059,4029,30,-30,121800,121300,15867,-346067,-338777
663.229213,6,0,0,0,0,121800,121300,0,0,0
663.482676,0,651,751,-100,100,121600,121500,35374,285026,275026
663.482676,1,606,701,-95,95,121600,121500,33043,112057,102557
663.482676,2,5936,5956,-20,20,121600,121500,25145,-538045,-540045
663.482676,3,821,851,-30,30,121600,121500,25307,182493,179493
663.482676,4,120,50,70,-70,121600,121500,-2139,-30461,-23461
663.482676,5,4059,4039,20,-20,121600,121500,16110,-345510,-343510
663.482676,6,0,0,0,0,121600,121500,0,0,0
663.774419,0,651,751,-100,100,121800,121500,35374,285026,260726
663.774419,1,606,701,-95,95,121800,121500,33043,112057,88972
663.774419,2,5946,5956,-10,10,121800,121500,25023,-541923,-544353
663.774419,3,821,851,-30,30,121800,121500,25307,182493,175203
663.774419,4,120,50,70,-70,121800,121500,-2139,-30461,-13451
663.774419,5,4059,4049,10,-10,121800,121500,16354,-343754,-341324
663.774419,6,0,0,0,0,121800,121500,0,0,0
663.985749,0,651,751,-100,100,121600,121400,35374,285026,265026
663.985749,1,606,701,-95,95,121600,121400,33043,112057,93057
663.985749,2,5956,5956,0,0,121600,121400,24901,-543801,-543801
663.985749,3,821,851,-30,30,121600,121400,25307,182493,176493
663.985749,4,120,50,70,-70,121600,121400,-2139,-30461,-16461
663.985749,5,4059,4059,0,0,121600,121400,16597,-343997,-343997
663.985749,6,0,0,0,0,121600,121400,0,0,0
664.230106,0,651,751,-100,100,121600,121400,35374,285026,265026
664.230106,1,606,701,-95,95,121600,121400,33043,112057,93057
664.230106,2,5956,5956,0,0,121600,121400,24901,-543801,-543801
664.230106,3,821,851,-30,30,121600,121400,25307,182493,176493
664.230106,4,120,50,70,-70,121600,121400,-2139,-30461,-16461
664.230106,5,4059,4059,0,0,121600,121400,16597,-343997,-343997
664.230106,6,0,0,0,0,121600,121400,0,0,0
664.524752,0,651,751,-100,100,121600,121400,35374,285026,265026
664.524752,1,606,701,-95,95,121600,121400,33043,112057,93057
664.524752,2,5956,5956,0,0,121600,121400,24901,-543801,-543801
664.524752,3,821,851,-30,30,121600,121400,25307,182493,176493
664.524752,4,120,50,70,-70,121600,121400,-2139,-30461,-16461
664.524752,5,4059,4059,0,0,121600,121400,16597,-343997,-343997
664.524752,6,0,0,0,0,121600,121400,0,0,0
664.763405,0,651,751,-100,100,121300,121400,35374,285026,295026
664.763405,1,606,701,-95,95,121300,121400,33043,112057,121557
664.763405,2,5966,5956,10,-10,121300,121400,24780,-543680,-544680
664.763405,3,821,851,-30,30,121300,121400,25307,182493,185493
664.763405,4,120,50,70,-70,121300,121400,-2139,-30461,-37461
664.763405,5,4069,4059,10,-10,121300,121400,16476,-343876,-344876
664.763405,6,0,0,0,0,121300,121400,0,0,0
665.030116,0,651,751,-100,100,122000,121500,35374,285026,260726
665.030116,1,606,701,-95,95,122000,121500,33043,112057,88972
665.030116,2,5966,5966,0,0,122000,121500,24659,-545559,-545559
665.030116,3,821,853,-32,32,122000,121500,25283,182917,175141
665.030116,4,120,50,70,-70,122000,121500,-2139,-30461,-13451
665.030116,5,4069,4069,0,0,122000,121500,16354,-344754,-344754
665.030116,6,0,0,0,0,122000,121500,0,0,0
665.242805,0,651,751,-100,100,122000,121600,35374,285026,260726
665.242805,1,606,701,-95,95,122000,121600,33043,112057,88972
665.242805,2,5966,5966,0,0,122000,121600,24659,-545559,-545559
665.242805,3,821,853,-32,32,122000,121600,25283,182917,175141
665.242805,4,120,50,70,-70,122000,121600,-2139,-30461,-13451
665.242805,5,4069,4069,0,0,122000,121600,16354,-344754,-344754
665.242805,6,0,0,0,0,122000,121600,0,0,0
665.503091,0,651,751,-100,100,121800,121800,35374,285026,285026
665.503091,1,606,701,-95,95,121800,121800,33043,112057,112057
665.503091,2,5976,5966,10,-10,121800,121800,24902,-545802,-545802
665.503091,3,824,853,-29,29,121800,121800,25356,182244,182244
665.503091,4,120,50,70,-70,121800,121800,-2139,-30461,-30461
665.503091,5,4069,4082,-13,13,121800,121800,16195,-345295,-345295
665.503091,6,0,0,0,0,121800,121800,0,0,0
665.717156,0,651,751,-100,100,122200,121800,35374,285026,260626
665.717156,1,606,701,-95,95,122200,121800,33043,112057,88877
665.717156,2,5976,5976,0,0,122200,121800,24780,-546680,-546680
665.717156,3,827,853,-26,26,122200,121800,25429,180371,174027
665.717156,4,120,50,70,-70,122200,121800,-2139,-30461,-13381
665.717156,5,4079,4082,-3,3,122200,121800,16438,-346538,-347270
665.717156,6,0,0,0,0,122200,121800,0,0,0
665.966563,0,651,751,-100,100,122100,121800,35374,285026,260626
665.966563,1,606,701,-95,95,122100,121800,33043,112057,88877
665.966563,2,5976,5976,0,0,122100,121800,24780,-546680,-546680
665.966563,3,827,855,-28,28,122100,121800,25405,181195,174363
665.966563,4,120,50,70,-70,122100,121800,-2139,-30461,-13381
665.966563,5,4079,4087,-8,8,122100,121800,16377,-344477,-346429
665.966563,6,0,0,0,0,122100,121800,0,0,0
666.24294,0,661,751,-90,90,122300,122000,35619,280781,258821
666.24294,1,606,701,-95,95,122300,122000,33043,112057,88877
666.24294,2,5976,5996,-20,20,122300,122000,24902,-548802,-553682
666.24294,3,830,857,-27,27,122300,122000,25454,179946,173358
666.24294,4,120,50,70,-70,122300,122000,-2139,-30461,-13381
666.24294,5,4089,4097,-8,8,122300,122000,16133,-347233,-349185
666.24294,6,0,0,0,0,122300,122000,0,0,0
666.512563,0,661,751,-90,90,122300,122000,35619,280781,258821
666.512563,1,606,701,-95,95,122300,122000,33043,112057,88877
666.512563,2,5976,5996,-20,20,122300,122000,24902,-548802,-553682
666.512563,3,833,857,-24,24,122300,122000,25527,178973,173117
666.512563,4,120,50,70,-70,122300,122000,-2139,-30461,-13381
666.512563,5,4089,4097,-8,8,122300,122000,16133,-347233,-349185
666.512563,6,0,0,0,0,122300,122000,0,0,0
666.726294,0,661,751,-90,90,122300,122200,35619,280781,271781
666.726294,1,606,701,-95,95,122300,122200,33043,112057,102557
666.726294,2,5986,5996,-10,10,122300,122200,25147,-550047,-551047
666.726294,3,833,857,-24,24,122300,122200,25527,178973,176573
666.726294,4,120,50,70,-70,122300,122200,-2139,-30461,-23461
666.726294,5,4089,4097,-8,8,122300,122200,16133,-347233,-348033
666.726294,6,0,0,0,0,122300,122200,0,0,0
666.998089,0,661,751,-90,90,122700,122100,35619,280781,258821
666.998089,1,606,701,-95,95,122700,122100,33043,112057,88877
666.998089,2,5986,6006,-20,20,122700,122100,25025,-546925,-551805
666.998089,3,833,859,-26,26,122700,122100,25502,179798,173454
666.998089,4,120,50,70,-70,122700,122100,-2139,-30461,-13381
666.998089,5,4089,4107,-18,18,122700,122100,16011,-345111,-349503
666.998089,6,0,0,0,0,122700,122100,0,0,0
667.245409,0,661,751,-90,90,122700,122100,35619,280781,258821
667.245409,1,606,701,-95,95,122700,122100,33043,112057,88877
667.245409,2,5986,6006,-20,20,122700,122100,25025,-546925,-551805
667.245409,3,833,859,-26,26,122700,122100,25502,179798,173454
667.245409,4,120,50,70,-70,122700,122100,-2139,-30461,-13381
667.245409,5,4089,4107,-18,18,122700,122100,16011,-345111,-349503
667.245409,6,0,0,0,0,122700,122100,0,0,0
667.460452,0,661,751,-90,90,122700,122100,35619,280781,258821
667.460452,1,606,701,-95,95,122700,122100,33043,112057,88877
667.460452,2,5986,6016,-30,30,122700,122100,24903,-545803,-553123
667.460452,3,833,861,-28,28,122700,122100,25478,180222,173390
667.460452,4,120,50,70,-70,122700,122100,-2139,-30461,-13381
667.460452,5,4089,4117,-28,28,122700,122100,15889,-344989,-351821
667.460452,6,0,0,0,0,122700,122100,0,0,0
667.750765,0,661,751,-90,90,122700,122100,35619,280781,258821
667.750765,1,606,701,-95,95,122700,122100,33043,112057,88877
667.750765,2,5986,6016,-30,30,122700,122100,24903,-545803,-553123
667.750765,3,833,861,-28,28,122700,122100,25478,180222,173390
667.750765,4,120,50,70,-70,122700,122100,-2139,-30461,-13381
667.750765,5,4089,4117,-28,28,122700,122100,15889,-344989,-351821
667.750765,6,0,0,0,0,122700,122100,0,0,0
667.959911,0,661,761,-100,100,122400,122200,35864,282536,262536
667.959911,1,606,701,-95,95,122400,122200,33043,112057,93057
667.959911,2,5986,6016,-30,30,122400,122200,24903,-545803,-551803
667.959911,3,833,861,-28,28,122400,122200,25478,180222,174622
667.959911,4,120,50,70,-70,122400,122200,-2139,-30461,-16461
667.959911,5,4095,4117,-22,22,122400,122200,15816,-347316,-351716
667.959911,6,0,0,0,0,122400,122200,0,0,0
668.217431,0,661,761,-100,100,122400,122200,35864,282536,262536
668.217431,1,606,701,-95,95,122400,122200,33043,112057,93057
668.217431,2,5988,6016,-28,28,122400,122200,24879,-546379,-551979
668.217431,3,833,863,-30,30,122400,122200,25527,180373,174373
668.217431,4,120,50,70,-70,122400,122200,-2139,-30461,-16461
668.217431,5,4095,4117,-22,22,122400,122200,15816,-347316,-351716
668.217431,6,0,0,0,0,122400,122200,0,0,0
668.474806,0,661,761,-100,100,122200,122200,35864,282536,282536
668.474806,1,606,701,-95,95,122200,122200,33043,112057,112057
668.474806,2,5988,6026,-38,38,122200,122200,25124,-543624,-543624
668.474806,3,833,863,-30,30,122200,122200,25527,180373,180373
668.474806,4,120,50,70,-70,122200,122200,-2139,-30461,-30461
668.474806,5,4110,4117,-7,7,122200,122200,15633,-353633,-353633
668.474806,6,0,0,0,0,122200,122200,0,0,0
668.751713,0,661,761,-100,100,122300,122200,35864,282536,272536
668.751713,1,606,701,-95,95,122300,122200,33043,112057,102557
668.751713,2,5992,6026,-34,34,122300,122200,25149,-545249,-548649
668.751713,3,833,867,-34,34,122300,122200,25552,181148,177748
668.751713,4,120,50,70,-70,122300,122200,-2139,-30461,-23461
668.751713,5,4110,4117,-7,7,122300,122200,15633,-353633,-354333
668.751713,6,0,0,0,0,122300,122200,0,0,0
669.050101,0,661,761,-100,100,122300,122200,35864,282536,272536
669.050101,1,606,701,-95,95,122300,122200,33043,112057,102557
669.050101,2,5998,6026,-28,28,122300,122200,25076,-547576,-550376
669.050101,3,833,867,-34,34,122300,122200,25552,181148,177748
669.050101,4,120,50,70,-70,122300,122200,-2139,-30461,-23461
669.050101,5,4110,4123,-13,13,122300,122200,15780,-352580,-353880
669.050101,6,0,0,0,0,122300,122200,0,0,0
669.222953,0,661,761,-100,100,122300,122200,35864,282536,272536
669.222953,1,606,701,-95,95,122300,122200,33043,112057,102557
669.222953,2,5998,6026,-28,28,122300,122200,25076,-547576,-550376
669.222953,3,833,867,-34,34,122300,122200,25552,181148,177748
669.222953,4,120,50,70,-70,122300,122200,-2139,-30461,-23461
669.222953,5,4110,4123,-13,13,122300,122200,15780,-352580,-353880
669.222953,6,0,0,0,0,122300,122200,0,0,0
669.483748,0,661,761,-100,100,122600,122200,35864,282536,258136
669.483748,1,606,701,-95,95,122600,122200,33043,112057,88877
669.483748,2,5998,6036,-38,38,122600,122200,24954,-544454,-553726
669.483748,3,833,869,-36,36,122600,122200,25528,181772,172988
669.483748,4,120,50,70,-70,122600,122200,-2139,-30461,-13381
669.483748,5,4110,4127,-17,17,122600,122200,15731,-351731,-355879
669.483748,6,0,0,0,0,122600,122200,0,0,0
669.758924,0,661,761,-100,100,122600,122200,35864,282536,258136
669.758924,1,606,701,-95,95,122600,122200,33043,112057,88877
669.758924,2,5998,6036,-38,38,122600,122200,24954,-544454,-553726
669.758924,3,833,869,-36,36,122600,122200,25528,181772,172988
669.758924,4,120,50,70,-70,122600,122200,-2139,-30461,-13381
669.758924,5,4110,4127,-17,17,122600,122200,15731,-351731,-355879
669.758924,6,0,0,0,0,122600,122200,0,0,0
670.021548,0,661,761,-100,100,122400,122200,35864,282536,262536
670.021548,1,606,701,-95,95,122400,122200,33043,112057,93057
670.021548,2,5998,6036,-38,38,122400,122200,24954,-544454,-552054
670.021548,3,833,871,-38,38,122400,122200,25504,182396,174796
670.021548,4,120,50,70,-70,122400,122200,-2139,-30461,-16461
670.021548,5,4110,4134,-24,24,122400,122200,15645,-349545,-354345
670.021548,6,0,0,0,0,122400,122200,0,0,0
670.248769,0,661,761,-100,100,122100,122200,35864,282536,292536
670.248769,1,606,701,-95,95,122100,122200,33043,112057,121557
670.248769,2,6008,6036,-28,28,122100,122200,24832,-548332,-545532
670.248769,3,833,871,-38,38,122100,122200,25504,182396,186196
670.248769,4,120,50,70,-70,122100,122200,-2139,-30461,-37461
670.248769,5,4110,4134,-24,24,122100,122200,15645,-349545,-347145
670.248769,6,0,0,0,0,122100,122200,0,0,0
670.538965,0,661,761,-100,100,121400,121900,35864,282536,306936
670.538965,1,606,701,-95,95,121400,121900,33043,112057,135237
670.538965,2,6018,6036,-18,18,121400,121900,24710,-551210,-546818
670.538965,3,835,871,-36,36,121400,121900,25480,183020,191804
670.538965,4,120,50,70,-70,121400,121900,-2139,-30461,-47541
670.538965,5,4120,4134,-14,14,121400,121900,15523,-353423,-350007
670.538965,6,0,0,0,0,121400,121900,0,0,0
670.750125,0,661,761,-100,100,121400,121900,35864,282536,306936
670.750125,1,606,701,-95,95,121400,121900,33043,112057,135237
670.750125,2,6018,6036,-18,18,121400,121900,24710,-551210,-546818
670.750125,3,835,871,-36,36,121400,121900,25480,183020,191804
670.750125,4,120,50,70,-70,121400,121900,-2139,-30461,-47541
670.750125,5,4120,4134,-14,14,121400,121900,15523,-353423,-350007
670.750125,6,0,0,0,0,121400,121900,0,0,0
670.958811,0,661,761,-100,100,121400,121900,35864,282536,306936
670.958811,1,606,701,-95,95,121400,121900,33043,112057,135237
670.958811,2,6018,6036,-18,18,121400,121900,24710,-551210,-546818
670.958811,3,835,871,-36,36,121400,121900,25480,183020,191804
670.958811,4,120,50,70,-70,121400,121900,-2139,-30461,-47541
670.958811,5,4120,4134,-14,14,121400,121900,15523,-353423,-350007
670.958811,6,0,0,0,0,121400,121900,0,0,0
671.206137,0,661,761,-100,100,122000,121900,35864,282536,272536
671.206137,1,606,701,-95,95,122000,121900,33043,112057,102557
671.206137,2,6018,6036,-18,18,122000,121900,24710,-551210,-553010
671.206137,3,835,873,-38,38,122000,121900,25529,183171,179371
671.206137,4,120,50,70,-70,122000,121900,-2139,-30461,-23461
671.206137,5,4122,4134,-12,12,122000,121900,15499,-353999,-355199
671.206137,6,0,0,0,0,122000,121900,0,0,0
671.483908,0,661,761,-100,100,122000,121900,35864,282536,272536
671.483908,1,606,701,-95,95,122000,121900,33043,112057,102557
671.483908,2,6018,6036,-18,18,122000,121900,24710,-551210,-553010
671.483908,3,835,873,-38,38,122000,121900,25529,183171,179371
671.483908,4,120,50,70,-70,122000,121900,-2139,-30461,-23461
671.483908,5,4122,4134,-12,12,122000,121900,15499,-353999,-355199
671.483908,6,0,0,0,0,122000,121900,0,0,0
671.784304,0,661,761,-100,100,122000,121900,35864,282536,272536
671.784304,1,606,701,-95,95,122000,121900,33043,112057,102557
671.784304,2,6018,6036,-18,18,122000,121900,24710,-551210,-553010
671.784304,3,835,873,-38,38,122000,121900,25529,183171,179371
671.784304,4,120,50,70,-70,122000,121900,-2139,-30461,-23461
671.784304,5,4122,4134,-12,12,122000,121900,15499,-353999,-355199
671.784304,6,0,0,0,0,122000,121900,0,0,0
672.000312,0,661,761,-100,100,122000,121900,35864,282536,272536
672.000312,1,606,701,-95,95,122000,121900,33043,112057,102557
672.000312,2,6018,6036,-18,18,122000,121900,24710,-551210,-553010
672.000312,3,835,873,-38,38,122000,121900,25529,183171,179371
672.000312,4,120,50,70,-70,122000,121900,-2139,-30461,-23461
672.000312,5,4122,4134,-12,12,122000,121900,15499,-353999,-355199
672.000312,6,0,0,0,0,122000,121900,0,0,0
672.267031,0,661,761,-100,100,122000,121800,35864,282536,262536
672.267031,1,606,701,-95,95,122000,121800,33043,112057,93057
672.267031,2,6018,6036,-18,18,122000,121800,24710,-551210,-554810
672.267031,3,835,873,-38,38,122000,121800,25529,183171,175571
672.267031,4,120,50,70,-70,122000,121800,-2139,-30461,-16461
672.267031,5,4122,4134,-12,12,122000,121800,15499,-353999,-356399
672.267031,6,0,0,0,0,122000,121800,0,0,0
672.486453,0,661,761,-100,100,122000,121800,35864,282536,262536
672.486453,1,606,701,-95,95,122000,121800,33043,112057,93057
672.486453,2,6028,6036,-8,8,122000,121800,24588,-555088,-556688
672.486453,3,835,873,-38,38,122000,121800,25529,183171,175571
672.486453,4,120,50,70,-70,122000,121800,-2139,-30461,-16461
672.486453,5,4122,4144,-22,22,122000,121800,15743,-353243,-357643
672.486453,6,0,0,0,0,122000,121800,0,0,0
672.744867,0,661,761,-100,100,122100,121800,35864,282536,258136
672.744867,1,606,701,-95,95,122100,121800,33043,112057,88877
672.744867,2,6028,6046,-18,18,122100,121800,24832,-554332,-558724
672.744867,3,835,875,-40,40,122100,121800,25505,183595,173835
672.744867,4,120,50,70,-70,122100,121800,-2139,-30461,-13381
672.744867,5,4132,4154,-22,22,122100,121800,15499,-354999,-360367
672.744867,6,0,0,0,0,122100,121800,0,0,0
672.984532,0,661,761,-100,100,122200,121800,35864,282536,258136
672.984532,1,606,701,-95,95,122200,121800,33043,112057,88877
672.984532,2,6028,6056,-28,28,122200,121800,25076,-551576,-558408
672.984532,3,835,877,-42,42,122200,121800,25554,184146,173898
672.984532,4,120,50,70,-70,122200,121800,-2139,-30461,-13381
672.984532,5,4132,4154,-22,22,122200,121800,15499,-354999,-360367
672.984532,6,0,0,0,0,122200,121800,0,0,0
673.246479,0,661,761,-100,100,122200,121800,35864,282536,258136
673.246479,1,606,701,-95,95,122200,121800,33043,112057,88877
673.246479,2,6028,6056,-28,28,122200,121800,25076,-551576,-558408
673.246479,3,835,877,-42,42,122200,121800,25554,184146,173898
673.246479,4,120,50,70,-70,122200,121800,-2139,-30461,-13381
673.246479,5,4132,4164,-32,32,122200,121800,15743,-353243,-361051
673.246479,6,0,0,0,0,122200,121800,0,0,0
673.461597,0,661,761,-100,100,122200,121800,35864,282536,258136
673.461597,1,606,701,-95,95,122200,121800,33043,112057,88877
673.461597,2,6028,6056,-28,28,122200,121800,25076,-551576,-558408
673.461597,3,835,877,-42,42,122200,121800,25554,184146,173898
673.461597,4,120,50,70,-70,122200,121800,-2139,-30461,-13381
673.461597,5,4132,4164,-32,32,122200,121800,15743,-353243,-361051
673.461597,6,0,0,0,0,122200,121800,0,0,0
673.708197,0,661,761,-100,100,122200,122000,35864,282536,262536
673.708197,1,606,701,-95,95,122200,122000,33043,112057,93057
673.708197,2,6028,6056,-28,28,122200,122000,25076,-551576,-557176
673.708197,3,835,879,-44,44,122200,122000,25603,184297,175497
673.708197,4,120,50,70,-70,122200,122000,-2139,-30461,-16461
673.708197,5,4132,4164,-32,32,122200,122000,15743,-353243,-359643
673.708197,6,0,0,0,0,122200,122000,0,0,0
673.995672,0,661,761,-100,100,122200,122000,35864,282536,262536
673.995672,1,606,701,-95,95,122200,122000,33043,112057,93057
673.995672,2,6028,6056,-28,28,122200,122000,25076,-551576,-557176
673.995672,3,835,879,-44,44,122200,122000,25603,184297,175497
673.995672,4,120,50,70,-70,122200,122000,-2139,-30461,-16461
673.995672,5,4132,4164,-32,32,122200,122000,15743,-353243,-359643
673.995672,6,0,0,0,0,122200,122000,0,0,0
674.270741,0,661,761,-100,100,122300,122000,35864,282536,258136
674.270741,1,606,701,-95,95,122300,122000,33043,112057,88877
674.270741,2,6028,6056,-28,28,122300,122000,25076,-551576,-558408
674.270741,3,835,879,-44,44,122300,122000,25603,184297,173561
674.270741,4,120,50,70,-70,122300,122000,-2139,-30461,-13381
674.270741,5,4141,4164,-23,23,122300,122000,15963,-356163,-361775
674.270741,6,0,0,0,0,122300,122000,0,0,0
674.459619,0,661,761,-100,100,122300,122000,35864,282536,258136
674.459619,1,606,701,-95,95,122300,122000,33043,112057,88877
674.459619,2,6028,6056,-28,28,122300,122000,25076,-551576,-558408
674.459619,3,835,879,-44,44,122300,122000,25603,184297,173561
674.459619,4,120,50,70,-70,122300,122000,-2139,-30461,-13381
674.459619,5,4141,4164,-23,23,122300,122000,15963,-356163,-361775
674.459619,6,0,0,0,0,122300,122000,0,0,0
674.721099,0,661,761,-100,100,122300,122000,35864,282536,258136
674.721099,1,606,701,-95,95,122300,122000,33043,112057,88877
674.721099,2,6028,6056,-28,28,122300,122000,25076,-551576,-558408
674.721099,3,835,879,-44,44,122300,122000,25603,184297,173561
674.721099,4,120,50,70,-70,122300,122000,-2139,-30461,-13381
674.721099,5,4141,4164,-23,23,122300,122000,15963,-356163,-361775
674.721099,6,0,0,0,0,122300,122000,0,0,0
675.004692,0,661,761,-100,100,122200,122000,35864,282536,262536
675.004692,1,606,701,-95,95,122200,122000,33043,112057,93057
675.004692,2,6028,6056,-28,28,122200,122000,25076,-551576,-557176
675.004692,3,835,881,-46,46,122200,122000,25652,184648,175448
675.004692,4,120,50,70,-70,122200,122000,-2139,-30461,-16461
675.004692,5,4141,4164,-23,23,122200,122000,15963,-356163,-360763
675.004692,6,0,0,0,0,122200,122000,0,0,0
675.262886,0,661,761,-100,100,122200,122000,35864,282536,262536
675.262886,1,606,701,-95,95,122200,122000,33043,112057,93057
675.262886,2,6028,6056,-28,28,122200,122000,25076,-551576,-557176
675.262886,3,835,881,-46,46,122200,122000,25652,184648,175448
675.262886,4,120,50,70,-70,122200,122000,-2139,-30461,-16461
675.262886,5,4141,4164,-23,23,122200,122000,15963,-356163,-360763
675.262886,6,0,0,0,0,122200,122000,0,0,0
675.515118,0,661,761,-100,100,122200,122000,35864,282536,262536
675.515118,1,606,701,-95,95,122200,122000,33043,112057,93057
675.515118,2,6028,6056,-28,28,122200,122000,25076,-551576,-557176
675.515118,3,835,881,-46,46,122200,122000,25652,184648,175448
675.515118,4,120,50,70,-70,122200,122000,-2139,-30461,-16461
675.515118,5,4141,4164,-23,23,122200,122000,15963,-356163,-360763
675.515118,6,0,0,0,0,122200,122000,0,0,0
675.749197,0,661,761,-100,100,122200,122000,35864,282536,262536
675.749197,1,606,701,-95,95,122200,122000,33043,112057,93057
675.749197,2,6028,6056,-28,28,122200,122000,25076,-551576,-557176
675.749197,3,835,883,-48,48,122200,122000,25701,184799,175199
675.749197,4,120,50,70,-70,122200,122000,-2139,-30461,-16461
675.749197,5,4141,4164,-23,23,122200,122000,15963,-356163,-360763
675.749197,6,0,0,0,0,122200,122000,0,0,0
676.047267,0,661,761,-100,100,122200,122000,35864,282536,262536
676.047267,1,606,701,-95,95,122200,122000,33043,112057,93057
676.047267,2,6028,6056,-28,28,122200,122000,25076,-551576,-557176
676.047267,3,835,883,-48,48,122200,122000,25701,184799,175199
676.047267,4,120,50,70,-70,122200,122000,-2139,-30461,-16461
676.047267,5,4141,4164,-23,23,122200,122000,15963,-356163,-360763
676.047267,6,0,0,0,0,122200,122000,0,0,0
676.207384,0,661,761,-100,100,122200,122000,35864,282536,262536
676.207384,1,606,701,-95,95,122200,122000,33043,112057,93057
676.207384,2,6028,6056,-28,28,122200,122000,25076,-551576,-557176
676.207384,3,835,885,-50,50,122200,122000,25750,184950,174950
676.207384,4,120,50,70,-70,122200,122000,-2139,-30461,-16461
676.207384,5,4141,4164,-23,23,122200,122000,15963,-356163,-360763
676.207384,6,0,0,0,0,122200,122000,0,0,0
676.498446,0,661,761,-100,100,122200,122000,35864,282536,262536
676.498446,1,606,701,-95,95,122200,122000,33043,112057,93057
676.498446,2,6028,6056,-28,28,122200,122000,25076,-551576,-557176
676.498446,3,835,885,-50,50,122200,122000,25750,184950,174950
676.498446,4,120,50,70,-70,122200,122000,-2139,-30461,-16461
676.498446,5,4141,4164,-23,23,122200,122000,15963,-356163,-360763
676.498446,6,0,0,0,0,122200,122000,0,0,0
676.764534,0,661,761,-100,100,122600,122000,35864,282536,258136
676.764534,1,606,701,-95,95,122600,122000,33043,112057,88877
676.764534,2,6028,6066,-38,38,122600,122000,24954,-548454,-557726
676.764534,3,835,887,-52,52,122600,122000,25726,185574,172886
676.764534,4,120,50,70,-70,122600,122000,-2139,-30461,-13381
676.764534,5,4141,4174,-33,33,122600,122000,15841,-353041,-361093
676.764534,6,0,0,0,0,122600,122000,0,0,0
676.962807,0,661,761,-100,100,122600,122000,35864,282536,258136
676.962807,1,606,701,-95,95,122600,122000,33043,112057,88877
676.962807,2,6028,6066,-38,38,122600,122000,24954,-548454,-557726
676.962807,3,835,887,-52,52,122600,122000,25726,185574,172886
676.962807,4,120,50,70,-70,122600,122000,-2139,-30461,-13381
676.962807,5,4141,4174,-33,33,122600,122000,15841,-353041,-361093
676.962807,6,0,0,0,0,122600,122000,0,0,0
677.2858,0,661,761,-100,100,122000,122100,35864,282536,292536
677.2858,1,606,701,-95,95,122000,122100,33043,112057,121557
677.2858,2,6038,6066,-28,28,122000,122100,24832,-552332,-549532
677.2858,3,835,887,-52,52,122000,122100,25726,185574,190774
677.2858,4,120,50,70,-70,122000,122100,-2139,-30461,-37461
677.2858,5,4151,4174,-23,23,122000,122100,15719,-355919,-353619
677.2858,6,0,0,0,0,122000,122100,0,0,0
677.462125,0,661,761,-100,100,122800,122100,35864,282536,258136
677.462125,1,606,701,-95,95,122800,122100,33043,112057,88877
677.462125,2,6038,6076,-38,38,122800,122100,24709,-548209,-557481
677.462125,3,835,889,-54,54,122800,122100,25701,186399,173223
677.462125,4,120,50,70,-70,122800,122100,-2139,-30461,-13381
677.462125,5,4151,4184,-33,33,122800,122100,15596,-350796,-358848
677.462125,6,0,0,0,0,122800,122100,0,0,0
677.786565,0,661,761,-100,100,122800,122100,35864,282536,258136
677.786565,1,606,701,-95,95,122800,122100,33043,112057,88877
677.786565,2,6038,6076,-38,38,122800,122100,24709,-548209,-557481
677.786565,3,835,889,-54,54,122800,122100,25701,186399,173223
677.786565,4,120,50,70,-70,122800,122100,-2139,-30461,-13381
677.786565,5,4151,4184,-33,33,122800,122100,15596,-350796,-358848
677.786565,6,0,0,0,0,122800,122100,0,0,0
677.981428,0,661,761,-100,100,122800,122100,35864,282536,258136
677.981428,1,606,701,-95,95,122800,122100,33043,112057,88877
677.981428,2,6038,6076,-38,38,122800,122100,24709,-548209,-557481
677.981428,3,835,889,-54,54,122800,122100,25701,186399,173223
677.981428,4,120,50,70,-70,122800,122100,-2139,-30461,-13381
677.981428,5,4151,4184,-33,33,122800,122100,15596,-350796,-358848
677.981428,6,0,0,0,0,122800,122100,0,0,0
678.243018,0,661,761,-100,100,122200,122100,35864,282536,272536
678.243018,1,606,701,-95,95,122200,122100,33043,112057,102557
678.243018,2,6048,6076,-28,28,122200,122100,24587,-552087,-554887
678.243018,3,835,889,-54,54,122200,122100,25701,186399,180999
678.243018,4,120,50,70,-70,122200,122100,-2139,-30461,-23461
678.243018,5,4161,4184,-23,23,122200,122100,15474,-354674,-356974
678.243018,6,0,0,0,0,122200,122100,0,0,0
678.45493,0,661,761,-100,100,122200,122100,35864,282536,272536
678.45493,1,606,701,-95,95,122200,122100,33043,112057,102557
678.45493,2,6048,6076,-28,28,122200,122100,24587,-552087,-554887
678.45493,3,835,889,-54,54,122200,122100,25701,186399,180999
678.45493,4,120,50,70,-70,122200,122100,-2139,-30461,-23461
678.45493,5,4161,4184,-23,23,122200,122100,15474,-354674,-356974
678.45493,6,0,0,0,0,122200,122100,0,0,0
678.720978,0,661,761,-100,100,122300,122100,35864,282536,262536
678.720978,1,606,701,-95,95,122300,122100,33043,112057,93057
678.720978,2,6048,6076,-28,28,122300,122100,24587,-552087,-557687
678.720978,3,835,891,-56,56,122300,122100,25750,186750,175550
678.720978,4,120,50,70,-70,122300,122100,-2139,-30461,-16461
678.720978,5,4163,4184,-21,21,122300,122100,15450,-355450,-359650
678.720978,6,0,0,0,0,122300,122100,0,0,0
678.973094,0,661,761,-100,100,122300,122100,35864,282536,262536
678.973094,1,606,701,-95,95,122300,122100,33043,112057,93057
678.973094,2,6048,6076,-28,28,122300,122100,24587,-552087,-557687
678.973094,3,835,891,-56,56,122300,122100,25750,186750,175550
678.973094,4,120,50,70,-70,122300,122100,-2139,-30461,-16461
678.973094,5,4163,4184,-21,21,122300,122100,15450,-355450,-359650
678.973094,6,0,0,0,0,122300,122100,0,0,0
679.284273,0,661,761,-100,100,122300,122100,35864,282536,262536
679.284273,1,606,701,-95,95,122300,122100,33043,112057,93057
679.284273,2,6048,6076,-28,28,122300,122100,24587,-552087,-557687
679.284273,3,835,891,-56,56,122300,122100,25750,186750,175550
679.284273,4,120,50,70,-70,122300,122100,-2139,-30461,-16461
679.284273,5,4163,4184,-21,21,122300,122100,15450,-355450,-359650
679.284273,6,0,0,0,0,122300,122100,0,0,0
679.49821,0,661,761,-100,100,122200,121900,35864,282536,258136
679.49821,1,606,701,-95,95,122200,121900,33043,112057,88877
679.49821,2,6058,6076,-18,18,122200,121900,24465,-555965,-560357
679.49821,3,835,891,-56,56,122200,121900,25750,186750,173086
679.49821,4,120,50,70,-70,122200,121900,-2139,-30461,-13381
679.49821,5,4173,4184,-11,11,122200,121900,15328,-360328,-363012
679.49821,6,0,0,0,0,122200,121900,0,0,0
679.790056,0,661,761,-100,100,122600,121900,35864,282536,258136
679.790056,1,606,701,-95,95,122600,121900,33043,112057,88877
679.790056,2,6058,6086,-28,28,122600,121900,24709,-554209,-561041
679.790056,3,835,893,-58,58,122600,121900,25726,187374,173222
679.790056,4,120,50,70,-70,122600,121900,-2139,-30461,-13381
679.790056,5,4173,4184,-11,11,122600,121900,15328,-360328,-363012
679.790056,6,0,0,0,0,122600,121900,0,0,0
679.958587,0,661,761,-100,100,122200,121900,35864,282536,258136
679.958587,1,606,701,-95,95,122200,121900,33043,112057,88877
679.958587,2,6058,6096,-38,38,122200,121900,24953,-551453,-560725
679.958587,3,835,895,-60,60,122200,121900,25775,187925,173285
679.958587,4,120,50,70,-70,122200,121900,-2139,-30461,-13381
679.958587,5,4173,4184,-11,11,122200,121900,15328,-360328,-363012
679.958587,6,0,0,0,0,122200,121900,0,0,0
680.266808,0,661,761,-100,100,122200,121900,35864,282536,258136
680.266808,1,606,701,-95,95,122200,121900,33043,112057,88877
680.266808,2,6058,6096,-38,38,122200,121900,24953,-551453,-560725
680.266808,3,835,897,-62,62,122200,121900,25824,188476,173348
680.266808,4,120,50,70,-70,122200,121900,-2139,-30461,-13381
680.266808,5,4173,4184,-11,11,122200,121900,15328,-360328,-363012
680.266808,6,0,0,0,0,122200,121900,0,0,0
680.467497,0,661,761,-100,100,122200,121900,35864,282536,258136
680.467497,1,606,701,-95,95,122200,121900,33043,112057,88877
680.467497,2,6058,6096,-38,38,122200,121900,24953,-551453,-560725
680.467497,3,835,899,-64,64,122200,121900,25873,189027,173411
680.467497,4,120,50,70,-70,122200,121900,-2139,-30461,-13381
680.467497,5,4173,4194,-21,21,122200,121900,15572,-357572,-362696
680.467497,6,0,0,0,0,122200,121900,0,0,0
680.717266,0,661,761,-100,100,122200,121900,35864,282536,258136
680.717266,1,606,701,-95,95,122200,121900,33043,112057,88877
680.717266,2,6058,6096,-38,38,122200,121900,24953,-551453,-560725
680.717266,3,835,901,-66,66,122200,121900,25922,189578,173474
680.717266,4,120,50,70,-70,122200,121900,-2139,-30461,-13381
680.717266,5,4173,4194,-21,21,122200,121900,15572,-357572,-362696
680.717266,6,0,0,0,0,122200,121900,0,0,0
680.962922,0,661,761,-100,100,122200,121900,35864,282536,258136
680.962922,1,606,701,-95,95,122200,121900,33043,112057,88877
680.962922,2,6058,6096,-38,38,122200,121900,24953,-551453,-560725
680.962922,3,835,903,-68,68,122200,121900,25971,190129,173537
680.962922,4,120,50,70,-70,122200,121900,-2139,-30461,-13381
680.962922,5,4173,4194,-21,21,122200,121900,15572,-357572,-362696
680.962922,6,0,0,0,0,122200,121900,0,0,0
681.214804,0,661,761,-100,100,122400,121800,35864,282536,258136
681.214804,1,606,701,-95,95,122400,121800,33043,112057,88877
681.214804,2,6058,6106,-48,48,122400,121800,24831,-547331,-559043
681.214804,3,835,905,-70,70,122400,121800,26020,190680,173600
681.214804,4,120,50,70,-70,122400,121800,-2139,-30461,-13381
681.214804,5,4173,4204,-31,31,122400,121800,15450,-353450,-361014
681.214804,6,0,0,0,0,122400,121800,0,0,0
681.475649,0,661,761,-100,100,122300,121800,35864,282536,258136
681.475649,1,606,701,-95,95,122300,121800,33043,112057,88877
681.475649,2,6058,6106,-48,48,122300,121800,24831,-547331,-559043
681.475649,3,835,907,-72,72,122300,121800,26069,191431,173863
681.475649,4,120,50,70,-70,122300,121800,-2139,-30461,-13381
681.475649,5,4175,4204,-29,29,122300,121800,15426,-354426,-361502
681.475649,6,0,0,0,0,122300,121800,0,0,0
681.775756,0,661,761,-100,100,122300,121900,35864,282536,258136
681.775756,1,606,701,-95,95,122300,121900,33043,112057,88877
681.775756,2,6060,6106,-46,46,122300,121900,24807,-548107,-559331
681.775756,3,835,909,-74,74,122300,121900,26118,191782,173726
681.775756,4,120,50,70,-70,122300,121900,-2139,-30461,-13381
681.775756,5,4175,4204,-29,29,122300,121900,15426,-354426,-361502
681.775756,6,0,0,0,0,122300,121900,0,0,0
681.997656,0,661,761,-100,100,122600,121900,35864,282536,258136
681.997656,1,606,701,-95,95,122600,121900,33043,112057,88877
681.997656,2,6070,6106,-36,36,122600,121900,25052,-553352,-562136
681.997656,3,835,909,-74,74,122600,121900,26118,191782,173726
681.997656,4,120,50,70,-70,122600,121900,-2139,-30461,-13381
681.997656,5,4175,4204,-29,29,122600,121900,15426,-354426,-361502
681.997656,6,0,0,0,0,122600,121900,0,0,0
682.236951,0,661,761,-100,100,122600,121900,35864,282536,258136
682.236951,1,606,701,-95,95,122600,121900,33043,112057,88877
682.236951,2,6070,6106,-36,36,122600,121900,25052,-553352,-562136
682.236951,3,835,909,-74,74,122600,121900,26118,191782,173726
682.236951,4,120,50,70,-70,122600,121900,-2139,-30461,-13381
682.236951,5,4175,4204,-29,29,122600,121900,15426,-354426,-361502
682.236951,6,0,0,0,0,122600,121900,0,0,0
682.485542,0,661,761,-100,100,122400,121900,35864,282536,258136
682.485542,1,606,701,-95,95,122400,121900,33043,112057,88877
682.485542,2,6072,6116,-44,44,122400,121900,24905,-550005,-560741
682.485542,3,835,913,-78,78,122400,121900,26142,192558,173526
682.485542,4,120,50,70,-70,122400,121900,-2139,-30461,-13381
682.485542,5,4175,4214,-39,39,122400,121900,15303,-350303,-359819
682.485542,6,0,0,0,0,122400,121900,0,0,0
682.785056,0,661,761,-100,100,122500,121900,35864,282536,258136
682.785056,1,606,701,-95,95,122500,121900,33043,112057,88877
682.785056,2,6082,6116,-34,34,122500,121900,25150,-555250,-563546
682.785056,3,835,913,-78,78,122500,121900,26142,192558,173526
682.785056,4,120,50,70,-70,122500,121900,-2139,-30461,-13381
682.785056,5,4175,4214,-39,39,122500,121900,15303,-350303,-359819
682.785056,6,0,0,0,0,122500,121900,0,0,0
683.022052,0,661,761,-100,100,122500,121900,35864,282536,258136
683.022052,1,606,701,-95,95,122500,121900,33043,112057,88877
683.022052,2,6082,6116,-34,34,122500,121900,25150,-555250,-563546
683.022052,3,835,913,-78,78,122500,121900,26142,192558,173526
683.022052,4,120,50,70,-70,122500,121900,-2139,-30461,-13381
683.022052,5,4175,4214,-39,39,122500,121900,15303,-350303,-359819
683.022052,6,0,0,0,0,122500,121900,0,0,0
683.215166,0,661,761,-100,100,122300,121900,35864,282536,258136
683.215166,1,606,701,-95,95,122300,121900,33043,112057,88877
683.215166,2,6082,6126,-44,44,122300,121900,25395,-551495,-562231
683.215166,3,835,917,-82,82,122300,121900,26240,194060,174052
683.215166,4,120,50,70,-70,122300,121900,-2139,-30461,-13381
683.215166,5,4189,4214,-25,25,122300,121900,15133,-357133,-363233
683.215166,6,0,0,0,0,122300,121900,0,0,0
683.520583,0,661,761,-100,100,122300,121900,35864,282536,258136
683.520583,1,606,701,-95,95,122300,121900,33043,112057,88877
683.520583,2,6084,6126,-42,42,122300,121900,25371,-552471,-562719
683.520583,3,835,919,-84,84,122300,121900,26289,194811,174315
683.520583,4,120,50,70,-70,122300,121900,-2139,-30461,-13381
683.520583,5,4189,4214,-25,25,122300,121900,15133,-357133,-363233
683.520583,6,0,0,0,0,122300,121900,0,0,0
683.727748,0,661,761,-100,100,122200,121900,35864,282536,258136
683.727748,1,606,701,-95,95,122200,121900,33043,112057,88877
683.727748,2,6084,6126,-42,42,122200,121900,25371,-552471,-562719
683.727748,3,835,921,-86,86,122200,121900,26338,195362,174378
683.727748,4,120,50,70,-70,122200,121900,-2139,-30461,-13381
683.727748,5,4189,4214,-25,25,122200,121900,15133,-357133,-363233
683.727748,6,0,0,0,0,122200,121900,0,0,0
684.008744,0,661,761,-100,100,122200,121900,35864,282536,258136
684.008744,1,606,701,-95,95,122200,121900,33043,112057,88877
684.008744,2,6084,6126,-42,42,122200,121900,25371,-552471,-562719
684.008744,3,835,923,-88,88,122200,121900,26387,195913,174441
684.008744,4,120,50,70,-70,122200,121900,-2139,-30461,-13381
684.008744,5,4189,4214,-25,25,122200,121900,15133,-357133,-363233
684.008744,6,0,0,0,0,122200,121900,0,0,0
684.216768,0,661,761,-100,100,122300,121900,35864,282536,258136
684.216768,1,606,701,-95,95,122300,121900,33043,112057,88877
684.216768,2,6094,6126,-32,32,122300,121900,25249,-557349,-565157
684.216768,3,835,923,-88,88,122300,121900,26387,195913,174441
684.216768,4,120,50,70,-70,122300,121900,-2139,-30461,-13381
684.216768,5,4189,4224,-35,35,122300,121900,15378,-354378,-362918
684.216768,6,0,0,0,0,122300,121900,0,0,0
684.450683,0,661,761,-100,100,122300,121900,35864,282536,258136
684.450683,1,606,701,-95,95,122300,121900,33043,112057,88877
684.450683,2,6094,6126,-32,32,122300,121900,25249,-557349,-565157
684.450683,3,835,925,-90,90,122300,121900,26436,196464,174504
684.450683,4,120,50,70,-70,122300,121900,-2139,-30461,-13381
684.450683,5,4191,4224,-33,33,122300,121900,15354,-355354,-363406
684.450683,6,0,0,0,0,122300,121900,0,0,0
684.759516,0,661,761,-100,100,122200,121900,35864,282536,258136
684.759516,1,606,701,-95,95,122200,121900,33043,112057,88877
684.759516,2,6104,6126,-22,22,122200,121900,25127,-559227,-564595
684.759516,3,835,925,-90,90,122200,121900,26436,196464,174504
684.759516,4,120,50,70,-70,122200,121900,-2139,-30461,-13381
684.759516,5,4201,4224,-23,23,122200,121900,15232,-358232,-363844
684.759516,6,0,0,0,0,122200,121900,0,0,0
685.01994,0,661,761,-100,100,122200,121900,35864,282536,258136
685.01994,1,606,701,-95,95,122200,121900,33043,112057,88877
685.01994,2,6114,6126,-12,12,122200,121900,25371,-561471,-564399
685.01994,3,835,925,-90,90,122200,121900,26436,196464,174504
685.01994,4,120,50,70,-70,122200,121900,-2139,-30461,-13381
685.01994,5,4211,4224,-13,13,122200,121900,15476,-360476,-363648
685.01994,6,0,0,0,0,122200,121900,0,0,0
685.244678,0,661,761,-100,100,122200,122000,35864,282536,262536
685.244678,1,606,701,-95,95,122200,122000,33043,112057,93057
685.244678,2,6116,6126,-10,10,122200,122000,25420,-562120,-564120
685.244678,3,835,925,-90,90,122200,122000,26436,196464,178464
685.244678,4,120,50,70,-70,122200,122000,-2139,-30461,-16461
685.244678,5,4211,4224,-13,13,122200,122000,15476,-360476,-363076
685.244678,6,0,0,0,0,122200,122000,0,0,0
685.454736,0,661,761,-100,100,122200,122000,35864,282536,262536
685.454736,1,606,701,-95,95,122200,122000,33043,112057,93057
685.454736,2,6116,6126,-10,10,122200,122000,25420,-562120,-564120
685.454736,3,835,925,-90,90,122200,122000,26436,196464,178464
685.454736,4,120,50,70,-70,122200,122000,-2139,-30461,-16461
685.454736,5,4211,4224,-13,13,122200,122000,15476,-360476,-363076
685.454736,6,0,0,0,0,122200,122000,0,0,0
685.770295,0,661,761,-100,100,122200,122200,35864,282536,282536
685.770295,1,606,701,-95,95,122200,122200,33043,112057,112057
685.770295,2,6116,6126,-10,10,122200,122200,25420,-562120,-562120
685.770295,3,835,925,-90,90,122200,122200,26436,196464,196464
685.770295,4,120,50,70,-70,122200,122200,-2139,-30461,-30461
685.770295,5,4211,4224,-13,13,122200,122200,15476,-360476,-360476
685.770295,6,0,0,0,0,122200,122200,0,0,0
686.035706,0,661,761,-100,100,122200,122200,35864,282536,282536
686.035706,1,606,701,-95,95,122200,122200,33043,112057,112057
686.035706,2,6116,6126,-10,10,122200,122200,25420,-562120,-562120
686.035706,3,835,925,-90,90,122200,122200,26436,196464,196464
686.035706,4,120,50,70,-70,122200,122200,-2139,-30461,-30461
686.035706,5,4211,4224,-13,13,122200,122200,15476,-360476,-360476
686.035706,6,0,0,0,0,122200,122200,0,0,0
686.220205,0,661,761,-100,100,122200,121800,35864,282536,258136
686.220205,1,606,701,-95,95,122200,121800,33043,112057,88877
686.220205,2,6116,6126,-10,10,122200,121800,25420,-562120,-564560
686.220205,3,835,925,-90,90,122200,121800,26436,196464,174504
686.220205,4,120,50,70,-70,122200,121800,-2139,-30461,-13381
686.220205,5,4211,4224,-13,13,122200,121800,15476,-360476,-363648
686.220205,6,0,0,0,0,122200,121800,0,0,0
686.505455,0,661,761,-100,100,122000,121800,35864,282536,262536
686.505455,1,606,701,-95,95,122000,121800,33043,112057,93057
686.505455,2,6116,6136,-20,20,122000,121800,25664,-560364,-564364
686.505455,3,835,925,-90,90,122000,121800,26436,196464,178464
686.505455,4,120,50,70,-70,122000,121800,-2139,-30461,-16461
686.505455,5,4221,4224,-3,3,122000,121800,15354,-363354,-363954
686.505455,6,0,0,0,0,122000,121800,0,0,0
686.705721,0,661,761,-100,100,122000,121800,35864,282536,262536
686.705721,1,606,701,-95,95,122000,121800,33043,112057,93057
686.705721,2,6116,6136,-20,20,122000,121800,25664,-560364,-564364
686.705721,3,835,925,-90,90,122000,121800,26436,196464,178464
686.705721,4,120,50,70,-70,122000,121800,-2139,-30461,-16461
686.705721,5,4221,4224,-3,3,122000,121800,15354,-363354,-363954
686.705721,6,0,0,0,0,122000,121800,0,0,0
687.029171,0,661,761,-100,100,122000,121800,35864,282536,262536
687.029171,1,606,701,-95,95,122000,121800,33043,112057,93057
687.029171,2,6116,6136,-20,20,122000,121800,25664,-560364,-564364
687.029171,3,835,925,-90,90,122000,121800,26436,196464,178464
687.029171,4,120,50,70,-70,122000,121800,-2139,-30461,-16461
687.029171,5,4221,4224,-3,3,122000,121800,15354,-363354,-363954
687.029171,6,0,0,0,0,122000,121800,0,0,0
687.217148,0,661,761,-100,100,122000,121800,35864,282536,262536
687.217148,1,606,701,-95,95,122000,121800,33043,112057,93057
687.217148,2,6116,6136,-20,20,122000,121800,25664,-560364,-564364
687.217148,3,835,925,-90,90,122000,121800,26436,196464,178464
687.217148,4,120,50,70,-70,122000,121800,-2139,-30461,-16461
687.217148,5,4221,4224,-3,3,122000,121800,15354,-363354,-363954
687.217148,6,0,0,0,0,122000,121800,0,0,0
687.509198,0,661,761,-100,100,122000,121800,35864,282536,262536
687.509198,1,606,701,-95,95,122000,121800,33043,112057,93057
687.509198,2,6116,6140,-24,24,122000,121800,25615,-559515,-564315
687.509198,3,835,925,-90,90,122000,121800,26436,196464,178464
687.509198,4,120,50,70,-70,122000,121800,-2139,-30461,-16461
687.509198,5,4221,4224,-3,3,122000,121800,15354,-363354,-363954
687.509198,6,0,0,0,0,122000,121800,0,0,0
687.792156,0,661,761,-100,100,122100,121800,35864,282536,258136
687.792156,1,606,701,-95,95,122100,121800,33043,112057,88877
687.792156,2,6126,6140,-14,14,122100,121800,25859,-561759,-565175
687.792156,3,835,925,-90,90,122100,121800,26436,196464,174504
687.792156,4,120,50,70,-70,122100,121800,-2139,-30461,-13381
687.792156,5,4221,4234,-13,13,122100,121800,15232,-363232,-366404
687.792156,6,0,0,0,0,122100,121800,0,0,0
687.958116,0,661,761,-100,100,122100,121800,35864,282536,258136
687.958116,1,606,701,-95,95,122100,121800,33043,112057,88877
687.958116,2,6126,6140,-14,14,122100,121800,25859,-561759,-565175
687.958116,3,835,925,-90,90,122100,121800,26436,196464,174504
687.958116,4,120,50,70,-70,122100,121800,-2139,-30461,-13381
687.958116,5,4221,4234,-13,13,122100,121800,15232,-363232,-366404
687.958116,6,0,0,0,0,122100,121800,0,0,0
688.206089,0,661,761,-100,100,121600,121800,35864,282536,302536
688.206089,1,606,701,-95,95,121600,121800,33043,112057,131057
688.206089,2,6136,6150,-14,14,121600,121800,25981,-561881,-559081
688.206089,3,837,925,-88,88,121600,121800,26412,197088,214688
688.206089,4,120,50,70,-70,121600,121800,-2139,-30461,-44461
688.206089,5,4241,4234,7,-7,121600,121800,14988,-368988,-370388
688.206089,6,0,0,0,0,121600,121800,0,0,0
688.520959,0,691,761,-70,70,121600,121800,36594,290806,304806
688.520959,1,610,701,-91,91,121600,121800,33140,113160,131360
688.520959,2,6146,6150,-4,4,121600,121800,26224,-559124,-558324
688.520959,3,839,925,-86,86,121600,121800,26461,197639,214839
688.520959,4,120,50,70,-70,121600,121800,-2139,-30461,-44461
688.520959,5,4251,4234,17,-17,121600,121800,15231,-366231,-369631
688.520959,6,0,0,0,0,121600,121800,0,0,0
688.778519,0,691,761,-70,70,122000,121800,36594,290806,276806
688.778519,1,610,701,-91,91,122000,121800,33140,113160,94960
688.778519,2,6146,6158,-12,12,122000,121800,26126,-558226,-560626
688.778519,3,847,925,-78,78,122000,121800,26656,195044,179444
688.778519,4,120,50,70,-70,122000,121800,-2139,-30461,-16461
688.778519,5,4251,4234,17,-17,122000,121800,15231,-366231,-362831
688.778519,6,0,0,0,0,122000,121800,0,0,0
689.03475,0,691,761,-70,70,122400,121800,36594,290806,273726
689.03475,1,610,701,-91,91,122400,121800,33140,113160,90956
689.03475,2,6146,6160,-14,14,122400,121800,26102,-557802,-561218
689.03475,3,847,927,-80,80,122400,121800,26632,195668,176148
689.03475,4,120,50,70,-70,122400,121800,-2139,-30461,-13381
689.03475,5,4251,4234,17,-17,122400,121800,15231,-366231,-362083
689.03475,6,0,0,0,0,122400,121800,0,0,0
689.269865,0,691,761,-70,70,122400,121800,36594,290806,273726
689.269865,1,610,701,-91,91,122400,121800,33140,113160,90956
689.269865,2,6146,6160,-14,14,122400,121800,26102,-557802,-561218
689.269865,3,847,927,-80,80,122400,121800,26632,195668,176148
689.269865,4,120,50,70,-70,122400,121800,-2139,-30461,-13381
689.269865,5,4251,4234,17,-17,122400,121800,15231,-366231,-362083
689.269865,6,0,0,0,0,122400,121800,0,0,0
689.503046,0,691,761,-70,70,122400,121800,36594,290806,273726
689.503046,1,610,701,-91,91,122400,121800,33140,113160,90956
689.503046,2,6146,6160,-14,14,122400,121800,26102,-557802,-561218
689.503046,3,847,927,-80,80,122400,121800,26632,195668,176148
689.503046,4,120,50,70,-70,122400,121800,-2139,-30461,-13381
689.503046,5,4251,4234,17,-17,122400,121800,15231,-366231,-362083
689.503046,6,0,0,0,0,122400,121800,0,0,0
689.719242,0,691,761,-70,70,122400,121800,36594,290806,273726
689.719242,1,610,701,-91,91,122400,121800,33140,113160,90956
689.719242,2,6146,6160,-14,14,122400,121800,26102,-557802,-561218
689.719242,3,847,927,-80,80,122400,121800,26632,195668,176148
689.719242,4,120,50,70,-70,122400,121800,-2139,-30461,-13381
689.719242,5,4251,4234,17,-17,122400,121800,15231,-366231,-362083
689.719242,6,0,0,0,0,122400,121800,0,0,0
690.040537,0,691,761,-70,70,122400,121800,36594,290806,273726
690.040537,1,610,701,-91,91,122400,121800,33140,113160,90956
690.040537,2,6146,6160,-14,14,122400,121800,26102,-557802,-561218
690.040537,3,847,927,-80,80,122400,121800,26632,195668,176148
690.040537,4,120,50,70,-70,122400,121800,-2139,-30461,-13381
690.040537,5,4251,4234,17,-17,122400,121800,15231,-366231,-362083
690.040537,6,0,0,0,0,122400,121800,0,0,0
690.252342,0,691,761,-70,70,122400,121500,36594,290806,273796
690.252342,1,610,701,-91,91,122400,121500,33140,113160,91047
690.252342,2,6146,6160,-14,14,122400,121500,26102,-557802,-561204
690.252342,3,847,927,-80,80,122400,121500,26632,195668,176228
690.252342,4,120,50,70,-70,122400,121500,-2139,-30461,-13451
690.252342,5,4251,4234,17,-17,122400,121500,15231,-366231,-362100
690.252342,6,0,0,0,0,122400,121500,0,0,0
690.49935,0,691,781,-90,90,121300,121300,37080,290320,290320
690.49935,1,610,701,-91,91,121300,121300,33140,113160,113160
690.49935,2,6156,6160,-4,4,121300,121300,25980,-559680,-559680
690.49935,3,847,927,-80,80,121300,121300,26632,195668,195668
690.49935,4,120,50,70,-70,121300,121300,-2139,-30461,-30461
690.49935,5,4251,4234,17,-17,121300,121300,15231,-366231,-366231
690.49935,6,0,0,0,0,121300,121300,0,0,0
690.79,0,691,781,-90,90,121300,121300,37080,290320,290320
690.79,1,610,701,-91,91,121300,121300,33140,113160,113160
690.79,2,6156,6160,-4,4,121300,121300,25980,-559680,-559680
690.79,3,847,927,-80,80,121300,121300,26632,195668,195668
690.79,4,120,50,70,-70,121300,121300,-2139,-30461,-30461
690.79,5,4251,4234,17,-17,121300,121300,15231,-366231,-366231
690.79,6,0,0,0,0,121300,121300,0,0,0
691.023004,0,691,781,-90,90,121300,121300,37080,290320,290320
691.023004,1,610,701,-91,91,121300,121300,33140,113160,113160
691.023004,2,6156,6160,-4,4,121300,121300,25980,-559680,-559680
691.023004,3,847,927,-80,80,121300,121300,26632,195668,195668
691.023004,4,120,50,70,-70,121300,121300,-2139,-30461,-30461
691.023004,5,4251,4234,17,-17,121300,121300,15231,-366231,-366231
691.023004,6,0,0,0,0,121300,121300,0,0,0
691.22624,0,691,781,-90,90,121300,121300,37080,290320,290320
691.22624,1,610,701,-91,91,121300,121300,33140,113160,113160
691.22624,2,6156,6160,-4,4,121300,121300,25980,-559680,-559680
691.22624,3,847,927,-80,80,121300,121300,26632,195668,195668
691.22624,4,120,50,70,-70,121300,121300,-2139,-30461,-30461
691.22624,5,4251,4234,17,-17,121300,121300,15231,-366231,-366231
691.22624,6,0,0,0,0,121300,121300,0,0,0
691.491597,0,691,781,-90,90,121300,121300,37080,290320,290320
691.491597,1,610,701,-91,91,121300,121300,33140,113160,113160
691.491597,2,6156,6160,-4,4,121300,121300,25980,-559680,-559680
691.491597,3,847,927,-80,80,121300,121300,26632,195668,195668
691.491597,4,120,50,70,-70,121300,121300,-2139,-30461,-30461
691.491597,5,4251,4234,17,-17,121300,121300,15231,-366231,-366231
691.491597,6,0,0,0,0,121300,121300,0,0,0
691.787854,0,691,781,-90,90,121300,121300,37080,290320,290320
691.787854,1,610,701,-91,91,121300,121300,33140,113160,113160
691.787854,2,6156,6160,-4,4,121300,121300,25980,-559680,-559680
691.787854,3,847,927,-80,80,121300,121300,26632,195668,195668
691.787854,4,120,50,70,-70,121300,121300,-2139,-30461,-30461
691.787854,5,4251,4234,17,-17,121300,121300,15231,-366231,-366231
691.787854,6,0,0,0,0,121300,121300,0,0,0
692.03581,0,691,781,-90,90,121300,121300,37080,290320,290320
692.03581,1,610,701,-91,91,121300,121300,33140,113160,113160
692.03581,2,6156,6160,-4,4,121300,121300,25980,-559680,-559680
692.03581,3,847,927,-80,80,121300,121300,26632,195668,195668
692.03581,4,120,50,70,-70,121300,121300,-2139,-30461,-30461
692.03581,5,4251,4234,17,-17,121300,121300,15231,-366231,-366231
692.03581,6,0,0,0,0,121300,121300,0,0,0
692.300035,0,691,781,-90,90,121600,121300,37080,290320,268450
692.300035,1,610,701,-91,91,121600,121300,33140,113160,91047
692.300035,2,6156,6160,-4,4,121600,121300,25980,-559680,-560652
692.300035,3,847,927,-80,80,121600,121300,26632,195668,176228
692.300035,4,120,50,70,-70,121600,121300,-2139,-30461,-13451
692.300035,5,4251,4234,17,-17,121600,121300,15231,-366231,-362100
692.300035,6,0,0,0,0,121600,121300,0,0,0
692.530745,0,691,781,-90,90,121600,121300,37080,290320,268450
692.530745,1,610,701,-91,91,121600,121300,33140,113160,91047
692.530745,2,6156,6160,-4,4,121600,121300,25980,-559680,-560652
692.530745,3,847,927,-80,80,121600,121300,26632,195668,176228
692.530745,4,120,50,70,-70,121600,121300,-2139,-30461,-13451
692.530745,5,4251,4234,17,-17,121600,121300,15231,-366231,-362100
692.530745,6,0,0,0,0,121600,121300,0,0,0
692.718471,0,691,781,-90,90,121700,121300,37080,290320,268450
692.718471,1,610,701,-91,91,121700,121300,33140,113160,91047
692.718471,2,6166,6170,-4,4,121700,121300,26101,-560801,-561773
692.718471,3,847,927,-80,80,121700,121300,26632,195668,176228
692.718471,4,120,50,70,-70,121700,121300,-2139,-30461,-13451
692.718471,5,4251,4244,7,-7,121700,121300,15109,-366109,-364408
692.718471,6,0,0,0,0,121700,121300,0,0,0
692.973308,0,691,781,-90,90,121700,121300,37080,290320,268450
692.973308,1,610,701,-91,91,121700,121300,33140,113160,91047
692.973308,2,6166,6175,-9,9,121700,121300,26223,-560423,-562610
692.973308,3,847,927,-80,80,121700,121300,26632,195668,176228
692.973308,4,120,50,70,-70,121700,121300,-2139,-30461,-13451
692.973308,5,4251,4254,-3,3,121700,121300,15352,-365352,-366081
692.973308,6,0,0,0,0,121700,121300,0,0,0
693.234452,0,691,781,-90,90,121700,121300,37080,290320,268450
693.234452,1,610,701,-91,91,121700,121300,33140,113160,91047
693.234452,2,6166,6175,-9,9,121700,121300,26223,-560423,-562610
693.234452,3,847,927,-80,80,121700,121300,26632,195668,176228
693.234452,4,120,50,70,-70,121700,121300,-2139,-30461,-13451
693.234452,5,4251,4254,-3,3,121700,121300,15352,-365352,-366081
693.234452,6,0,0,0,0,121700,121300,0,0,0
693.507949,0,691,781,-90,90,121700,121300,37080,290320,268450
693.507949,1,610,701,-91,91,121700,121300,33140,113160,91047
693.507949,2,6166,6175,-9,9,121700,121300,26223,-560423,-562610
693.507949,3,847,927,-80,80,121700,121300,26632,195668,176228
693.507949,4,120,50,70,-70,121700,121300,-2139,-30461,-13451
693.507949,5,4251,4254,-3,3,121700,121300,15352,-365352,-366081
693.507949,6,0,0,0,0,121700,121300,0,0,0
693.750836,0,691,781,-90,90,121700,121300,37080,290320,268450
693.750836,1,610,701,-91,91,121700,121300,33140,113160,91047
693.750836,2,6166,6175,-9,9,121700,121300,26223,-560423,-562610
693.750836,3,847,927,-80,80,121700,121300,26632,195668,176228
693.750836,4,120,50,70,-70,121700,121300,-2139,-30461,-13451
693.750836,5,4251,4254,-3,3,121700,121300,15352,-365352,-366081
693.750836,6,0,0,0,0,121700,121300,0,0,0
694.038079,0,691,781,-90,90,121700,121300,37080,290320,268450
694.038079,1,610,701,-91,91,121700,121300,33140,113160,91047
694.038079,2,6166,6175,-9,9,121700,121300,26223,-560423,-562610
694.038079,3,847,927,-80,80,121700,121300,26632,195668,176228
694.038079,4,120,50,70,-70,121700,121300,-2139,-30461,-13451
694.038079,5,4251,4254,-3,3,121700,121300,15352,-365352,-366081
694.038079,6,0,0,0,0,121700,121300,0,0,0
694.201796,0,691,781,-90,90,121300,121300,37080,290320,290320
694.201796,1,610,701,-91,91,121300,121300,33140,113160,113160
694.201796,2,6176,6182,-6,6,121300,121300,26382,-560882,-560882
694.201796,3,856,927,-71,71,121300,121300,26779,194021,194021
694.201796,4,120,50,70,-70,121300,121300,-2139,-30461,-30461
694.201796,5,4261,4264,-3,3,121300,121300,15108,-366108,-366108
694.201796,6,0,0,0,0,121300,121300,0,0,0
694.547331,0,691,781,-90,90,121300,121300,37080,290320,290320
694.547331,1,610,701,-91,91,121300,121300,33140,113160,113160
694.547331,2,6176,6182,-6,6,121300,121300,26382,-560882,-560882
694.547331,3,856,927,-71,71,121300,121300,26779,194021,194021
694.547331,4,120,50,70,-70,121300,121300,-2139,-30461,-30461
694.547331,5,4261,4264,-3,3,121300,121300,15108,-366108,-366108
694.547331,6,0,0,0,0,121300,121300,0,0,0
694.723091,0,691,781,-90,90,121300,121300,37080,290320,290320
694.723091,1,610,701,-91,91,121300,121300,33140,113160,113160
694.723091,2,6176,6182,-6,6,121300,121300,26382,-560882,-560882
694.723091,3,856,927,-71,71,121300,121300,26779,194021,194021
694.723091,4,120,50,70,-70,121300,121300,-2139,-30461,-30461
694.723091,5,4261,4264,-3,3,121300,121300,15108,-366108,-366108
694.723091,6,0,0,0,0,121300,121300,0,0,0
695.039948,0,691,781,-90,90,121300,121300,37080,290320,290320
695.039948,1,610,701,-91,91,121300,121300,33140,113160,113160
695.039948,2,6176,6182,-6,6,121300,121300,26382,-560882,-560882
695.039948,3,856,927,-71,71,121300,121300,26779,194021,194021
695.039948,4,120,50,70,-70,121300,121300,-2139,-30461,-30461
695.039948,5,4261,4264,-3,3,121300,121300,15108,-366108,-366108
695.039948,6,0,0,0,0,121300,121300,0,0,0
695.205826,0,691,781,-90,90,121300,121300,37080,290320,290320
695.205826,1,610,701,-91,91,121300,121300,33140,113160,113160
695.205826,2,6176,6182,-6,6,121300,121300,26382,-560882,-560882
695.205826,3,856,927,-71,71,121300,121300,26779,194021,194021
695.205826,4,120,50,70,-70,121300,121300,-2139,-30461,-30461
695.205826,5,4261,4264,-3,3,121300,121300,15108,-366108,-366108
695.205826,6,0,0,0,0,121300,121300,0,0,0
695.470913,0,691,781,-90,90,121900,121300,37080,290320,268450
695.470913,1,610,701,-91,91,121900,121300,33140,113160,91047
695.470913,2,6176,6187,-11,11,121900,121300,26321,-559821,-562494
695.470913,3,856,927,-71,71,121900,121300,26779,194021,176768
695.470913,4,120,50,70,-70,121900,121300,-2139,-30461,-13451
695.470913,5,4261,4264,-3,3,121900,121300,15108,-366108,-366837
695.470913,6,0,0,0,0,121900,121300,0,0,0
695.7757,0,691,781,-90,90,122000,121300,37080,290320,268450
695.7757,1,610,701,-91,91,122000,121300,33140,113160,91047
695.7757,2,6176,6190,-14,14,122000,121300,26284,-559484,-562886
695.7757,3,856,927,-71,71,122000,121300,26779,194021,176768
695.7757,4,120,50,70,-70,122000,121300,-2139,-30461,-13451
695.7757,5,4261,4274,-13,13,122000,121300,14986,-364986,-368145
695.7757,6,0,0,0,0,122000,121300,0,0,0
695.976864,0,691,781,-90,90,122000,121300,37080,290320,268450
695.976864,1,610,701,-91,91,122000,121300,33140,113160,91047
695.976864,2,6176,6190,-14,14,122000,121300,26284,-559484,-562886
695.976864,3,856,927,-71,71,122000,121300,26779,194021,176768
695.976864,4,120,50,70,-70,122000,121300,-2139,-30461,-13451
695.976864,5,4261,4274,-13,13,122000,121300,14986,-364986,-368145
695.976864,6,0,0,0,0,122000,121300,0,0,0
696.275311,0,691,781,-90,90,122000,121300,37080,290320,268450
696.275311,1,610,701,-91,91,122000,121300,33140,113160,91047
696.275311,2,6176,6190,-14,14,122000,121300,26284,-559484,-562886
696.275311,3,856,927,-71,71,122000,121300,26779,194021,176768
696.275311,4,120,50,70,-70,122000,121300,-2139,-30461,-13451
696.275311,5,4261,4274,-13,13,122000,121300,14986,-364986,-368145
696.275311,6,0,0,0,0,122000,121300,0,0,0
696.536443,0,691,781,-90,90,122000,121300,37080,290320,268450
696.536443,1,610,701,-91,91,122000,121300,33140,113160,91047
696.536443,2,6176,6190,-14,14,122000,121300,26284,-559484,-562886
696.536443,3,856,927,-71,71,122000,121300,26779,194021,176768
696.536443,4,120,50,70,-70,122000,121300,-2139,-30461,-13451
696.536443,5,4261,4274,-13,13,122000,121300,14986,-364986,-368145
696.536443,6,0,0,0,0,122000,121300,0,0,0
696.784693,0,691,781,-90,90,122000,121300,37080,290320,268450
696.784693,1,610,701,-91,91,122000,121300,33140,113160,91047
696.784693,2,6176,6190,-14,14,122000,121300,26284,-559484,-562886
696.784693,3,856,927,-71,71,122000,121300,26779,194021,176768
696.784693,4,120,50,70,-70,122000,121300,-2139,-30461,-13451
696.784693,5,4261,4274,-13,13,122000,121300,14986,-364986,-368145
696.784693,6,0,0,0,0,122000,121300,0,0,0
697.024025,0,691,781,-90,90,122000,121300,37080,290320,268450
697.024025,1,610,701,-91,91,122000,121300,33140,113160,91047
697.024025,2,6176,6190,-14,14,122000,121300,26284,-559484,-562886
697.024025,3,856,927,-71,71,122000,121300,26779,194021,176768
697.024025,4,120,50,70,-70,122000,121300,-2139,-30461,-13451
697.024025,5,4261,4274,-13,13,122000,121300,14986,-364986,-368145
697.024025,6,0,0,0,0,122000,121300,0,0,0
697.242149,0,691,781,-90,90,122200,121300,37080,290320,268450
697.242149,1,610,701,-91,91,122200,121300,33140,113160,91047
697.242149,2,6186,6190,-4,4,122200,121300,26528,-561728,-562700
697.242149,3,856,929,-73,73,122200,121300,26755,194245,176506
697.242149,4,120,50,70,-70,122200,121300,-2139,-30461,-13451
697.242149,5,4261,4282,-21,21,122200,121300,14888,-364088,-369191
697.242149,6,0,0,0,0,122200,121300,0,0,0
697.501389,0,691,781,-90,90,122200,122000,37080,290320,272320
697.501389,1,610,701,-91,91,122200,122000,33140,113160,94960
697.501389,2,6186,6200,-14,14,122200,122000,26772,-560972,-563772
697.501389,3,856,929,-73,73,122200,122000,26755,194245,179645
697.501389,4,120,50,70,-70,122200,122000,-2139,-30461,-16461
697.501389,5,4271,4282,-11,11,122200,122000,14766,-365966,-368166
697.501389,6,0,0,0,0,122200,122000,0,0,0
697.79827,0,691,791,-100,100,121900,122000,37324,290076,300076
697.79827,1,610,701,-91,91,121900,122000,33140,113160,122260
697.79827,2,6196,6200,-4,4,121900,122000,26650,-562850,-562450
697.79827,3,856,929,-73,73,121900,122000,26755,194245,201545
697.79827,4,120,50,70,-70,121900,122000,-2139,-30461,-37461
697.79827,5,4271,4282,-11,11,121900,122000,14766,-365966,-364866
697.79827,6,0,0,0,0,121900,122000,0,0,0
697.981911,0,691,791,-100,100,121900,122000,37324,290076,300076
697.981911,1,610,701,-91,91,121900,122000,33140,113160,122260
697.981911,2,6196,6200,-4,4,121900,122000,26650,-562850,-562450
697.981911,3,856,929,-73,73,121900,122000,26755,194245,201545
697.981911,4,120,50,70,-70,121900,122000,-2139,-30461,-37461
697.981911,5,4271,4282,-11,11,121900,122000,14766,-365966,-364866
697.981911,6,0,0,0,0,121900,122000,0,0,0
698.209911,0,691,791,-100,100,121900,122000,37324,290076,300076
698.209911,1,610,701,-91,91,121900,122000,33140,113160,122260
698.209911,2,6196,6200,-4,4,121900,122000,26650,-562850,-562450
698.209911,3,856,929,-73,73,121900,122000,26755,194245,201545
698.209911,4,120,50,70,-70,121900,122000,-2139,-30461,-37461
698.209911,5,4271,4282,-11,11,121900,122000,14766,-365966,-364866
698.209911,6,0,0,0,0,121900,122000,0,0,0
698.476158,0,691,791,-100,100,121900,122000,37324,290076,300076
698.476158,1,610,701,-91,91,121900,122000,33140,113160,122260
698.476158,2,6196,6200,-4,4,121900,122000,26650,-562850,-562450
698.476158,3,856,929,-73,73,121900,122000,26755,194245,201545
698.476158,4,120,50,70,-70,121900,122000,-2139,-30461,-37461
698.476158,5,4271,4282,-11,11,121900,122000,14766,-365966,-364866
698.476158,6,0,0,0,0,121900,122000,0,0,0
698.769174,0,691,791,-100,100,121900,122000,37324,290076,300076
698.769174,1,610,701,-91,91,121900,122000,33140,113160,122260
698.769174,2,6196,6208,-12,12,121900,122000,26845,-562245,-561045
698.769174,3,856,931,-75,75,121900,122000,26804,194396,201896
698.769174,4,120,50,70,-70,121900,122000,-2139,-30461,-37461
698.769174,5,4281,4282,-1,1,121900,122000,14644,-368844,-368744
698.769174,6,0,0,0,0,121900,122000,0,0,0
699.000628,0,691,791,-100,100,121900,122000,37324,290076,300076
699.000628,1,610,701,-91,91,121900,122000,33140,113160,122260
699.000628,2,6196,6208,-12,12,121900,122000,26845,-562245,-561045
699.000628,3,856,931,-75,75,121900,122000,26804,194396,201896
699.000628,4,120,50,70,-70,121900,122000,-2139,-30461,-37461
699.000628,5,4281,4282,-1,1,121900,122000,14644,-368844,-368744
699.000628,6,0,0,0,0,121900,122000,0,0,0
699.239786,0,691,791,-100,100,121900,122000,37324,290076,300076
699.239786,1,610,701,-91,91,121900,122000,33140,113160,122260
699.239786,2,6196,6208,-12,12,121900,122000,26845,-562245,-561045
699.239786,3,856,931,-75,75,121900,122000,26804,194396,201896
699.239786,4,120,50,70,-70,121900,122000,-2139,-30461,-37461
699.239786,5,4281,4282,-1,1,121900,122000,14644,-368844,-368744
699.239786,6,0,0,0,0,121900,122000,0,0,0
699.539488,0,691,791,-100,100,121900,122000,37324,290076,300076
699.539488,1,610,701,-91,91,121900,122000,33140,113160,122260
699.539488,2,6196,6208,-12,12,121900,122000,26845,-562245,-561045
699.539488,3,856,931,-75,75,121900,122000,26804,194396,201896
699.539488,4,120,50,70,-70,121900,122000,-2139,-30461,-37461
699.539488,5,4281,4282,-1,1,121900,122000,14644,-368844,-368744
699.539488,6,0,0,0,0,121900,122000,0,0,0
699.74167,0,691,791,-100,100,121900,122000,37324,290076,300076
699.74167,1,610,701,-91,91,121900,122000,33140,113160,122260
699.74167,2,6206,6208,-2,2,121900,122000,27089,-564489,-564289
699.74167,3,856,931,-75,75,121900,122000,26804,194396,201896
699.74167,4,120,50,70,-70,121900,122000,-2139,-30461,-37461
699.74167,5,4281,4292,-11,11,121900,122000,14522,-368722,-367622
699.74167,6,0,0,0,0,121900,122000,0,0,0
700.034686,0,691,791,-100,100,121900,122000,37324,290076,300076
700.034686,1,610,701,-91,91,121900,122000,33140,113160,122260
700.034686,2,6206,6208,-2,2,121900,122000,27089,-564489,-564289
700.034686,3,856,931,-75,75,121900,122000,26804,194396,201896
700.034686,4,120,50,70,-70,121900,122000,-2139,-30461,-37461
700.034686,5,4281,4292,-11,11,121900,122000,14522,-368722,-367622
700.034686,6,0,0,0,0,121900,122000,0,0,0
700.210389,0,691,791,-100,100,121900,122000,37324,290076,300076
700.210389,1,610,701,-91,91,121900,122000,33140,113160,122260
700.210389,2,6206,6208,-2,2,121900,122000,27089,-564489,-564289
700.210389,3,856,931,-75,75,121900,122000,26804,194396,201896
700.210389,4,120,50,70,-70,121900,122000,-2139,-30461,-37461
700.210389,5,4281,4292,-11,11,121900,122000,14522,-368722,-367622
700.210389,6,0,0,0,0,121900,122000,0,0,0
700.46887,0,691,791,-100,100,121900,122000,37324,290076,300076
700.46887,1,610,701,-91,91,121900,122000,33140,113160,122260
700.46887,2,6206,6208,-2,2,121900,122000,27089,-564489,-564289
700.46887,3,856,931,-75,75,121900,122000,26804,194396,201896
700.46887,4,120,50,70,-70,121900,122000,-2139,-30461,-37461
700.46887,5,4281,4292,-11,11,121900,122000,14522,-368722,-367622
700.46887,6,0,0,0,0,121900,122000,0,0,0
700.712128,0,691,791,-100,100,121800,121300,37324,290076,265776
700.712128,1,610,701,-91,91,121800,121300,33140,113160,91047
700.712128,2,6206,6218,-12,12,121800,121300,27333,-561733,-564649
700.712128,3,856,933,-77,77,121800,121300,26853,194947,176236
700.712128,4,120,50,70,-70,121800,121300,-2139,-30461,-13451
700.712128,5,4281,4292,-11,11,121800,121300,14522,-368722,-371395
700.712128,6,0,0,0,0,121800,121300,0,0,0
700.995428,0,691,791,-100,100,121500,121300,37324,290076,270076
700.995428,1,610,701,-91,91,121500,121300,33140,113160,94960
700.995428,2,6206,6228,-22,22,121500,121300,27576,-559976,-564376
700.995428,3,856,933,-77,77,121500,121300,26853,194947,179547
700.995428,4,120,50,70,-70,121500,121300,-2139,-30461,-16461
700.995428,5,4301,4292,9,-9,121500,121300,14278,-377478,-375678
700.995428,6,0,0,0,0,121500,121300,0,0,0
701.206555,0,691,791,-100,100,121500,121300,37324,290076,270076
701.206555,1,610,701,-91,91,121500,121300,33140,113160,94960
701.206555,2,6208,6228,-20,20,121500,121300,27552,-560552,-564552
701.206555,3,856,935,-79,79,121500,121300,26902,195298,179498
701.206555,4,120,50,70,-70,121500,121300,-2139,-30461,-16461
701.206555,5,4301,4292,9,-9,121500,121300,14278,-377478,-375678
701.206555,6,0,0,0,0,121500,121300,0,0,0
701.52004,0,691,791,-100,100,121500,121300,37324,290076,270076
701.52004,1,610,701,-91,91,121500,121300,33140,113160,94960
701.52004,2,6208,6228,-20,20,121500,121300,27552,-560552,-564552
701.52004,3,856,935,-79,79,121500,121300,26902,195298,179498
701.52004,4,120,50,70,-70,121500,121300,-2139,-30461,-16461
701.52004,5,4301,4292,9,-9,121500,121300,14278,-377478,-375678
701.52004,6,0,0,0,0,121500,121300,0,0,0
701.785259,0,691,791,-100,100,121500,121300,37324,290076,270076
701.785259,1,610,701,-91,91,121500,121300,33140,113160,94960
701.785259,2,6208,6228,-20,20,121500,121300,27552,-560552,-564552
701.785259,3,856,935,-79,79,121500,121300,26902,195298,179498
701.785259,4,120,50,70,-70,121500,121300,-2139,-30461,-16461
701.785259,5,4301,4292,9,-9,121500,121300,14278,-377478,-375678
701.785259,6,0,0,0,0,121500,121300,0,0,0
702.027273,0,691,791,-100,100,121400,121300,37324,290076,280076
702.027273,1,610,701,-91,91,121400,121300,33140,113160,104060
702.027273,2,6208,6228,-20,20,121400,121300,27552,-560552,-562552
702.027273,3,856,935,-79,79,121400,121300,26902,195298,187398
702.027273,4,120,50,70,-70,121400,121300,-2139,-30461,-23461
702.027273,5,4301,4302,-1,1,121400,121300,14521,-378721,-378821
702.027273,6,0,0,0,0,121400,121300,0,0,0
702.293771,0,691,791,-100,100,122000,121300,37324,290076,265776
702.293771,1,610,701,-91,91,122000,121300,33140,113160,91047
702.293771,2,6208,6238,-30,30,122000,121300,27430,-558430,-565720
702.293771,3,856,937,-81,81,122000,121300,26878,195922,176239
702.293771,4,120,50,70,-70,122000,121300,-2139,-30461,-13451
702.293771,5,4301,4302,-1,1,122000,121300,14521,-378721,-378964
702.293771,6,0,0,0,0,122000,121300,0,0,0
702.522356,0,691,791,-100,100,121700,121300,37324,290076,265776
702.522356,1,610,701,-91,91,121700,121300,33140,113160,91047
702.522356,2,6218,6238,-20,20,121700,121300,27673,-561673,-566533
702.522356,3,856,937,-81,81,121700,121300,26878,195922,176239
702.522356,4,120,50,70,-70,121700,121300,-2139,-30461,-13451
702.522356,5,4301,4312,-11,11,121700,121300,14399,-377599,-380272
702.522356,6,0,0,0,0,121700,121300,0,0,0
702.794444,0,691,791,-100,100,121700,121300,37324,290076,265776
702.794444,1,610,701,-91,91,121700,121300,33140,113160,91047
702.794444,2,6218,6238,-20,20,121700,121300,27673,-561673,-566533
702.794444,3,856,937,-81,81,121700,121300,26878,195922,176239
702.794444,4,120,50,70,-70,121700,121300,-2139,-30461,-13451
702.794444,5,4301,4312,-11,11,121700,121300,14399,-377599,-380272
702.794444,6,0,0,0,0,121700,121300,0,0,0
703.022168,0,691,791,-100,100,122100,121300,37324,290076,265776
703.022168,1,610,701,-91,91,122100,121300,33140,113160,91047
703.022168,2,6218,6248,-30,30,122100,121300,27551,-560551,-567841
703.022168,3,856,939,-83,83,122100,121300,26854,196346,176177
703.022168,4,120,50,70,-70,122100,121300,-2139,-30461,-13451
703.022168,5,4301,4322,-21,21,122100,121300,14277,-375477,-380580
703.022168,6,0,0,0,0,122100,121300,0,0,0
703.274068,0,691,791,-100,100,122000,121300,37324,290076,265776
703.274068,1,610,701,-91,91,122000,121300,33140,113160,91047
703.274068,2,6228,6248,-20,20,122000,121300,27795,-562795,-567655
703.274068,3,856,939,-83,83,122000,121300,26854,196346,176177
703.274068,4,120,50,70,-70,122000,121300,-2139,-30461,-13451
703.274068,5,4301,4332,-31,31,122000,121300,14155,-375355,-382888
703.274068,6,0,0,0,0,122000,121300,0,0,0
703.495279,0,691,791,-100,100,122000,121300,37324,290076,265776
703.495279,1,610,701,-91,91,122000,121300,33140,113160,91047
703.495279,2,6228,6248,-20,20,122000,121300,27795,-562795,-567655
703.495279,3,856,939,-83,83,122000,121300,26854,196346,176177
703.495279,4,120,50,70,-70,122000,121300,-2139,-30461,-13451
703.495279,5,4301,4332,-31,31,122000,121300,14155,-375355,-382888
703.495279,6,0,0,0,0,122000,121300,0,0,0
703.7022,0,691,791,-100,100,122000,121300,37324,290076,265776
703.7022,1,610,701,-91,91,122000,121300,33140,113160,91047
703.7022,2,6228,6248,-20,20,122000,121300,27795,-562795,-567655
703.7022,3,856,939,-83,83,122000,121300,26854,196346,176177
703.7022,4,120,50,70,-70,122000,121300,-2139,-30461,-13451
703.7022,5,4301,4332,-31,31,122000,121300,14155,-375355,-382888
703.7022,6,0,0,0,0,122000,121300,0,0,0
703.966104,0,691,791,-100,100,121900,121300,37324,290076,265776
703.966104,1,610,701,-91,91,121900,121300,33140,113160,91047
703.966104,2,6238,6258,-20,20,121900,121300,27917,-562917,-567777
703.966104,3,856,941,-85,85,121900,121300,26830,196970,176315
703.966104,4,120,50,70,-70,121900,121300,-2139,-30461,-13451
703.966104,5,4311,4332,-21,21,121900,121300,14033,-379233,-384336
703.966104,6,0,0,0,0,121900,121300,0,0,0
704.258388,0,691,791,-100,100,121900,121300,37324,290076,265776
704.258388,1,610,701,-91,91,121900,121300,33140,113160,91047
704.258388,2,6248,6258,-10,10,121900,121300,28161,-565161,-567591
704.258388,3,856,941,-85,85,121900,121300,26830,196970,176315
704.258388,4,120,50,70,-70,121900,121300,-2139,-30461,-13451
704.258388,5,4321,4332,-11,11,121900,121300,14277,-381477,-384150
704.258388,6,0,0,0,0,121900,121300,0,0,0
704.518313,0,691,791,-100,100,121900,121300,37324,290076,265776
704.518313,1,610,701,-91,91,121900,121300,33140,113160,91047
704.518313,2,6248,6258,-10,10,121900,121300,28161,-565161,-567591
704.518313,3,856,941,-85,85,121900,121300,26830,196970,176315
704.518313,4,120,50,70,-70,121900,121300,-2139,-30461,-13451
704.518313,5,4321,4332,-11,11,121900,121300,14277,-381477,-384150
704.518313,6,0,0,0,0,121900,121300,0,0,0
704.795359,0,691,791,-100,100,121900,121300,37324,290076,265776
704.795359,1,610,701,-91,91,121900,121300,33140,113160,91047
704.795359,2,6248,6258,-10,10,121900,121300,28161,-565161,-567591
704.795359,3,856,941,-85,85,121900,121300,26830,196970,176315
704.795359,4,120,50,70,-70,121900,121300,-2139,-30461,-13451
704.795359,5,4321,4332,-11,11,121900,121300,14277,-381477,-384150
704.795359,6,0,0,0,0,121900,121300,0,0,0
704.989985,0,691,791,-100,100,121800,121300,37324,290076,265776
704.989985,1,610,701,-91,91,121800,121300,33140,113160,91047
704.989985,2,6248,6268,-20,20,121800,121300,28405,-564405,-569265
704.989985,3,856,943,-87,87,121800,121300,26879,197121,175980
704.989985,4,120,50,70,-70,121800,121300,-2139,-30461,-13451
704.989985,5,4321,4332,-11,11,121800,121300,14277,-381477,-384150
704.989985,6,0,0,0,0,121800,121300,0,0,0
705.265885,0,691,791,-100,100,121800,121500,37324,290076,265776
705.265885,1,610,701,-91,91,121800,121500,33140,113160,91047
705.265885,2,6248,6268,-20,20,121800,121500,28405,-564405,-569265
705.265885,3,856,943,-87,87,121800,121500,26879,197121,175980
705.265885,4,120,50,70,-70,121800,121500,-2139,-30461,-13451
705.265885,5,4321,4332,-11,11,121800,121500,14277,-381477,-384150
705.265885,6,0,0,0,0,121800,121500,0,0,0
705.49535,0,691,791,-100,100,121800,121500,37324,290076,265776
705.49535,1,610,701,-91,91,121800,121500,33140,113160,91047
705.49535,2,6248,6278,-30,30,121800,121500,28649,-562649,-569939
705.49535,3,856,943,-87,87,121800,121500,26879,197121,175980
705.49535,4,120,50,70,-70,121800,121500,-2139,-30461,-13451
705.49535,5,4328,4332,-4,4,121800,121500,14192,-383492,-384464
705.49535,6,0,0,0,0,121800,121500,0,0,0
705.766612,0,691,791,-100,100,121800,121500,37324,290076,265776
705.766612,1,610,701,-91,91,121800,121500,33140,113160,91047
705.766612,2,6248,6278,-30,30,121800,121500,28649,-562649,-569939
705.766612,3,856,943,-87,87,121800,121500,26879,197121,175980
705.766612,4,120,50,70,-70,121800,121500,-2139,-30461,-13451
705.766612,5,4328,4332,-4,4,121800,121500,14192,-383492,-384464
705.766612,6,0,0,0,0,121800,121500,0,0,0
706.008022,0,691,791,-100,100,121800,121500,37324,290076,265776
706.008022,1,610,701,-91,91,121800,121500,33140,113160,91047
706.008022,2,6248,6278,-30,30,121800,121500,28649,-562649,-569939
706.008022,3,856,943,-87,87,121800,121500,26879,197121,175980
706.008022,4,120,50,70,-70,121800,121500,-2139,-30461,-13451
706.008022,5,4328,4332,-4,4,121800,121500,14192,-383492,-384464
706.008022,6,0,0,0,0,121800,121500,0,0,0
706.25546,0,691,791,-100,100,121600,121500,37324,290076,280076
706.25546,1,610,701,-91,91,121600,121500,33140,113160,104060
706.25546,2,6248,6278,-30,30,121600,121500,28649,-562649,-565649
706.25546,3,856,943,-87,87,121600,121500,26879,197121,188421
706.25546,4,120,50,70,-70,121600,121500,-2139,-30461,-23461
706.25546,5,4328,4342,-14,14,121600,121500,14435,-383735,-385135
706.25546,6,0,0,0,0,121600,121500,0,0,0
706.530735,0,691,791,-100,100,121600,121500,37324,290076,280076
706.530735,1,610,701,-91,91,121600,121500,33140,113160,104060
706.530735,2,6248,6278,-30,30,121600,121500,28649,-562649,-565649
706.530735,3,856,943,-87,87,121600,121500,26879,197121,188421
706.530735,4,120,50,70,-70,121600,121500,-2139,-30461,-23461
706.530735,5,4328,4342,-14,14,121600,121500,14435,-383735,-385135
706.530735,6,0,0,0,0,121600,121500,0,0,0
706.740623,0,691,791,-100,100,121600,121500,37324,290076,280076
706.740623,1,610,701,-91,91,121600,121500,33140,113160,104060
706.740623,2,6248,6278,-30,30,121600,121500,28649,-562649,-565649
706.740623,3,856,943,-87,87,121600,121500,26879,197121,188421
706.740623,4,120,50,70,-70,121600,121500,-2139,-30461,-23461
706.740623,5,4328,4342,-14,14,121600,121500,14435,-383735,-385135
706.740623,6,0,0,0,0,121600,121500,0,0,0
707.04801,0,691,791,-100,100,121600,121500,37324,290076,280076
707.04801,1,610,701,-91,91,121600,121500,33140,113160,104060
707.04801,2,6248,6278,-30,30,121600,121500,28649,-562649,-565649
707.04801,3,856,943,-87,87,121600,121500,26879,197121,188421
707.04801,4,120,50,70,-70,121600,121500,-2139,-30461,-23461
707.04801,5,4328,4342,-14,14,121600,121500,14435,-383735,-385135
707.04801,6,0,0,0,0,121600,121500,0,0,0
707.211881,0,691,791,-100,100,121600,121500,37324,290076,280076
707.211881,1,610,701,-91,91,121600,121500,33140,113160,104060
707.211881,2,6248,6278,-30,30,121600,121500,28649,-562649,-565649
707.211881,3,856,943,-87,87,121600,121500,26879,197121,188421
707.211881,4,120,50,70,-70,121600,121500,-2139,-30461,-23461
707.211881,5,4328,4342,-14,14,121600,121500,14435,-383735,-385135
707.211881,6,0,0,0,0,121600,121500,0,0,0
707.550327,0,691,791,-100,100,121800,121500,37324,290076,265776
707.550327,1,610,701,-91,91,121800,121500,33140,113160,91047
707.550327,2,6250,6278,-28,28,121800,121500,28625,-563225,-570029
707.550327,3,856,945,-89,89,121800,121500,26928,197272,175645
707.550327,4,120,50,70,-70,121800,121500,-2139,-30461,-13451
707.550327,5,4328,4342,-14,14,121800,121500,14435,-383735,-387137
707.550327,6,0,0,0,0,121800,121500,0,0,0
707.796662,0,691,791,-100,100,121800,121500,37324,290076,265776
707.796662,1,610,701,-91,91,121800,121500,33140,113160,91047
707.796662,2,6250,6278,-28,28,121800,121500,28625,-563225,-570029
707.796662,3,856,945,-89,89,121800,121500,26928,197272,175645
707.796662,4,120,50,70,-70,121800,121500,-2139,-30461,-13451
707.796662,5,4328,4342,-14,14,121800,121500,14435,-383735,-387137
707.796662,6,0,0,0,0,121800,121500,0,0,0
707.986063,0,691,791,-100,100,121900,121500,37324,290076,265776
707.986063,1,610,701,-91,91,121900,121500,33140,113160,91047
707.986063,2,6260,6278,-18,18,121900,121500,28869,-566469,-570843
707.986063,3,856,945,-89,89,121900,121500,26928,197272,175645
707.986063,4,120,50,70,-70,121900,121500,-2139,-30461,-13451
707.986063,5,4328,4342,-14,14,121900,121500,14435,-383735,-387137
707.986063,6,0,0,0,0,121900,121500,0,0,0
708.252594,0,691,791,-100,100,121900,121500,37324,290076,265776
708.252594,1,610,701,-91,91,121900,121500,33140,113160,91047
708.252594,2,6260,6278,-18,18,121900,121500,28869,-566469,-570843
708.252594,3,856,945,-89,89,121900,121500,26928,197272,175645
708.252594,4,120,50,70,-70,121900,121500,-2139,-30461,-13451
708.252594,5,4328,4342,-14,14,121900,121500,14435,-383735,-387137
708.252594,6,0,0,0,0,121900,121500,0,0,0
708.52051,0,691,791,-100,100,121900,121500,37324,290076,265776
708.52051,1,610,701,-91,91,121900,121500,33140,113160,91047
708.52051,2,6260,6278,-18,18,121900,121500,28869,-566469,-570843
708.52051,3,856,945,-89,89,121900,121500,26928,197272,175645
708.52051,4,120,50,70,-70,121900,121500,-2139,-30461,-13451
708.52051,5,4328,4342,-14,14,121900,121500,14435,-383735,-387137
708.52051,6,0,0,0,0,121900,121500,0,0,0
708.742511,0,691,791,-100,100,121900,121500,37324,290076,265776
708.742511,1,610,701,-91,91,121900,121500,33140,113160,91047
708.742511,2,6260,6278,-18,18,121900,121500,28869,-566469,-570843
708.742511,3,856,945,-89,89,121900,121500,26928,197272,175645
708.742511,4,120,50,70,-70,121900,121500,-2139,-30461,-13451
708.742511,5,4328,4342,-14,14,121900,121500,14435,-383735,-387137
708.742511,6,0,0,0,0,121900,121500,0,0,0
708.958685,0,691,791,-100,100,121900,121500,37324,290076,265776
708.958685,1,610,701,-91,91,121900,121500,33140,113160,91047
708.958685,2,6260,6278,-18,18,121900,121500,28869,-566469,-570843
708.958685,3,856,945,-89,89,121900,121500,26928,197272,175645
708.958685,4,120,50,70,-70,121900,121500,-2139,-30461,-13451
708.958685,5,4328,4342,-14,14,121900,121500,14435,-383735,-387137
708.958685,6,0,0,0,0,121900,121500,0,0,0
709.232739,0,691,791,-100,100,121900,121800,37324,290076,280076
709.232739,1,610,701,-91,91,121900,121800,33140,113160,104060
709.232739,2,6260,6278,-18,18,121900,121800,28869,-566469,-568269
709.232739,3,856,945,-89,89,121900,121800,26928,197272,188372
709.232739,4,120,50,70,-70,121900,121800,-2139,-30461,-23461
709.232739,5,4328,4342,-14,14,121900,121800,14435,-383735,-385135
709.232739,6,0,0,0,0,121900,121800,0,0,0
709.463328,0,691,791,-100,100,121900,121800,37324,290076,280076
709.463328,1,610,701,-91,91,121900,121800,33140,113160,104060
709.463328,2,6260,6278,-18,18,121900,121800,28869,-566469,-568269
709.463328,3,856,945,-89,89,121900,121800,26928,197272,188372
709.463328,4,120,50,70,-70,121900,121800,-2139,-30461,-23461
709.463328,5,4328,4342,-14,14,121900,121800,14435,-383735,-385135
709.463328,6,0,0,0,0,121900,121800,0,0,0
709.746794,0,691,791,-100,100,121900,121800,37324,290076,280076
709.746794,1,610,701,-91,91,121900,121800,33140,113160,104060
709.746794,2,6260,6278,-18,18,121900,121800,28869,-566469,-568269
709.746794,3,856,945,-89,89,121900,121800,26928,197272,188372
709.746794,4,120,50,70,-70,121900,121800,-2139,-30461,-23461
709.746794,5,4328,4342,-14,14,121900,121800,14435,-383735,-385135
709.746794,6,0,0,0,0,121900,121800,0,0,0
709.972828,0,691,791,-100,100,122200,121800,37324,290076,265676
709.972828,1,610,701,-91,91,122200,121800,33140,113160,90956
709.972828,2,6260,6288,-28,28,122200,121800,28747,-564347,-571179
709.972828,3,856,945,-89,89,122200,121800,26928,197272,175556
709.972828,4,120,50,70,-70,122200,121800,-2139,-30461,-13381
709.972828,5,4328,4352,-24,24,122200,121800,14313,-381613,-387469
709.972828,6,0,0,0,0,122200,121800,0,0,0
710.284185,0,691,791,-100,100,122200,121400,37324,290076,265776
710.284185,1,610,701,-91,91,122200,121400,33140,113160,91047
710.284185,2,6260,6288,-28,28,122200,121400,28747,-564347,-571151
710.284185,3,856,945,-89,89,122200,121400,26928,197272,175645
710.284185,4,120,50,70,-70,122200,121400,-2139,-30461,-13451
710.284185,5,4328,4352,-24,24,122200,121400,14313,-381613,-387445
710.284185,6,0,0,0,0,122200,121400,0,0,0
710.544506,0,691,791,-100,100,121600,121400,37324,290076,270076
710.544506,1,610,701,-91,91,121600,121400,33140,113160,94960
710.544506,2,6260,6298,-38,38,121600,121400,28990,-561590,-569190
710.544506,3,856,945,-89,89,121600,121400,26928,197272,179472
710.544506,4,120,50,70,-70,121600,121400,-2139,-30461,-16461
710.544506,5,4338,4362,-24,24,121600,121400,14434,-383734,-388534
710.544506,6,0,0,0,0,121600,121400,0,0,0
710.744106,0,691,791,-100,100,121600,121400,37324,290076,270076
710.744106,1,610,701,-91,91,121600,121400,33140,113160,94960
710.744106,2,6260,6298,-38,38,121600,121400,28990,-561590,-569190
710.744106,3,856,945,-89,89,121600,121400,26928,197272,179472
710.744106,4,120,50,70,-70,121600,121400,-2139,-30461,-16461
710.744106,5,4338,4362,-24,24,121600,121400,14434,-383734,-388534
710.744106,6,0,0,0,0,121600,121400,0,0,0
711.025228,0,691,791,-100,100,121600,121400,37324,290076,270076
711.025228,1,610,701,-91,91,121600,121400,33140,113160,94960
711.025228,2,6260,6298,-38,38,121600,121400,28990,-561590,-569190
711.025228,3,856,945,-89,89,121600,121400,26928,197272,179472
711.025228,4,120,50,70,-70,121600,121400,-2139,-30461,-16461
711.025228,5,4338,4362,-24,24,121600,121400,14434,-383734,-388534
711.025228,6,0,0,0,0,121600,121400,0,0,0
711.28998,0,691,791,-100,100,121900,121400,37324,290076,265776
711.28998,1,610,701,-91,91,121900,121400,33140,113160,91047
711.28998,2,6262,6298,-36,36,121900,121400,28966,-562366,-571114
711.28998,3,856,947,-91,91,121900,121400,26977,197623,175510
711.28998,4,120,50,70,-70,121900,121400,-2139,-30461,-13451
711.28998,5,4338,4362,-24,24,121900,121400,14434,-383734,-389566
711.28998,6,0,0,0,0,121900,121400,0,0,0
711.460163,0,691,791,-100,100,121900,121400,37324,290076,265776
711.460163,1,610,701,-91,91,121900,121400,33140,113160,91047
711.460163,2,6262,6298,-36,36,121900,121400,28966,-562366,-571114
711.460163,3,856,947,-91,91,121900,121400,26977,197623,175510
711.460163,4,120,50,70,-70,121900,121400,-2139,-30461,-13451
711.460163,5,4338,4362,-24,24,121900,121400,14434,-383734,-389566
711.460163,6,0,0,0,0,121900,121400,0,0,0
711.769451,0,691,791,-100,100,121900,121400,37324,290076,265776
711.769451,1,610,701,-91,91,121900,121400,33140,113160,91047
711.769451,2,6262,6298,-36,36,121900,121400,28966,-562366,-571114
711.769451,3,856,947,-91,91,121900,121400,26977,197623,175510
711.769451,4,120,50,70,-70,121900,121400,-2139,-30461,-13451
711.769451,5,4338,4362,-24,24,121900,121400,14434,-383734,-389566
711.769451,6,0,0,0,0,121900,121400,0,0,0
712.000017,0,691,791,-100,100,121900,121400,37324,290076,265776
712.000017,1,610,701,-91,91,121900,121400,33140,113160,91047
712.000017,2,6272,6298,-26,26,121900,121400,29210,-566610,-572928
712.000017,3,856,949,-93,93,121900,121400,27026,197774,175175
712.000017,4,120,50,70,-70,121900,121400,-2139,-30461,-13451
712.000017,5,4340,4372,-32,32,121900,121400,14288,-380988,-388764
712.000017,6,0,0,0,0,121900,121400,0,0,0
712.210165,0,691,791,-100,100,122000,121400,37324,290076,265776
712.210165,1,610,701,-91,91,122000,121400,33140,113160,91047
712.210165,2,6282,6298,-16,16,122000,121400,29454,-569854,-573742
712.210165,3,856,949,-93,93,122000,121400,27026,197774,175175
712.210165,4,120,50,70,-70,122000,121400,-2139,-30461,-13451
712.210165,5,4350,4372,-22,22,122000,121400,14532,-384232,-389578
712.210165,6,0,0,0,0,122000,121400,0,0,0
712.509369,0,691,791,-100,100,122000,121400,37324,290076,265776
712.509369,1,610,701,-91,91,122000,121400,33140,113160,91047
712.509369,2,6282,6298,-16,16,122000,121400,29454,-569854,-573742
712.509369,3,856,949,-93,93,122000,121400,27026,197774,175175
712.509369,4,120,50,70,-70,122000,121400,-2139,-30461,-13451
712.509369,5,4350,4372,-22,22,122000,121400,14532,-384232,-389578
712.509369,6,0,0,0,0,122000,121400,0,0,0
712.738045,0,691,791,-100,100,121800,121400,37324,290076,265776
712.738045,1,610,701,-91,91,121800,121400,33140,113160,91047
712.738045,2,6282,6298,-16,16,121800,121400,29454,-569854,-573742
712.738045,3,856,949,-93,93,121800,121400,27026,197774,175175
712.738045,4,120,50,70,-70,121800,121400,-2139,-30461,-13451
712.738045,5,4350,4372,-22,22,121800,121400,14532,-384232,-389578
712.738045,6,0,0,0,0,121800,121400,0,0,0
712.981583,0,691,791,-100,100,121800,121400,37324,290076,265776
712.981583,1,610,701,-91,91,121800,121400,33140,113160,91047
712.981583,2,6282,6308,-26,26,121800,121400,29698,-568098,-574416
712.981583,3,856,949,-93,93,121800,121400,27026,197774,175175
712.981583,4,120,50,70,-70,121800,121400,-2139,-30461,-13451
712.981583,5,4350,4372,-22,22,121800,121400,14532,-384232,-389578
712.981583,6,0,0,0,0,121800,121400,0,0,0
713.259544,0,691,791,-100,100,121800,121400,37324,290076,265776
713.259544,1,610,701,-91,91,121800,121400,33140,113160,91047
713.259544,2,6282,6308,-26,26,121800,121400,29698,-568098,-574416
713.259544,3,856,949,-93,93,121800,121400,27026,197774,175175
713.259544,4,120,50,70,-70,121800,121400,-2139,-30461,-13451
713.259544,5,4350,4372,-22,22,121800,121400,14532,-384232,-389578
713.259544,6,0,0,0,0,121800,121400,0,0,0
713.492952,0,691,791,-100,100,121800,121400,37324,290076,265776
713.492952,1,610,701,-91,91,121800,121400,33140,113160,91047
713.492952,2,6282,6308,-26,26,121800,121400,29698,-568098,-574416
713.492952,3,856,949,-93,93,121800,121400,27026,197774,175175
713.492952,4,120,50,70,-70,121800,121400,-2139,-30461,-13451
713.492952,5,4350,4372,-22,22,121800,121400,14532,-384232,-389578
713.492952,6,0,0,0,0,121800,121400,0,0,0
713.718988,0,691,791,-100,100,121800,121400,37324,290076,265776
713.718988,1,610,701,-91,91,121800,121400,33140,113160,91047
713.718988,2,6282,6308,-26,26,121800,121400,29698,-568098,-574416
713.718988,3,856,949,-93,93,121800,121400,27026,197774,175175
713.718988,4,120,50,70,-70,121800,121400,-2139,-30461,-13451
713.718988,5,4350,4372,-22,22,121800,121400,14532,-384232,-389578
713.718988,6,0,0,0,0,121800,121400,0,0,0
713.988655,0,691,791,-100,100,121700,121400,37324,290076,265776
713.988655,1,610,701,-91,91,121700,121400,33140,113160,91047
713.988655,2,6292,6308,-16,16,121700,121400,29576,-571976,-575864
713.988655,3,856,949,-93,93,121700,121400,27026,197774,175175
713.988655,4,120,50,70,-70,121700,121400,-2139,-30461,-13451
713.988655,5,4360,4372,-12,12,121700,121400,14410,-388110,-391026
713.988655,6,0,0,0,0,121700,121400,0,0,0
714.273956,0,691,791,-100,100,121700,121400,37324,290076,265776
714.273956,1,610,701,-91,91,121700,121400,33140,113160,91047
714.273956,2,6292,6308,-16,16,121700,121400,29576,-571976,-575864
714.273956,3,856,949,-93,93,121700,121400,27026,197774,175175
714.273956,4,120,50,70,-70,121700,121400,-2139,-30461,-13451
714.273956,5,4360,4372,-12,12,121700,121400,14410,-388110,-391026
714.273956,6,0,0,0,0,121700,121400,0,0,0
714.519899,0,691,791,-100,100,121700,121400,37324,290076,265776
714.519899,1,610,701,-91,91,121700,121400,33140,113160,91047
714.519899,2,6292,6318,-26,26,121700,121400,29819,-570219,-576537
714.519899,3,856,949,-93,93,121700,121400,27026,197774,175175
714.519899,4,120,50,70,-70,121700,121400,-2139,-30461,-13451
714.519899,5,4360,4372,-12,12,121700,121400,14410,-388110,-391026
714.519899,6,0,0,0,0,121700,121400,0,0,0
714.77041,0,691,791,-100,100,121700,121400,37324,290076,265776
714.77041,1,610,701,-91,91,121700,121400,33140,113160,91047
714.77041,2,6292,6318,-26,26,121700,121400,29819,-570219,-576537
714.77041,3,856,949,-93,93,121700,121400,27026,197774,175175
714.77041,4,120,50,70,-70,121700,121400,-2139,-30461,-13451
714.77041,5,4360,4372,-12,12,121700,121400,14410,-388110,-391026
714.77041,6,0,0,0,0,121700,121400,0,0,0
715.041381,0,691,791,-100,100,121300,121400,37324,290076,300076
715.041381,1,610,701,-91,91,121300,121400,33140,113160,122260
715.041381,2,6302,6318,-16,16,121300,121400,29697,-572097,-570497
715.041381,3,856,949,-93,93,121300,121400,27026,197774,207074
715.041381,4,120,50,70,-70,121300,121400,-2139,-30461,-37461
715.041381,5,4370,4372,-2,2,121300,121400,14288,-389988,-389788
715.041381,6,0,0,0,0,121300,121400,0,0,0
715.297584,0,691,791,-100,100,121200,121400,37324,290076,310076
715.297584,1,610,701,-91,91,121200,121400,33140,113160,131360
715.297584,2,6312,6318,-6,6,121200,121400,29575,-573975,-572775
715.297584,3,856,949,-93,93,121200,121400,27026,197774,216374
715.297584,4,120,50,70,-70,121200,121400,-2139,-30461,-44461
715.297584,5,4380,4372,8,-8,121200,121400,14167,-389867,-391467
715.297584,6,0,0,0,0,121200,121400,0,0,0
715.541906,0,691,791,-100,100,121700,121400,37324,290076,265776
715.541906,1,610,701,-91,91,121700,121400,33140,113160,91047
715.541906,2,6312,6320,-8,8,121700,121400,29551,-573751,-575695
715.541906,3,856,949,-93,93,121700,121400,27026,197774,175175
715.541906,4,120,50,70,-70,121700,121400,-2139,-30461,-13451
715.541906,5,4380,4372,8,-8,121700,121400,14167,-389867,-387923
715.541906,6,0,0,0,0,121700,121400,0,0,0
715.790823,0,691,791,-100,100,121700,121400,37324,290076,265776
715.790823,1,610,701,-91,91,121700,121400,33140,113160,91047
715.790823,2,6312,6320,-8,8,121700,121400,29551,-573751,-575695
715.790823,3,856,949,-93,93,121700,121400,27026,197774,175175
715.790823,4,120,50,70,-70,121700,121400,-2139,-30461,-13451
715.790823,5,4380,4372,8,-8,121700,121400,14167,-389867,-387923
715.790823,6,0,0,0,0,121700,121400,0,0,0
716.040885,0,691,791,-100,100,121200,121400,37324,290076,310076
716.040885,1,610,701,-91,91,121200,121400,33140,113160,131360
716.040885,2,6322,6320,2,-2,121200,121400,29429,-573629,-574029
716.040885,3,856,949,-93,93,121200,121400,27026,197774,216374
716.040885,4,120,50,70,-70,121200,121400,-2139,-30461,-44461
716.040885,5,4390,4372,18,-18,121200,121400,14045,-388745,-392345
716.040885,6,0,0,0,0,121200,121400,0,0,0
716.281504,0,691,791,-100,100,121200,121400,37324,290076,310076
716.281504,1,610,701,-91,91,121200,121400,33140,113160,131360
716.281504,2,6322,6320,2,-2,121200,121400,29429,-573629,-574029
716.281504,3,856,949,-93,93,121200,121400,27026,197774,216374
716.281504,4,120,50,70,-70,121200,121400,-2139,-30461,-44461
716.281504,5,4390,4372,18,-18,121200,121400,14045,-388745,-392345
716.281504,6,0,0,0,0,121200,121400,0,0,0
716.545486,0,691,791,-100,100,121200,121400,37324,290076,310076
716.545486,1,610,701,-91,91,121200,121400,33140,113160,131360
716.545486,2,6322,6320,2,-2,121200,121400,29429,-573629,-574029
716.545486,3,856,949,-93,93,121200,121400,27026,197774,216374
716.545486,4,120,50,70,-70,121200,121400,-2139,-30461,-44461
716.545486,5,4390,4372,18,-18,121200,121400,14045,-388745,-392345
716.545486,6,0,0,0,0,121200,121400,0,0,0
716.74351,0,691,791,-100,100,121200,121400,37324,290076,310076
716.74351,1,610,701,-91,91,121200,121400,33140,113160,131360
716.74351,2,6322,6320,2,-2,121200,121400,29429,-573629,-574029
716.74351,3,856,949,-93,93,121200,121400,27026,197774,216374
716.74351,4,120,50,70,-70,121200,121400,-2139,-30461,-44461
716.74351,5,4390,4372,18,-18,121200,121400,14045,-388745,-392345
716.74351,6,0,0,0,0,121200,121400,0,0,0
717.017776,0,691,791,-100,100,121200,121400,37324,290076,310076
717.017776,1,610,701,-91,91,121200,121400,33140,113160,131360
717.017776,2,6322,6320,2,-2,121200,121400,29429,-573629,-574029
717.017776,3,856,949,-93,93,121200,121400,27026,197774,216374
717.017776,4,120,50,70,-70,121200,121400,-2139,-30461,-44461
717.017776,5,4390,4372,18,-18,121200,121400,14045,-388745,-392345
717.017776,6,0,0,0,0,121200,121400,0,0,0
717.259481,0,691,791,-100,100,121200,121400,37324,290076,310076
717.259481,1,610,701,-91,91,121200,121400,33140,113160,131360
717.259481,2,6322,6320,2,-2,121200,121400,29429,-573629,-574029
717.259481,3,856,949,-93,93,121200,121400,27026,197774,216374
717.259481,4,120,50,70,-70,121200,121400,-2139,-30461,-44461
717.259481,5,4390,4372,18,-18,121200,121400,14045,-388745,-392345
717.259481,6,0,0,0,0,121200,121400,0,0,0
717.460817,0,691,791,-100,100,121100,121400,37324,290076,314376
717.460817,1,610,701,-91,91,121100,121400,33140,113160,135273
717.460817,2,6332,6320,12,-12,121100,121400,29308,-572508,-575424
717.460817,3,856,949,-93,93,121100,121400,27026,197774,220373
717.460817,4,120,50,70,-70,121100,121400,-2139,-30461,-47471
717.460817,5,4404,4372,32,-32,121100,121400,13875,-385575,-393351
717.460817,6,0,0,0,0,121100,121400,0,0,0
717.711724,0,691,791,-100,100,121100,121400,37324,290076,314376
717.711724,1,610,701,-91,91,121100,121400,33140,113160,135273
717.711724,2,6332,6320,12,-12,121100,121400,29308,-572508,-575424
717.711724,3,856,949,-93,93,121100,121400,27026,197774,220373
717.711724,4,120,50,70,-70,121100,121400,-2139,-30461,-47471
717.711724,5,4404,4372,32,-32,121100,121400,13875,-385575,-393351
717.711724,6,0,0,0,0,121100,121400,0,0,0
717.955496,0,691,791,-100,100,121500,121400,37324,290076,280076
717.955496,1,610,701,-91,91,121500,121400,33140,113160,104060
717.955496,2,6332,6328,4,-4,121500,121400,29211,-573211,-572811
717.955496,3,864,949,-85,85,121500,121400,27220,197580,189080
717.955496,4,120,50,70,-70,121500,121400,-2139,-30461,-23461
717.955496,5,4404,4372,32,-32,121500,121400,13875,-385575,-382375
717.955496,6,0,0,0,0,121500,121400,0,0,0
718.253604,0,691,791,-100,100,121200,121600,37324,290076,314376
718.253604,1,610,701,-91,91,121200,121600,33140,113160,135273
718.253604,2,6342,6328,14,-14,121200,121600,29090,-573090,-576492
718.253604,3,864,949,-85,85,121200,121600,27220,197580,218235
718.253604,4,120,50,70,-70,121200,121600,-2139,-30461,-47471
718.253604,5,4414,4372,42,-42,121200,121600,13754,-383454,-393660
718.253604,6,0,0,0,0,121200,121600,0,0,0
718.527596,0,706,791,-85,85,121400,121600,37688,292712,309712
718.527596,1,610,701,-91,91,121400,121600,33140,113160,131360
718.527596,2,6342,6336,6,-6,121400,121600,28993,-573793,-574993
718.527596,3,872,949,-77,77,121400,121600,27414,197386,212786
718.527596,4,120,50,70,-70,121400,121600,-2139,-30461,-44461
718.527596,5,4414,4372,42,-42,121400,121600,13754,-383454,-391854
718.527596,6,0,0,0,0,121400,121600,0,0,0
718.73184,0,706,791,-85,85,122000,121600,37688,292712,272057
718.73184,1,610,701,-91,91,122000,121600,33140,113160,91047
718.73184,2,6342,6346,-4,4,122000,121600,28872,-573672,-574644
718.73184,3,886,949,-63,63,122000,121600,27755,192645,177336
718.73184,4,120,50,70,-70,122000,121600,-2139,-30461,-13451
718.73184,5,4414,4372,42,-42,122000,121600,13754,-383454,-373248
718.73184,6,0,0,0,0,122000,121600,0,0,0
719.020613,0,706,806,-100,100,121900,121600,38054,296846,272546
719.020613,1,610,701,-91,91,121900,121600,33140,113160,91047
719.020613,2,6342,6356,-14,14,121900,121600,29116,-570916,-574318
719.020613,3,886,951,-65,65,121900,121600,27804,193196,177401
719.020613,4,120,50,70,-70,121900,121600,-2139,-30461,-13451
719.020613,5,4414,4372,42,-42,121900,121600,13754,-383454,-373248
719.020613,6,0,0,0,0,121900,121600,0,0,0
719.253491,0,706,806,-100,100,121900,121600,38054,296846,272546
719.253491,1,610,701,-91,91,121900,121600,33140,113160,91047
719.253491,2,6342,6366,-24,24,121900,121600,29360,-568160,-573992
719.253491,3,886,953,-67,67,121900,121600,27853,193747,177466
719.253491,4,120,50,70,-70,121900,121600,-2139,-30461,-13451
719.253491,5,4414,4372,42,-42,121900,121600,13754,-383454,-373248
719.253491,6,0,0,0,0,121900,121600,0,0,0
719.542043,0,706,806,-100,100,121900,121600,38054,296846,272546
719.542043,1,610,701,-91,91,121900,121600,33140,113160,91047
719.542043,2,6342,6366,-24,24,121900,121600,29360,-568160,-573992
719.542043,3,886,953,-67,67,121900,121600,27853,193747,177466
719.542043,4,120,50,70,-70,121900,121600,-2139,-30461,-13451
719.542043,5,4414,4372,42,-42,121900,121600,13754,-383454,-373248
719.542043,6,0,0,0,0,121900,121600,0,0,0
719.787605,0,706,806,-100,100,121900,121600,38054,296846,272546
719.787605,1,610,701,-91,91,121900,121600,33140,113160,91047
719.787605,2,6342,6366,-24,24,121900,121600,29360,-568160,-573992
719.787605,3,886,953,-67,67,121900,121600,27853,193747,177466
719.787605,4,120,50,70,-70,121900,121600,-2139,-30461,-13451
719.787605,5,4414,4372,42,-42,121900,121600,13754,-383454,-373248
719.787605,6,0,0,0,0,121900,121600,0,0,0
720.006277,0,706,806,-100,100,121600,121600,38054,296846,296846
720.006277,1,610,701,-91,91,121600,121600,33140,113160,113160
720.006277,2,6344,6366,-22,22,121600,121600,29336,-568936,-568936
720.006277,3,886,955,-69,69,121600,121600,27902,194098,194098
720.006277,4,120,50,70,-70,121600,121600,-2139,-30461,-30461
720.006277,5,4414,4372,42,-42,121600,121600,13754,-383454,-383454
720.006277,6,0,0,0,0,121600,121600,0,0,0
720.262857,0,706,806,-100,100,121600,121600,38054,296846,296846
720.262857,1,610,701,-91,91,121600,121600,33140,113160,113160
720.262857,2,6344,6366,-22,22,121600,121600,29336,-568936,-568936
720.262857,3,886,955,-69,69,121600,121600,27902,194098,194098
720.262857,4,120,50,70,-70,121600,121600,-2139,-30461,-30461
720.262857,5,4414,4372,42,-42,121600,121600,13754,-383454,-383454
720.262857,6,0,0,0,0,121600,121600,0,0,0
720.452019,0,706,806,-100,100,121600,121600,38054,296846,296846
720.452019,1,610,701,-91,91,121600,121600,33140,113160,113160
720.452019,2,6344,6366,-22,22,121600,121600,29336,-568936,-568936
720.452019,3,886,955,-69,69,121600,121600,27902,194098,194098
720.452019,4,120,50,70,-70,121600,121600,-2139,-30461,-30461
720.452019,5,4414,4372,42,-42,121600,121600,13754,-383454,-383454
720.452019,6,0,0,0,0,121600,121600,0,0,0
720.720922,0,706,806,-100,100,121100,121600,38054,296846,321146
720.720922,1,610,701,-91,91,121100,121600,33140,113160,135273
720.720922,2,6352,6366,-14,14,121100,121600,29239,-572039,-568637
720.720922,3,886,955,-69,69,121100,121600,27902,194098,210865
720.720922,4,120,50,70,-70,121100,121600,-2139,-30461,-47471
720.720922,5,4414,4372,42,-42,121100,121600,13754,-383454,-393660
720.720922,6,0,0,0,0,121100,121600,0,0,0
721.021417,0,706,806,-100,100,121100,121400,38054,296846,321146
721.021417,1,610,701,-91,91,121100,121400,33140,113160,135273
721.021417,2,6352,6366,-14,14,121100,121400,29239,-572039,-568637
721.021417,3,886,955,-69,69,121100,121400,27902,194098,210865
721.021417,4,120,50,70,-70,121100,121400,-2139,-30461,-47471
721.021417,5,4414,4372,42,-42,121100,121400,13754,-383454,-393660
721.021417,6,0,0,0,0,121100,121400,0,0,0
721.254353,0,706,806,-100,100,121400,121400,38054,296846,296846
721.254353,1,610,701,-91,91,121400,121400,33140,113160,113160
721.254353,2,6354,6366,-12,12,121400,121400,29215,-572415,-572415
721.254353,3,886,957,-71,71,121400,121400,27951,194249,194249
721.254353,4,120,50,70,-70,121400,121400,-2139,-30461,-30461
721.254353,5,4414,4372,42,-42,121400,121400,13754,-383454,-383454
721.254353,6,0,0,0,0,121400,121400,0,0,0
721.456448,0,706,806,-100,100,121400,121400,38054,296846,296846
721.456448,1,610,701,-91,91,121400,121400,33140,113160,113160
721.456448,2,6354,6366,-12,12,121400,121400,29215,-572415,-572415
721.456448,3,886,957,-71,71,121400,121400,27951,194249,194249
721.456448,4,120,50,70,-70,121400,121400,-2139,-30461,-30461
721.456448,5,4414,4372,42,-42,121400,121400,13754,-383454,-383454
721.456448,6,0,0,0,0,121400,121400,0,0,0
721.718001,0,706,806,-100,100,121400,121400,38054,296846,296846
721.718001,1,610,701,-91,91,121400,121400,33140,113160,113160
721.718001,2,6354,6366,-12,12,121400,121400,29215,-572415,-572415
721.718001,3,886,957,-71,71,121400,121400,27951,194249,194249
721.718001,4,120,50,70,-70,121400,121400,-2139,-30461,-30461
721.718001,5,4414,4372,42,-42,121400,121400,13754,-383454,-383454
721.718001,6,0,0,0,0,121400,121400,0,0,0
722.004445,0,706,806,-100,100,121400,121400,38054,296846,296846
722.004445,1,610,701,-91,91,121400,121400,33140,113160,113160
722.004445,2,6354,6366,-12,12,121400,121400,29215,-572415,-572415
722.004445,3,886,957,-71,71,121400,121400,27951,194249,194249
722.004445,4,120,50,70,-70,121400,121400,-2139,-30461,-30461
722.004445,5,4414,4372,42,-42,121400,121400,13754,-383454,-383454
722.004445,6,0,0,0,0,121400,121400,0,0,0
722.238799,0,706,806,-100,100,121400,121400,38054,296846,296846
722.238799,1,610,701,-91,91,121400,121400,33140,113160,113160
722.238799,2,6354,6366,-12,12,121400,121400,29215,-572415,-572415
722.238799,3,886,957,-71,71,121400,121400,27951,194249,194249
722.238799,4,120,50,70,-70,121400,121400,-2139,-30461,-30461
722.238799,5,4414,4372,42,-42,121400,121400,13754,-383454,-383454
722.238799,6,0,0,0,0,121400,121400,0,0,0
722.519405,0,706,806,-100,100,121400,121400,38054,296846,296846
722.519405,1,610,701,-91,91,121400,121400,33140,113160,113160
722.519405,2,6354,6366,-12,12,121400,121400,29215,-572415,-572415
722.519405,3,886,957,-71,71,121400,121400,27951,194249,194249
722.519405,4,120,50,70,-70,121400,121400,-2139,-30461,-30461
722.519405,5,4414,4372,42,-42,121400,121400,13754,-383454,-383454
722.519405,6,0,0,0,0,121400,121400,0,0,0
722.715461,0,706,806,-100,100,121600,121400,38054,296846,276846
722.715461,1,610,701,-91,91,121600,121400,33140,113160,94960
722.715461,2,6364,6366,-2,2,121600,121400,29093,-574293,-574693
722.715461,3,886,957,-71,71,121600,121400,27951,194249,180049
722.715461,4,120,50,70,-70,121600,121400,-2139,-30461,-16461
722.715461,5,4414,4382,32,-32,121600,121400,13997,-383697,-377297
722.715461,6,0,0,0,0,121600,121400,0,0,0
722.990625,0,706,806,-100,100,121400,121400,38054,296846,296846
722.990625,1,610,701,-91,91,121400,121400,33140,113160,113160
722.990625,2,6374,6366,8,-8,121400,121400,29336,-574536,-574536
722.990625,3,886,957,-71,71,121400,121400,27951,194249,194249
722.990625,4,120,50,70,-70,121400,121400,-2139,-30461,-30461
722.990625,5,4414,4392,22,-22,121400,121400,13876,-385576,-385576
722.990625,6,0,0,0,0,121400,121400,0,0,0
723.234947,0,706,806,-100,100,121400,121400,38054,296846,296846
723.234947,1,610,701,-91,91,121400,121400,33140,113160,113160
723.234947,2,6374,6366,8,-8,121400,121400,29336,-574536,-574536
723.234947,3,886,957,-71,71,121400,121400,27951,194249,194249
723.234947,4,120,50,70,-70,121400,121400,-2139,-30461,-30461
723.234947,5,4414,4392,22,-22,121400,121400,13876,-385576,-385576
723.234947,6,0,0,0,0,121400,121400,0,0,0
723.530159,0,706,806,-100,100,121400,121400,38054,296846,296846
723.530159,1,610,701,-91,91,121400,121400,33140,113160,113160
723.530159,2,6384,6366,18,-18,121400,121400,29215,-575415,-575415
723.530159,3,886,957,-71,71,121400,121400,27951,194249,194249
723.530159,4,120,50,70,-70,121400,121400,-2139,-30461,-30461
723.530159,5,4414,4402,12,-12,121400,121400,14119,-386819,-386819
723.530159,6,0,0,0,0,121400,121400,0,0,0
723.703756,0,706,806,-100,100,121400,121400,38054,296846,296846
723.703756,1,610,701,-91,91,121400,121400,33140,113160,113160
723.703756,2,6384,6366,18,-18,121400,121400,29215,-575415,-575415
723.703756,3,886,957,-71,71,121400,121400,27951,194249,194249
723.703756,4,120,50,70,-70,121400,121400,-2139,-30461,-30461
723.703756,5,4414,4402,12,-12,121400,121400,14119,-386819,-386819
723.703756,6,0,0,0,0,121400,121400,0,0,0
723.980865,0,706,806,-100,100,121400,121400,38054,296846,296846
723.980865,1,610,701,-91,91,121400,121400,33140,113160,113160
723.980865,2,6384,6366,18,-18,121400,121400,29215,-575415,-575415
723.980865,3,886,957,-71,71,121400,121400,27951,194249,194249
723.980865,4,120,50,70,-70,121400,121400,-2139,-30461,-30461
723.980865,5,4414,4402,12,-12,121400,121400,14119,-386819,-386819
723.980865,6,0,0,0,0,121400,121400,0,0,0
724.23045,0,706,806,-100,100,121100,121400,38054,296846,321146
724.23045,1,610,701,-91,91,121100,121400,33140,113160,135273
724.23045,2,6394,6366,28,-28,121100,121400,29094,-574294,-581098
724.23045,3,886,957,-71,71,121100,121400,27951,194249,211502
724.23045,4,120,50,70,-70,121100,121400,-2139,-30461,-47471
724.23045,5,4424,4402,22,-22,121100,121400,13998,-385698,-391044
724.23045,6,0,0,0,0,121100,121400,0,0,0
724.547617,0,706,806,-100,100,121400,121600,38054,296846,316846
724.547617,1,610,701,-91,91,121400,121600,33140,113160,131360
724.547617,2,6394,6372,22,-22,121400,121600,29021,-575421,-579821
724.547617,3,892,957,-65,65,121400,121600,28097,194103,207103
724.547617,4,120,50,70,-70,121400,121600,-2139,-30461,-44461
724.547617,5,4424,4402,22,-22,121400,121600,13998,-385698,-390098
724.547617,6,0,0,0,0,121400,121600,0,0,0
724.731307,0,706,806,-100,100,121900,121600,38054,296846,272546
724.731307,1,610,701,-91,91,121900,121600,33140,113160,91047
724.731307,2,6394,6382,12,-12,121900,121600,28900,-577300,-574384
724.731307,3,892,959,-67,67,121900,121600,28073,194727,178446
724.731307,4,120,50,70,-70,121900,121600,-2139,-30461,-13451
724.731307,5,4424,4402,22,-22,121900,121600,13998,-385698,-380352
724.731307,6,0,0,0,0,121900,121600,0,0,0
724.989025,0,706,806,-100,100,121400,121600,38054,296846,316846
724.989025,1,610,701,-91,91,121400,121600,33140,113160,131360
724.989025,2,6394,6388,6,-6,121400,121600,28827,-577827,-579027
724.989025,3,898,959,-61,61,121400,121600,28219,194581,206781
724.989025,4,120,50,70,-70,121400,121600,-2139,-30461,-44461
724.989025,5,4424,4402,22,-22,121400,121600,13998,-385698,-390098
724.989025,6,0,0,0,0,121400,121600,0,0,0
725.204382,0,706,806,-100,100,121400,121500,38054,296846,306846
725.204382,1,610,701,-91,91,121400,121500,33140,113160,122260
725.204382,2,6394,6388,6,-6,121400,121500,28827,-577827,-578427
725.204382,3,898,959,-61,61,121400,121500,28219,194581,200681
725.204382,4,120,50,70,-70,121400,121500,-2139,-30461,-37461
725.204382,5,4424,4402,22,-22,121400,121500,13998,-385698,-387898
725.204382,6,0,0,0,0,121400,121500,0,0,0
725.514008,0,706,806,-100,100,121600,121500,38054,296846,286846
725.514008,1,610,701,-91,91,121600,121500,33140,113160,104060
725.514008,2,6404,6394,10,-10,121600,121500,28633,-577633,-576633
725.514008,3,904,959,-55,55,121600,121500,28365,193235,187735
725.514008,4,120,50,70,-70,121600,121500,-2139,-30461,-23461
725.514008,5,4424,4412,12,-12,121600,121500,14241,-387941,-386741
725.514008,6,0,0,0,0,121600,121500,0,0,0
725.702208,0,706,806,-100,100,121700,121500,38054,296846,276846
725.702208,1,610,701,-91,91,121700,121500,33140,113160,94960
725.702208,2,6404,6398,6,-6,121700,121500,28584,-577584,-576384
725.702208,3,909,959,-50,50,121700,121500,28486,192014,182014
725.702208,4,120,50,70,-70,121700,121500,-2139,-30461,-16461
725.702208,5,4424,4413,11,-11,121700,121500,14229,-387829,-385629
725.702208,6,0,0,0,0,121700,121500,0,0,0
726.036895,0,706,806,-100,100,121700,121500,38054,296846,276846
726.036895,1,610,701,-91,91,121700,121500,33140,113160,94960
726.036895,2,6404,6398,6,-6,121700,121500,28584,-577584,-576384
726.036895,3,909,959,-50,50,121700,121500,28486,192014,182014
726.036895,4,120,50,70,-70,121700,121500,-2139,-30461,-16461
726.036895,5,4424,4413,11,-11,121700,121500,14229,-387829,-385629
726.036895,6,0,0,0,0,121700,121500,0,0,0
726.219879,0,706,806,-100,100,121700,121500,38054,296846,276846
726.219879,1,610,701,-91,91,121700,121500,33140,113160,94960
726.219879,2,6404,6398,6,-6,121700,121500,28584,-577584,-576384
726.219879,3,909,959,-50,50,121700,121500,28486,192014,182014
726.219879,4,120,50,70,-70,121700,121500,-2139,-30461,-16461
726.219879,5,4424,4413,11,-11,121700,121500,14229,-387829,-385629
726.219879,6,0,0,0,0,121700,121500,0,0,0
726.542184,0,706,806,-100,100,121700,121500,38054,296846,276846
726.542184,1,610,701,-91,91,121700,121500,33140,113160,94960
726.542184,2,6404,6398,6,-6,121700,121500,28584,-577584,-576384
726.542184,3,909,959,-50,50,121700,121500,28486,192014,182014
726.542184,4,120,50,70,-70,121700,121500,-2139,-30461,-16461
726.542184,5,4424,4413,11,-11,121700,121500,14229,-387829,-385629
726.542184,6,0,0,0,0,121700,121500,0,0,0
726.719604,0,706,806,-100,100,121700,121500,38054,296846,276846
726.719604,1,610,701,-91,91,121700,121500,33140,113160,94960
726.719604,2,6404,6398,6,-6,121700,121500,28584,-577584,-576384
726.719604,3,909,959,-50,50,121700,121500,28486,192014,182014
726.719604,4,120,50,70,-70,121700,121500,-2139,-30461,-16461
726.719604,5,4424,4413,11,-11,121700,121500,14229,-387829,-385629
726.719604,6,0,0,0,0,121700,121500,0,0,0
727.010055,0,706,806,-100,100,121400,121500,38054,296846,306846
727.010055,1,610,701,-91,91,121400,121500,33140,113160,122260
727.010055,2,6414,6398,16,-16,121400,121500,28827,-577827,-579427
727.010055,3,909,959,-50,50,121400,121500,28486,192014,197014
727.010055,4,120,50,70,-70,121400,121500,-2139,-30461,-37461
727.010055,5,4424,4423,1,-1,121400,121500,14108,-389708,-389808
727.010055,6,0,0,0,0,121400,121500,0,0,0
727.200744,0,706,806,-100,100,121600,121500,38054,296846,286846
727.200744,1,610,701,-91,91,121600,121500,33140,113160,104060
727.200744,2,6414,6408,6,-6,121600,121500,28706,-578706,-578106
727.200744,3,909,959,-50,50,121600,121500,28486,192014,187014
727.200744,4,120,50,70,-70,121600,121500,-2139,-30461,-23461
727.200744,5,4424,4433,-9,9,121600,121500,13987,-390587,-391487
727.200744,6,0,0,0,0,121600,121500,0,0,0
727.466437,0,706,806,-100,100,121500,121500,38054,296846,296846
727.466437,1,610,701,-91,91,121500,121500,33140,113160,113160
727.466437,2,6414,6418,-4,4,121500,121500,28949,-578949,-578949
727.466437,3,909,959,-50,50,121500,121500,28486,192014,192014
727.466437,4,120,50,70,-70,121500,121500,-2139,-30461,-30461
727.466437,5,4434,4433,1,-1,121500,121500,13865,-392465,-392465
727.466437,6,0,0,0,0,121500,121500,0,0,0
727.749304,0,706,806,-100,100,121600,121500,38054,296846,286846
727.749304,1,610,701,-91,91,121600,121500,33140,113160,104060
727.749304,2,6424,6418,6,-6,121600,121500,29192,-580192,-579592
727.749304,3,909,959,-50,50,121600,121500,28486,192014,187014
727.749304,4,120,50,70,-70,121600,121500,-2139,-30461,-23461
727.749304,5,4434,4433,1,-1,121600,121500,13865,-392465,-392365
727.749304,6,0,0,0,0,121600,121500,0,0,0
727.955307,0,706,806,-100,100,121600,121500,38054,296846,286846
727.955307,1,610,701,-91,91,121600,121500,33140,113160,104060
727.955307,2,6424,6418,6,-6,121600,121500,29192,-580192,-579592
727.955307,3,909,959,-50,50,121600,121500,28486,192014,187014
727.955307,4,120,50,70,-70,121600,121500,-2139,-30461,-23461
727.955307,5,4434,4433,1,-1,121600,121500,13865,-392465,-392365
727.955307,6,0,0,0,0,121600,121500,0,0,0
728.270809,0,706,806,-100,100,121600,121500,38054,296846,286846
728.270809,1,610,701,-91,91,121600,121500,33140,113160,104060
728.270809,2,6424,6418,6,-6,121600,121500,29192,-580192,-579592
728.270809,3,909,959,-50,50,121600,121500,28486,192014,187014
728.270809,4,120,50,70,-70,121600,121500,-2139,-30461,-23461
728.270809,5,4434,4433,1,-1,121600,121500,13865,-392465,-392365
728.270809,6,0,0,0,0,121600,121500,0,0,0
728.549983,0,706,806,-100,100,121600,121600,38054,296846,296846
728.549983,1,610,701,-91,91,121600,121600,33140,113160,113160
728.549983,2,6424,6418,6,-6,121600,121600,29192,-580192,-580192
728.549983,3,909,959,-50,50,121600,121600,28486,192014,192014
728.549983,4,120,50,70,-70,121600,121600,-2139,-30461,-30461
728.549983,5,4434,4433,1,-1,121600,121600,13865,-392465,-392465
728.549983,6,0,0,0,0,121600,121600,0,0,0
728.75401,0,706,806,-100,100,121600,121600,38054,296846,296846
728.75401,1,610,701,-91,91,121600,121600,33140,113160,113160
728.75401,2,6434,6418,16,-16,121600,121600,29435,-580435,-580435
728.75401,3,914,959,-45,45,121600,121600,28608,191892,191892
728.75401,4,120,50,70,-70,121600,121600,-2139,-30461,-30461
728.75401,5,4434,4433,1,-1,121600,121600,13865,-392465,-392465
728.75401,6,0,0,0,0,121600,121600,0,0,0
729.02499,0,706,806,-100,100,121600,121600,38054,296846,296846
729.02499,1,610,701,-91,91,121600,121600,33140,113160,113160
729.02499,2,6434,6418,16,-16,121600,121600,29435,-580435,-580435
729.02499,3,914,959,-45,45,121600,121600,28608,191892,191892
729.02499,4,120,50,70,-70,121600,121600,-2139,-30461,-30461
729.02499,5,4434,4433,1,-1,121600,121600,13865,-392465,-392465
729.02499,6,0,0,0,0,121600,121600,0,0,0
729.208096,0,706,806,-100,100,121600,121900,38054,296846,321246
729.208096,1,627,701,-74,74,121600,121900,33553,116147,134203
729.208096,2,6444,6418,26,-26,121600,121900,29678,-578678,-585022
729.208096,3,918,959,-41,41,121600,121900,28705,192595,202599
729.208096,4,120,50,70,-70,121600,121900,-2139,-30461,-47541
729.208096,5,4444,4433,11,-11,121600,121900,14108,-390708,-393392
729.208096,6,0,0,0,0,121600,121900,0,0,0
729.503721,0,706,806,-100,100,122200,121900,38054,296846,272446
729.503721,1,627,701,-74,74,122200,121900,33553,116147,98091
729.503721,2,6444,6428,16,-16,122200,121900,29556,-581156,-577252
729.503721,3,926,959,-33,33,122200,121900,28899,192401,184349
729.503721,4,120,50,70,-70,122200,121900,-2139,-30461,-13381
729.503721,5,4444,4443,1,-1,122200,121900,13986,-394586,-394342
729.503721,6,0,0,0,0,122200,121900,0,0,0
729.791115,0,706,806,-100,100,122200,121900,38054,296846,272446
729.791115,1,627,701,-74,74,122200,121900,33553,116147,98091
729.791115,2,6444,6428,16,-16,122200,121900,29556,-581156,-577252
729.791115,3,929,959,-30,30,122200,121900,28972,192028,184708
729.791115,4,120,50,70,-70,122200,121900,-2139,-30461,-13381
729.791115,5,4444,4443,1,-1,122200,121900,13986,-394586,-394342
729.791115,6,0,0,0,0,122200,121900,0,0,0
729.972764,0,706,806,-100,100,122000,121900,38054,296846,286846
729.972764,1,627,701,-74,74,122000,121900,33553,116147,108747
729.972764,2,6447,6435,12,-12,122000,121900,29433,-581133,-579933
729.972764,3,929,959,-30,30,122000,121900,28972,192028,189028
729.972764,4,120,50,70,-70,122000,121900,-2139,-30461,-23461
729.972764,5,4454,4443,11,-11,122000,121900,14230,-395830,-394730
729.972764,6,0,0,0,0,122000,121900,0,0,0
730.204264,0,706,806,-100,100,122300,121900,38054,296846,272446
730.204264,1,627,701,-74,74,122300,121900,33553,116147,98091
730.204264,2,6447,6438,9,-9,122300,121900,29396,-581396,-579200
730.204264,3,932,959,-27,27,122300,121900,29045,191655,185067
730.204264,4,120,50,70,-70,122300,121900,-2139,-30461,-13381
730.204264,5,4454,4443,11,-11,122300,121900,14230,-395830,-393146
730.204264,6,0,0,0,0,122300,121900,0,0,0
730.530711,0,706,806,-100,100,122400,121900,38054,296846,272446
730.530711,1,627,701,-74,74,122400,121900,33553,116147,98091
730.530711,2,6447,6438,9,-9,122400,121900,29396,-581396,-579200
730.530711,3,938,959,-21,21,122400,121900,29191,190909,185785
730.530711,4,120,50,70,-70,122400,121900,-2139,-30461,-13381
730.530711,5,4454,4443,11,-11,122400,121900,14230,-395830,-393146
730.530711,6,0,0,0,0,122400,121900,0,0,0
730.724887,0,706,806,-100,100,122400,122300,38054,296846,286846
730.724887,1,627,701,-74,74,122400,122300,33553,116147,108747
730.724887,2,6447,6438,9,-9,122400,122300,29396,-581396,-580496
730.724887,3,940,959,-19,19,122400,122300,29240,190260,188360
730.724887,4,120,50,70,-70,122400,122300,-2139,-30461,-23461
730.724887,5,4454,4443,11,-11,122400,122300,14230,-395830,-394730
730.724887,6,0,0,0,0,122400,122300,0,0,0
731.039799,0,706,806,-100,100,122400,122300,38054,296846,286846
731.039799,1,627,701,-74,74,122400,122300,33553,116147,108747
731.039799,2,6447,6438,9,-9,122400,122300,29396,-581396,-580496
731.039799,3,940,959,-19,19,122400,122300,29240,190260,188360
731.039799,4,120,50,70,-70,122400,122300,-2139,-30461,-23461
731.039799,5,4454,4443,11,-11,122400,122300,14230,-395830,-394730
731.039799,6,0,0,0,0,122400,122300,0,0,0
731.261655,0,706,806,-100,100,122400,122300,38054,296846,286846
731.261655,1,627,701,-74,74,122400,122300,33553,116147,108747
731.261655,2,6447,6438,9,-9,122400,122300,29396,-581396,-580496
731.261655,3,940,959,-19,19,122400,122300,29240,190260,188360
731.261655,4,120,50,70,-70,122400,122300,-2139,-30461,-23461
731.261655,5,4454,4443,11,-11,122400,122300,14230,-395830,-394730
731.261655,6,0,0,0,0,122400,122300,0,0,0
731.48532,0,706,806,-100,100,122400,122300,38054,296846,286846
731.48532,1,627,701,-74,74,122400,122300,33553,116147,108747
731.48532,2,6447,6438,9,-9,122400,122300,29396,-581396,-580496
731.48532,3,940,959,-19,19,122400,122300,29240,190260,188360
731.48532,4,120,50,70,-70,122400,122300,-2139,-30461,-23461
731.48532,5,4454,4443,11,-11,122400,122300,14230,-395830,-394730
731.48532,6,0,0,0,0,122400,122300,0,0,0
731.79114,0,706,806,-100,100,122400,122300,38054,296846,286846
731.79114,1,627,701,-74,74,122400,122300,33553,116147,108747
731.79114,2,6447,6438,9,-9,122400,122300,29396,-581396,-580496
731.79114,3,940,959,-19,19,122400,122300,29240,190260,188360
731.79114,4,120,50,70,-70,122400,122300,-2139,-30461,-23461
731.79114,5,4454,4443,11,-11,122400,122300,14230,-395830,-394730
731.79114,6,0,0,0,0,122400,122300,0,0,0
732.047131,0,706,806,-100,100,122400,122300,38054,296846,286846
732.047131,1,627,701,-74,74,122400,122300,33553,116147,108747
732.047131,2,6447,6438,9,-9,122400,122300,29396,-581396,-580496
732.047131,3,940,959,-19,19,122400,122300,29240,190260,188360
732.047131,4,120,50,70,-70,122400,122300,-2139,-30461,-23461
732.047131,5,4454,4443,11,-11,122400,122300,14230,-395830,-394730
732.047131,6,0,0,0,0,122400,122300,0,0,0
732.233322,0,706,806,-100,100,122400,122300,38054,296846,286846
732.233322,1,627,701,-74,74,122400,122300,33553,116147,108747
732.233322,2,6447,6438,9,-9,122400,122300,29396,-581396,-580496
732.233322,3,940,959,-19,19,122400,122300,29240,190260,188360
732.233322,4,120,50,70,-70,122400,122300,-2139,-30461,-23461
732.233322,5,4454,4443,11,-11,122400,122300,14230,-395830,-394730
732.233322,6,0,0,0,0,122400,122300,0,0,0
732.532268,0,706,806,-100,100,122000,122300,38054,296846,321346
732.532268,1,627,701,-74,74,122000,122300,33553,116147,134277
732.532268,2,6457,6438,19,-19,122000,122300,29274,-581274,-585929
732.532268,3,940,959,-19,19,122000,122300,29240,190260,194915
732.532268,4,120,50,70,-70,122000,122300,-2139,-30461,-47611
732.532268,5,4461,4443,18,-18,122000,122300,14145,-394345,-398755
732.532268,6,0,0,0,0,122000,122300,0,0,0
732.76515,0,706,806,-100,100,122000,122300,38054,296846,321346
732.76515,1,627,701,-74,74,122000,122300,33553,116147,134277
732.76515,2,6457,6438,19,-19,122000,122300,29274,-581274,-585929
732.76515,3,940,959,-19,19,122000,122300,29240,190260,194915
732.76515,4,120,50,70,-70,122000,122300,-2139,-30461,-47611
732.76515,5,4461,4443,18,-18,122000,122300,14145,-394345,-398755
732.76515,6,0,0,0,0,122000,122300,0,0,0
733.015383,0,706,806,-100,100,122200,122300,38054,296846,306846
733.015383,1,627,701,-74,74,122200,122300,33553,116147,123547
733.015383,2,6457,6440,17,-17,122200,122300,29250,-581450,-583150
733.015383,3,942,959,-17,17,122200,122300,29289,190211,191911
733.015383,4,120,50,70,-70,122200,122300,-2139,-30461,-37461
733.015383,5,4461,4443,18,-18,122200,122300,14145,-394345,-396145
733.015383,6,0,0,0,0,122200,122300,0,0,0
733.246339,0,706,806,-100,100,122200,122300,38054,296846,306846
733.246339,1,627,701,-74,74,122200,122300,33553,116147,123547
733.246339,2,6457,6442,15,-15,122200,122300,29226,-582026,-583526
733.246339,3,944,959,-15,15,122200,122300,29338,190362,191862
733.246339,4,120,50,70,-70,122200,122300,-2139,-30461,-37461
733.246339,5,4461,4443,18,-18,122200,122300,14145,-394345,-396145
733.246339,6,0,0,0,0,122200,122300,0,0,0
733.457484,0,706,806,-100,100,122300,122300,38054,296846,296846
733.457484,1,627,701,-74,74,122300,122300,33553,116147,116147
733.457484,2,6457,6444,13,-13,122300,122300,29202,-582202,-582202
733.457484,3,946,959,-13,13,122300,122300,29387,190313,190313
733.457484,4,120,50,70,-70,122300,122300,-2139,-30461,-30461
733.457484,5,4461,4443,18,-18,122300,122300,14145,-394345,-394345
733.457484,6,0,0,0,0,122300,122300,0,0,0
733.784817,0,706,806,-100,100,122300,122300,38054,296846,296846
733.784817,1,627,701,-74,74,122300,122300,33553,116147,116147
733.784817,2,6457,6444,13,-13,122300,122300,29202,-582202,-582202
733.784817,3,946,959,-13,13,122300,122300,29387,190313,190313
733.784817,4,120,50,70,-70,122300,122300,-2139,-30461,-30461
733.784817,5,4461,4443,18,-18,122300,122300,14145,-394345,-394345
733.784817,6,0,0,0,0,122300,122300,0,0,0
734.006742,0,706,806,-100,100,122300,122300,38054,296846,296846
734.006742,1,627,701,-74,74,122300,122300,33553,116147,116147
734.006742,2,6457,6444,13,-13,122300,122300,29202,-582202,-582202
734.006742,3,946,959,-13,13,122300,122300,29387,190313,190313
734.006742,4,120,50,70,-70,122300,122300,-2139,-30461,-30461
734.006742,5,4461,4443,18,-18,122300,122300,14145,-394345,-394345
734.006742,6,0,0,0,0,122300,122300,0,0,0
734.226614,0,706,806,-100,100,122300,122300,38054,296846,296846
734.226614,1,627,701,-74,74,122300,122300,33553,116147,116147
734.226614,2,6457,6444,13,-13,122300,122300,29202,-582202,-582202
734.226614,3,946,959,-13,13,122300,122300,29387,190313,190313
734.226614,4,120,50,70,-70,122300,122300,-2139,-30461,-30461
734.226614,5,4461,4443,18,-18,122300,122300,14145,-394345,-394345
734.226614,6,0,0,0,0,122300,122300,0,0,0
734.456452,0,706,806,-100,100,122300,122300,38054,296846,296846
734.456452,1,627,701,-74,74,122300,122300,33553,116147,116147
734.456452,2,6457,6444,13,-13,122300,122300,29202,-582202,-582202
734.456452,3,946,959,-13,13,122300,122300,29387,190313,190313
734.456452,4,120,50,70,-70,122300,122300,-2139,-30461,-30461
734.456452,5,4461,4443,18,-18,122300,122300,14145,-394345,-394345
734.456452,6,0,0,0,0,122300,122300,0,0,0
734.742697,0,706,806,-100,100,122300,122400,38054,296846,306846
734.742697,1,627,701,-74,74,122300,122400,33553,116147,123547
734.742697,2,6457,6444,13,-13,122300,122400,29202,-582202,-583502
734.742697,3,946,959,-13,13,122300,122400,29387,190313,191613
734.742697,4,120,50,70,-70,122300,122400,-2139,-30461,-37461
734.742697,5,4461,4443,18,-18,122300,122400,14145,-394345,-396145
734.742697,6,0,0,0,0,122300,122400,0,0,0
734.974912,0,706,806,-100,100,122400,122400,38054,296846,296846
734.974912,1,627,701,-74,74,122400,122400,33553,116147,116147
734.974912,2,6457,6444,13,-13,122400,122400,29202,-582202,-582202
734.974912,3,948,959,-11,11,122400,122400,29436,190464,190464
734.974912,4,120,50,70,-70,122400,122400,-2139,-30461,-30461
734.974912,5,4461,4443,18,-18,122400,122400,14145,-394345,-394345
734.974912,6,0,0,0,0,122400,122400,0,0,0
735.251724,0,731,806,-75,75,122500,122400,38666,298734,291234
735.251724,1,627,701,-74,74,122500,122400,33553,116147,108747
735.251724,2,6467,6454,13,-13,122500,122400,29325,-584325,-583025
735.251724,3,950,959,-9,9,122500,122400,29485,190415,189515
735.251724,4,120,50,70,-70,122500,122400,-2139,-30461,-23461
735.251724,5,4461,4453,8,-8,122500,122400,14023,-396223,-395423
735.251724,6,0,0,0,0,122500,122400,0,0,0
735.45835,0,731,806,-75,75,122500,122400,38666,298734,291234
735.45835,1,627,701,-74,74,122500,122400,33553,116147,108747
735.45835,2,6467,6454,13,-13,122500,122400,29325,-584325,-583025
735.45835,3,954,959,-5,5,122500,122400,29583,190317,189817
735.45835,4,120,50,70,-70,122500,122400,-2139,-30461,-23461
735.45835,5,4461,4453,8,-8,122500,122400,14023,-396223,-395423
735.45835,6,0,0,0,0,122500,122400,0,0,0
735.764563,0,731,806,-75,75,122500,122400,38666,298734,291234
735.764563,1,627,701,-74,74,122500,122400,33553,116147,108747
735.764563,2,6467,6454,13,-13,122500,122400,29325,-584325,-583025
735.764563,3,956,959,-3,3,122500,122400,29632,190268,189968
735.764563,4,120,50,70,-70,122500,122400,-2139,-30461,-23461
735.764563,5,4461,4453,8,-8,122500,122400,14023,-396223,-395423
735.764563,6,0,0,0,0,122500,122400,0,0,0
736.037975,0,731,806,-75,75,122500,122400,38666,298734,291234
736.037975,1,627,701,-74,74,122500,122400,33553,116147,108747
736.037975,2,6467,6454,13,-13,122500,122400,29325,-584325,-583025
736.037975,3,956,959,-3,3,122500,122400,29632,190268,189968
736.037975,4,120,50,70,-70,122500,122400,-2139,-30461,-23461
736.037975,5,4461,4453,8,-8,122500,122400,14023,-396223,-395423
736.037975,6,0,0,0,0,122500,122400,0,0,0
736.271445,0,731,806,-75,75,122400,122400,38666,298734,298734
736.271445,1,627,701,-74,74,122400,122400,33553,116147,116147
736.271445,2,6477,6454,23,-23,122400,122400,29203,-583203,-583203
736.271445,3,958,959,-1,1,122400,122400,29608,190892,190892
736.271445,4,120,50,70,-70,122400,122400,-2139,-30461,-30461
736.271445,5,4481,4453,28,-28,122400,122400,13779,-393979,-393979
736.271445,6,0,0,0,0,122400,122400,0,0,0
736.503513,0,731,806,-75,75,122400,122400,38666,298734,298734
736.503513,1,627,701,-74,74,122400,122400,33553,116147,116147
736.503513,2,6477,6454,23,-23,122400,122400,29203,-583203,-583203
736.503513,3,958,959,-1,1,122400,122400,29608,190892,190892
736.503513,4,120,50,70,-70,122400,122400,-2139,-30461,-30461
736.503513,5,4481,4453,28,-28,122400,122400,13779,-393979,-393979
736.503513,6,0,0,0,0,122400,122400,0,0,0
736.747663,0,731,806,-75,75,122400,122400,38666,298734,298734
736.747663,1,627,701,-74,74,122400,122400,33553,116147,116147
736.747663,2,6477,6454,23,-23,122400,122400,29203,-583203,-583203
736.747663,3,958,959,-1,1,122400,122400,29608,190892,190892
736.747663,4,120,50,70,-70,122400,122400,-2139,-30461,-30461
736.747663,5,4481,4453,28,-28,122400,122400,13779,-393979,-393979
736.747663,6,0,0,0,0,122400,122400,0,0,0
737.035667,0,731,806,-75,75,122400,122400,38666,298734,298734
737.035667,1,627,701,-74,74,122400,122400,33553,116147,116147
737.035667,2,6477,6454,23,-23,122400,122400,29203,-583203,-583203
737.035667,3,958,959,-1,1,122400,122400,29608,190892,190892
737.035667,4,120,50,70,-70,122400,122400,-2139,-30461,-30461
737.035667,5,4485,4453,32,-32,122400,122400,13730,-393530,-393530
737.035667,6,0,0,0,0,122400,122400,0,0,0
737.210583,0,731,806,-75,75,122500,122500,38666,298734,298734
737.210583,1,662,701,-39,39,122500,122500,34410,118790,118790
737.210583,2,6477,6464,13,-13,122500,122500,29081,-585081,-585081
737.210583,3,958,959,-1,1,122500,122500,29608,190892,190892
737.210583,4,120,50,70,-70,122500,122500,-2139,-30461,-30461
737.210583,5,4485,4453,32,-32,122500,122500,13730,-393530,-393530
737.210583,6,0,0,0,0,122500,122500,0,0,0
737.546872,0,731,806,-75,75,122400,122500,38666,298734,306234
737.546872,1,662,701,-39,39,122400,122500,34410,118790,122690
737.546872,2,6477,6474,3,-3,122400,122500,29326,-587326,-587626
737.546872,3,958,959,-1,1,122400,122500,29608,190892,190992
737.546872,4,120,50,70,-70,122400,122500,-2139,-30461,-37461
737.546872,5,4495,4453,42,-42,122400,122500,13608,-393408,-397608
737.546872,6,0,0,0,0,122400,122500,0,0,0
737.744299,0,731,806,-75,75,122400,122500,38666,298734,306234
737.744299,1,662,701,-39,39,122400,122500,34410,118790,122690
737.744299,2,6477,6474,3,-3,122400,122500,29326,-587326,-587626
737.744299,3,958,959,-1,1,122400,122500,29608,190892,190992
737.744299,4,120,50,70,-70,122400,122500,-2139,-30461,-37461
737.744299,5,4495,4463,32,-32,122400,122500,13853,-396653,-399853
737.744299,6,0,0,0,0,122400,122500,0,0,0
738.029953,0,731,806,-75,75,122500,122500,38666,298734,298734
738.029953,1,662,701,-39,39,122500,122500,34410,118790,118790
738.029953,2,6487,6474,13,-13,122500,122500,29204,-587204,-587204
738.029953,3,958,959,-1,1,122500,122500,29608,190892,190892
738.029953,4,120,50,70,-70,122500,122500,-2139,-30461,-30461
738.029953,5,4495,4473,22,-22,122500,122500,14098,-398898,-398898
738.029953,6,0,0,0,0,122500,122500,0,0,0
738.293811,0,731,806,-75,75,122600,122500,38666,298734,291234
738.293811,1,662,701,-39,39,122600,122500,34410,118790,114890
738.293811,2,6487,6474,13,-13,122600,122500,29204,-587204,-585904
738.293811,3,960,959,1,-1,122600,122500,29658,190642,190742
738.293811,4,120,50,70,-70,122600,122500,-2139,-30461,-23461
738.293811,5,4495,4473,22,-22,122600,122500,14098,-398898,-396698
738.293811,6,0,0,0,0,122600,122500,0,0,0
738.513653,0,731,806,-75,75,122600,122500,38666,298734,291234
738.513653,1,662,701,-39,39,122600,122500,34410,118790,114890
738.513653,2,6487,6474,13,-13,122600,122500,29204,-587204,-585904
738.513653,3,960,959,1,-1,122600,122500,29658,190642,190742
738.513653,4,120,50,70,-70,122600,122500,-2139,-30461,-23461
738.513653,5,4495,4473,22,-22,122600,122500,14098,-398898,-396698
738.513653,6,0,0,0,0,122600,122500,0,0,0
738.747484,0,731,806,-75,75,122600,122500,38666,298734,291234
738.747484,1,662,701,-39,39,122600,122500,34410,118790,114890
738.747484,2,6487,6474,13,-13,122600,122500,29204,-587204,-585904
738.747484,3,960,959,1,-1,122600,122500,29658,190642,190742
738.747484,4,120,50,70,-70,122600,122500,-2139,-30461,-23461
738.747484,5,4495,4473,22,-22,122600,122500,14098,-398898,-396698
738.747484,6,0,0,0,0,122600,122500,0,0,0
739.040429,0,731,806,-75,75,122600,122500,38666,298734,291234
739.040429,1,662,701,-39,39,122600,122500,34410,118790,114890
739.040429,2,6487,6474,13,-13,122600,122500,29204,-587204,-585904
739.040429,3,960,959,1,-1,122600,122500,29658,190642,190742
739.040429,4,120,50,70,-70,122600,122500,-2139,-30461,-23461
739.040429,5,4495,4473,22,-22,122600,122500,14098,-398898,-396698
739.040429,6,0,0,0,0,122600,122500,0,0,0
739.282533,0,731,806,-75,75,122600,122500,38666,298734,291234
739.282533,1,662,701,-39,39,122600,122500,34410,118790,114890
739.282533,2,6487,6474,13,-13,122600,122500,29204,-587204,-585904
739.282533,3,960,959,1,-1,122600,122500,29658,190642,190742
739.282533,4,120,50,70,-70,122600,122500,-2139,-30461,-23461
739.282533,5,4495,4473,22,-22,122600,122500,14098,-398898,-396698
739.282533,6,0,0,0,0,122600,122500,0,0,0
739.519073,0,731,806,-75,75,122600,122500,38666,298734,291234
739.519073,1,662,701,-39,39,122600,122500,34410,118790,114890
739.519073,2,6487,6474,13,-13,122600,122500,29204,-587204,-585904
739.519073,3,960,959,1,-1,122600,122500,29658,190642,190742
739.519073,4,120,50,70,-70,122600,122500,-2139,-30461,-23461
739.519073,5,4495,4473,22,-22,122600,122500,14098,-398898,-396698
739.519073,6,0,0,0,0,122600,122500,0,0,0
739.765278,0,731,806,-75,75,122600,122500,38666,298734,291234
739.765278,1,662,701,-39,39,122600,122500,34410,118790,114890
739.765278,2,6487,6474,13,-13,122600,122500,29204,-587204,-585904
739.765278,3,960,959,1,-1,122600,122500,29658,190642,190742
739.765278,4,120,50,70,-70,122600,122500,-2139,-30461,-23461
739.765278,5,4495,4473,22,-22,122600,122500,14098,-398898,-396698
739.765278,6,0,0,0,0,122600,122500,0,0,0
739.980265,0,731,806,-75,75,122600,122500,38666,298734,291234
739.980265,1,662,701,-39,39,122600,122500,34410,118790,114890
739.980265,2,6487,6474,13,-13,122600,122500,29204,-587204,-585904
739.980265,3,960,959,1,-1,122600,122500,29658,190642,190742
739.980265,4,120,50,70,-70,122600,122500,-2139,-30461,-23461
739.980265,5,4495,4473,22,-22,122600,122500,14098,-398898,-396698
739.980265,6,0,0,0,0,122600,122500,0,0,0
740.266569,0,731,806,-75,75,122600,122500,38666,298734,291234
740.266569,1,662,701,-39,39,122600,122500,34410,118790,114890
740.266569,2,6487,6474,13,-13,122600,122500,29204,-587204,-585904
740.266569,3,960,959,1,-1,122600,122500,29658,190642,190742
740.266569,4,120,50,70,-70,122600,122500,-2139,-30461,-23461
740.266569,5,4495,4473,22,-22,122600,122500,14098,-398898,-396698
740.266569,6,0,0,0,0,122600,122500,0,0,0
740.491857,0,731,806,-75,75,122300,122500,38666,298734,313734
740.491857,1,662,701,-39,39,122300,122500,34410,118790,126590
740.491857,2,6497,6474,23,-23,122300,122500,29082,-586082,-590682
740.491857,3,962,959,3,-3,122300,122500,29634,191266,190666
740.491857,4,120,50,70,-70,122300,122500,-2139,-30461,-44461
740.491857,5,4497,4473,24,-24,122300,122500,14074,-398274,-403074
740.491857,6,0,0,0,0,122300,122500,0,0,0
740.772897,0,731,806,-75,75,122300,122500,38666,298734,313734
740.772897,1,662,701,-39,39,122300,122500,34410,118790,126590
740.772897,2,6497,6474,23,-23,122300,122500,29082,-586082,-590682
740.772897,3,962,959,3,-3,122300,122500,29634,191266,190666
740.772897,4,120,50,70,-70,122300,122500,-2139,-30461,-44461
740.772897,5,4497,4473,24,-24,122300,122500,14074,-398274,-403074
740.772897,6,0,0,0,0,122300,122500,0,0,0
741.043292,0,731,806,-75,75,122300,122500,38666,298734,313734
741.043292,1,662,701,-39,39,122300,122500,34410,118790,126590
741.043292,2,6497,6474,23,-23,122300,122500,29082,-586082,-590682
741.043292,3,962,959,3,-3,122300,122500,29634,191266,190666
741.043292,4,120,50,70,-70,122300,122500,-2139,-30461,-44461
741.043292,5,4497,4473,24,-24,122300,122500,14074,-398274,-403074
741.043292,6,0,0,0,0,122300,122500,0,0,0
741.267487,0,731,806,-75,75,122400,122500,38666,298734,306234
741.267487,1,670,701,-31,31,122400,122500,34606,119394,122494
741.267487,2,6497,6484,13,-13,122400,122500,28960,-587960,-589260
741.267487,3,964,959,5,-5,122400,122500,29683,191417,190917
741.267487,4,120,50,70,-70,122400,122500,-2139,-30461,-37461
741.267487,5,4497,4473,24,-24,122400,122500,14074,-398274,-400674
741.267487,6,0,0,0,0,122400,122500,0,0,0
741.524446,0,731,806,-75,75,122500,122500,38666,298734,298734
741.524446,1,670,701,-31,31,122500,122500,34606,119394,119394
741.524446,2,6497,6494,3,-3,122500,122500,29205,-589205,-589205
741.524446,3,964,959,5,-5,122500,122500,29683,191417,191417
741.524446,4,120,50,70,-70,122500,122500,-2139,-30461,-30461
741.524446,5,4497,4493,4,-4,122500,122500,14197,-400397,-400397
741.524446,6,0,0,0,0,122500,122500,0,0,0
741.74123,0,731,806,-75,75,122500,122500,38666,298734,298734
741.74123,1,670,701,-31,31,122500,122500,34606,119394,119394
741.74123,2,6497,6494,3,-3,122500,122500,29205,-589205,-589205
741.74123,3,964,959,5,-5,122500,122500,29683,191417,191417
741.74123,4,120,50,70,-70,122500,122500,-2139,-30461,-30461
741.74123,5,4497,4493,4,-4,122500,122500,14197,-400397,-400397
741.74123,6,0,0,0,0,122500,122500,0,0,0
742.030477,0,731,806,-75,75,122500,122400,38666,298734,291234
742.030477,1,670,701,-31,31,122500,122400,34606,119394,116294
742.030477,2,6497,6494,3,-3,122500,122400,29205,-589205,-588905
742.030477,3,964,959,5,-5,122500,122400,29683,191417,191917
742.030477,4,120,50,70,-70,122500,122400,-2139,-30461,-23461
742.030477,5,4497,4493,4,-4,122500,122400,14197,-400397,-399997
742.030477,6,0,0,0,0,122500,122400,0,0,0
742.296018,0,731,806,-75,75,122500,122400,38666,298734,291234
742.296018,1,670,701,-31,31,122500,122400,34606,119394,116294
742.296018,2,6497,6504,-7,7,122500,122400,29450,-588450,-589150
742.296018,3,964,961,3,-3,122500,122400,29732,191568,191868
742.296018,4,120,50,70,-70,122500,122400,-2139,-30461,-23461
742.296018,5,4497,4493,4,-4,122500,122400,14197,-400397,-399997
742.296018,6,0,0,0,0,122500,122400,0,0,0
742.542808,0,731,806,-75,75,122500,122200,38666,298734,280434
742.542808,1,670,701,-31,31,122500,122200,34606,119394,111830
742.542808,2,6497,6504,-7,7,122500,122200,29450,-588450,-590158
742.542808,3,964,961,3,-3,122500,122200,29732,191568,192300
742.542808,4,120,50,70,-70,122500,122200,-2139,-30461,-13381
742.542808,5,4497,4493,4,-4,122500,122200,14197,-400397,-399421
742.542808,6,0,0,0,0,122500,122200,0,0,0
742.796222,0,731,806,-75,75,122600,122200,38666,298734,280434
742.796222,1,670,701,-31,31,122600,122200,34606,119394,111830
742.796222,2,6499,6514,-15,15,122600,122200,29304,-587704,-591364
742.796222,3,964,963,1,-1,122600,122200,29781,191719,191963
742.796222,4,120,50,70,-70,122600,122200,-2139,-30461,-13381
742.796222,5,4497,4493,4,-4,122600,122200,14197,-400397,-399421
742.796222,6,0,0,0,0,122600,122200,0,0,0
743.016718,0,731,806,-75,75,122600,122200,38666,298734,280434
743.016718,1,670,701,-31,31,122600,122200,34606,119394,111830
743.016718,2,6499,6514,-15,15,122600,122200,29304,-587704,-591364
743.016718,3,964,963,1,-1,122600,122200,29781,191719,191963
743.016718,4,120,50,70,-70,122600,122200,-2139,-30461,-13381
743.016718,5,4497,4493,4,-4,122600,122200,14197,-400397,-399421
743.016718,6,0,0,0,0,122600,122200,0,0,0
743.224025,0,731,806,-75,75,122400,122200,38666,298734,283734
743.224025,1,670,711,-41,41,122400,122200,34851,120149,111949
743.224025,2,6509,6514,-5,5,122400,122200,29182,-589582,-590582
743.224025,3,964,963,1,-1,122400,122200,29781,191719,191919
743.224025,4,120,50,70,-70,122400,122200,-2139,-30461,-16461
743.224025,5,4497,4493,4,-4,122400,122200,14197,-400397,-399597
743.224025,6,0,0,0,0,122400,122200,0,0,0
743.478606,0,731,806,-75,75,122400,122300,38666,298734,291234
743.478606,1,670,711,-41,41,122400,122300,34851,120149,116049
743.478606,2,6509,6514,-5,5,122400,122300,29182,-589582,-590082
743.478606,3,964,963,1,-1,122400,122300,29781,191719,191819
743.478606,4,120,50,70,-70,122400,122300,-2139,-30461,-23461
743.478606,5,4497,4493,4,-4,122400,122300,14197,-400397,-399997
743.478606,6,0,0,0,0,122400,122300,0,0,0
743.748536,0,731,806,-75,75,122400,122300,38666,298734,291234
743.748536,1,670,711,-41,41,122400,122300,34851,120149,116049
743.748536,2,6509,6514,-5,5,122400,122300,29182,-589582,-590082
743.748536,3,964,963,1,-1,122400,122300,29781,191719,191819
743.748536,4,120,50,70,-70,122400,122300,-2139,-30461,-23461
743.748536,5,4497,4493,4,-4,122400,122300,14197,-400397,-399997
743.748536,6,0,0,0,0,122400,122300,0,0,0
744.035256,0,731,806,-75,75,122600,122300,38666,298734,280359
744.035256,1,670,711,-41,41,122600,122300,34851,120149,110104
744.035256,2,6510,6524,-14,14,122600,122300,29048,-587648,-591078
744.035256,3,964,964,0,0,122600,122300,29805,191695,191695
744.035256,4,120,50,70,-70,122600,122300,-2139,-30461,-13311
744.035256,5,4497,4493,4,-4,122600,122300,14197,-400397,-399417
744.035256,6,0,0,0,0,122600,122300,0,0,0
744.294809,0,731,806,-75,75,122600,122300,38666,298734,280359
744.294809,1,670,711,-41,41,122600,122300,34851,120149,110104
744.294809,2,6510,6524,-14,14,122600,122300,29048,-587648,-591078
744.294809,3,964,964,0,0,122600,122300,29805,191695,191695
744.294809,4,120,50,70,-70,122600,122300,-2139,-30461,-13311
744.294809,5,4497,4493,4,-4,122600,122300,14197,-400397,-399417
744.294809,6,0,0,0,0,122600,122300,0,0,0
744.54899,0,731,806,-75,75,122300,122300,38666,298734,298734
744.54899,1,670,711,-41,41,122300,122300,34851,120149,120149
744.54899,2,6520,6524,-4,4,122300,122300,28926,-588526,-588526
744.54899,3,964,964,0,0,122300,122300,29805,191695,191695
744.54899,4,120,50,70,-70,122300,122300,-2139,-30461,-30461
744.54899,5,4497,4503,-6,6,122300,122300,14442,-401642,-401642
744.54899,6,0,0,0,0,122300,122300,0,0,0
744.729676,0,731,806,-75,75,122400,122300,38666,298734,291234
744.729676,1,670,711,-41,41,122400,122300,34851,120149,116049
744.729676,2,6530,6524,6,-6,122400,122300,28804,-591404,-590804
744.729676,3,964,964,0,0,122400,122300,29805,191695,191695
744.729676,4,120,50,70,-70,122400,122300,-2139,-30461,-23461
744.729676,5,4497,4513,-16,16,122400,122300,14687,-400887,-402487
744.729676,6,0,0,0,0,122400,122300,0,0,0
745.020758,0,731,806,-75,75,122400,122300,38666,298734,291234
745.020758,1,670,711,-41,41,122400,122300,34851,120149,116049
745.020758,2,6530,6534,-4,4,122400,122300,28682,-590282,-590682
745.020758,3,964,964,0,0,122400,122300,29805,191695,191695
745.020758,4,120,50,70,-70,122400,122300,-2139,-30461,-23461
745.020758,5,4507,4513,-6,6,122400,122300,14932,-404132,-404732
745.020758,6,0,0,0,0,122400,122300,0,0,0
745.266788,0,731,806,-75,75,121800,122300,38666,298734,317109
745.266788,1,670,711,-41,41,121800,122300,34851,120149,130194
745.266788,2,6540,6544,-4,4,121800,122300,28438,-592038,-591058
745.266788,3,966,964,2,-2,121800,122300,29781,192519,192029
745.266788,4,120,50,70,-70,121800,122300,-2139,-30461,-47611
745.266788,5,4517,4513,4,-4,121800,122300,15177,-404377,-405357
745.266788,6,0,0,0,0,121800,122300,0,0,0
745.531892,0,731,806,-75,75,121800,122300,38666,298734,317109
745.531892,1,670,711,-41,41,121800,122300,34851,120149,130194
745.531892,2,6540,6544,-4,4,121800,122300,28438,-592038,-591058
745.531892,3,966,964,2,-2,121800,122300,29781,192519,192029
745.531892,4,120,50,70,-70,121800,122300,-2139,-30461,-47611
745.531892,5,4517,4513,4,-4,121800,122300,15177,-404377,-405357
745.531892,6,0,0,0,0,121800,122300,0,0,0
745.782032,0,731,806,-75,75,122300,122300,38666,298734,298734
745.782032,1,670,711,-41,41,122300,122300,34851,120149,120149
745.782032,2,6542,6544,-2,2,122300,122300,28414,-592214,-592214
745.782032,3,966,966,0,0,122300,122300,29830,192270,192270
745.782032,4,120,50,70,-70,122300,122300,-2139,-30461,-30461
745.782032,5,4517,4513,4,-4,122300,122300,15177,-404377,-404377
745.782032,6,0,0,0,0,122300,122300,0,0,0
745.986472,0,731,806,-75,75,122300,122300,38666,298734,298734
745.986472,1,670,711,-41,41,122300,122300,34851,120149,120149
745.986472,2,6542,6544,-2,2,122300,122300,28414,-592214,-592214
745.986472,3,966,966,0,0,122300,122300,29830,192270,192270
745.986472,4,120,50,70,-70,122300,122300,-2139,-30461,-30461
745.986472,5,4517,4513,4,-4,122300,122300,15177,-404377,-404377
745.986472,6,0,0,0,0,122300,122300,0,0,0
746.220581,0,731,806,-75,75,121800,122300,38666,298734,317109
746.220581,1,670,711,-41,41,121800,122300,34851,120149,130194
746.220581,2,6552,6544,8,-8,121800,122300,28292,-593092,-595052
746.220581,3,968,966,2,-2,121800,122300,29806,192894,192404
746.220581,4,120,50,70,-70,121800,122300,-2139,-30461,-47611
746.220581,5,4527,4513,14,-14,121800,122300,15055,-403255,-406685
746.220581,6,0,0,0,0,121800,122300,0,0,0
746.536973,0,731,806,-75,75,121800,122300,38666,298734,317109
746.536973,1,670,711,-41,41,121800,122300,34851,120149,130194
746.536973,2,6552,6544,8,-8,121800,122300,28292,-593092,-595052
746.536973,3,968,966,2,-2,121800,122300,29806,192894,192404
746.536973,4,120,50,70,-70,121800,122300,-2139,-30461,-47611
746.536973,5,4527,4513,14,-14,121800,122300,15055,-403255,-406685
746.536973,6,0,0,0,0,121800,122300,0,0,0
746.727942,0,731,806,-75,75,121800,122300,38666,298734,317109
746.727942,1,670,711,-41,41,121800,122300,34851,120149,130194
746.727942,2,6552,6544,8,-8,121800,122300,28292,-593092,-595052
746.727942,3,968,966,2,-2,121800,122300,29806,192894,192404
746.727942,4,120,50,70,-70,121800,122300,-2139,-30461,-47611
746.727942,5,4527,4513,14,-14,121800,122300,15055,-403255,-406685
746.727942,6,0,0,0,0,121800,122300,0,0,0
746.976942,0,731,806,-75,75,121800,122300,38666,298734,317109
746.976942,1,670,711,-41,41,121800,122300,34851,120149,130194
746.976942,2,6552,6544,8,-8,121800,122300,28292,-593092,-595052
746.976942,3,968,966,2,-2,121800,122300,29806,192894,192404
746.976942,4,120,50,70,-70,121800,122300,-2139,-30461,-47611
746.976942,5,4527,4513,14,-14,121800,122300,15055,-403255,-406685
746.976942,6,0,0,0,0,121800,122300,0,0,0
747.221657,0,731,806,-75,75,121800,122300,38666,298734,317109
747.221657,1,670,711,-41,41,121800,122300,34851,120149,130194
747.221657,2,6552,6544,8,-8,121800,122300,28292,-593092,-595052
747.221657,3,968,966,2,-2,121800,122300,29806,192894,192404
747.221657,4,120,50,70,-70,121800,122300,-2139,-30461,-47611
747.221657,5,4527,4513,14,-14,121800,122300,15055,-403255,-406685
747.221657,6,0,0,0,0,121800,122300,0,0,0
747.455994,0,731,806,-75,75,121800,122300,38666,298734,317109
747.455994,1,670,711,-41,41,121800,122300,34851,120149,130194
747.455994,2,6562,6544,18,-18,121800,122300,28170,-592970,-597380
747.455994,3,970,966,4,-4,121800,122300,29782,193518,192538
747.455994,4,120,50,70,-70,121800,122300,-2139,-30461,-47611
747.455994,5,4537,4513,24,-24,121800,122300,14933,-401133,-407013
747.455994,6,0,0,0,0,121800,122300,0,0,0
747.77402,0,731,806,-75,75,121800,122300,38666,298734,317109
747.77402,1,670,711,-41,41,121800,122300,34851,120149,130194
747.77402,2,6562,6544,18,-18,121800,122300,28170,-592970,-597380
747.77402,3,970,966,4,-4,121800,122300,29782,193518,192538
747.77402,4,120,50,70,-70,121800,122300,-2139,-30461,-47611
747.77402,5,4537,4513,24,-24,121800,122300,14933,-401133,-407013
747.77402,6,0,0,0,0,121800,122300,0,0,0
748.041448,0,731,806,-75,75,121800,122300,38666,298734,317109
748.041448,1,670,711,-41,41,121800,122300,34851,120149,130194
748.041448,2,6562,6544,18,-18,121800,122300,28170,-592970,-597380
748.041448,3,970,966,4,-4,121800,122300,29782,193518,192538
748.041448,4,120,50,70,-70,121800,122300,-2139,-30461,-47611
748.041448,5,4537,4513,24,-24,121800,122300,14933,-401133,-407013
748.041448,6,0,0,0,0,121800,122300,0,0,0
748.22382,0,731,806,-75,75,121800,122300,38666,298734,317109
748.22382,1,670,711,-41,41,121800,122300,34851,120149,130194
748.22382,2,6562,6544,18,-18,121800,122300,28170,-592970,-597380
748.22382,3,970,966,4,-4,121800,122300,29782,193518,192538
748.22382,4,120,50,70,-70,121800,122300,-2139,-30461,-47611
748.22382,5,4537,4513,24,-24,121800,122300,14933,-401133,-407013
748.22382,6,0,0,0,0,121800,122300,0,0,0
748.481987,0,731,806,-75,75,121800,122300,38666,298734,317109
748.481987,1,670,711,-41,41,121800,122300,34851,120149,130194
748.481987,2,6562,6544,18,-18,121800,122300,28170,-592970,-597380
748.481987,3,970,966,4,-4,121800,122300,29782,193518,192538
748.481987,4,120,50,70,-70,121800,122300,-2139,-30461,-47611
748.481987,5,4537,4513,24,-24,121800,122300,14933,-401133,-407013
748.481987,6,0,0,0,0,121800,122300,0,0,0
748.761588,0,731,806,-75,75,122100,122100,38666,298734,298734
748.761588,1,670,711,-41,41,122100,122100,34851,120149,120149
748.761588,2,6572,6544,28,-28,122100,122100,28048,-591848,-591848
748.761588,3,970,966,4,-4,122100,122100,29782,193518,193518
748.761588,4,120,50,70,-70,122100,122100,-2139,-30461,-30461
748.761588,5,4537,4523,14,-14,122100,122100,15177,-403377,-403377
748.761588,6,0,0,0,0,122100,122100,0,0,0
748.972003,0,731,806,-75,75,121900,122100,38666,298734,313734
748.972003,1,670,711,-41,41,121900,122100,34851,120149,128349
748.972003,2,6572,6550,22,-22,121900,122100,28194,-592594,-596994
748.972003,3,970,970,0,0,121900,122100,29880,193020,193020
748.972003,4,120,50,70,-70,121900,122100,-2139,-30461,-44461
748.972003,5,4547,4523,24,-24,121900,122100,15056,-403256,-408056
748.972003,6,0,0,0,0,121900,122100,0,0,0
749.28042,0,735,806,-71,71,121900,122100,38763,299437,313637
749.28042,1,670,711,-41,41,121900,122100,34851,120149,128349
749.28042,2,6572,6564,8,-8,121900,122100,28389,-595989,-597589
749.28042,3,970,970,0,0,121900,122100,29880,193020,193020
749.28042,4,120,50,70,-70,121900,122100,-2139,-30461,-44461
749.28042,5,4557,4523,34,-34,121900,122100,14934,-402134,-408934
749.28042,6,0,0,0,0,121900,122100,0,0,0
749.458251,0,735,806,-71,71,121900,122200,38763,299437,316761
749.458251,1,670,711,-41,41,121900,122200,34851,120149,130153
749.458251,2,6572,6564,8,-8,121900,122200,28389,-595989,-597941
749.458251,3,970,970,0,0,121900,122200,29880,193020,193020
749.458251,4,120,50,70,-70,121900,122200,-2139,-30461,-47541
749.458251,5,4557,4523,34,-34,121900,122200,14934,-402134,-410430
749.458251,6,0,0,0,0,121900,122200,0,0,0
749.775844,0,735,806,-71,71,121500,122200,38763,299437,316761
749.775844,1,670,711,-41,41,121500,122200,34851,120149,130153
749.775844,2,6582,6564,18,-18,121500,122200,28267,-596867,-601259
749.775844,3,972,970,2,-2,121500,122200,29856,193844,193356
749.775844,4,120,50,70,-70,121500,122200,-2139,-30461,-47541
749.775844,5,4567,4533,34,-34,121500,122200,15056,-399256,-407552
749.775844,6,0,0,0,0,121500,122200,0,0,0
750.031606,0,735,806,-71,71,122200,122200,38763,299437,299437
750.031606,1,670,711,-41,41,122200,122200,34851,120149,120149
750.031606,2,6582,6566,16,-16,122200,122200,28243,-597243,-597243
750.031606,3,974,970,4,-4,122200,122200,29905,193795,193795
750.031606,4,120,50,70,-70,122200,122200,-2139,-30461,-30461
750.031606,5,4567,4533,34,-34,122200,122200,15056,-399256,-399256
750.031606,6,0,0,0,0,122200,122200,0,0,0
750.263016,0,735,806,-71,71,122400,122200,38763,299437,285237
750.263016,1,670,711,-41,41,122400,122200,34851,120149,111949
750.263016,2,6582,6576,6,-6,122400,122200,28121,-598121,-596921
750.263016,3,974,970,4,-4,122400,122200,29905,193795,194595
750.263016,4,120,50,70,-70,122400,122200,-2139,-30461,-16461
750.263016,5,4567,4543,24,-24,122400,122200,14934,-401134,-396334
750.263016,6,0,0,0,0,122400,122200,0,0,0
750.505436,0,735,806,-71,71,122300,122200,38763,299437,292337
750.505436,1,670,711,-41,41,122300,122200,34851,120149,116049
750.505436,2,6584,6586,-2,2,122300,122200,28342,-598342,-598542
750.505436,3,974,972,2,-2,122300,122200,29954,193346,193546
750.505436,4,120,50,70,-70,122300,122200,-2139,-30461,-23461
750.505436,5,4567,4553,14,-14,122300,122200,15179,-401379,-399979
750.505436,6,0,0,0,0,122300,122200,0,0,0
750.769354,0,735,806,-71,71,122300,122200,38763,299437,292337
750.769354,1,670,711,-41,41,122300,122200,34851,120149,116049
750.769354,2,6584,6586,-2,2,122300,122200,28342,-598342,-598542
750.769354,3,974,972,2,-2,122300,122200,29954,193346,193546
750.769354,4,120,50,70,-70,122300,122200,-2139,-30461,-23461
750.769354,5,4567,4553,14,-14,122300,122200,15179,-401379,-399979
750.769354,6,0,0,0,0,122300,122200,0,0,0
751.012821,0,735,806,-71,71,122300,122200,38763,299437,292337
751.012821,1,670,711,-41,41,122300,122200,34851,120149,116049
751.012821,2,6596,6586,10,-10,122300,122200,28196,-600396,-599396
751.012821,3,974,974,0,0,122300,122200,30003,193097,193097
751.012821,4,120,50,70,-70,122300,122200,-2139,-30461,-23461
751.012821,5,4567,4563,4,-4,122300,122200,15424,-401624,-401224
751.012821,6,0,0,0,0,122300,122200,0,0,0
751.213466,0,735,806,-71,71,122300,122200,38763,299437,292337
751.213466,1,670,711,-41,41,122300,122200,34851,120149,116049
751.213466,2,6596,6586,10,-10,122300,122200,28196,-600396,-599396
751.213466,3,974,974,0,0,122300,122200,30003,193097,193097
751.213466,4,120,50,70,-70,122300,122200,-2139,-30461,-23461
751.213466,5,4567,4563,4,-4,122300,122200,15424,-401624,-401224
751.213466,6,0,0,0,0,122300,122200,0,0,0
751.489723,0,735,806,-71,71,122300,122200,38763,299437,292337
751.489723,1,670,711,-41,41,122300,122200,34851,120149,116049
751.489723,2,6596,6586,10,-10,122300,122200,28196,-600396,-599396
751.489723,3,974,974,0,0,122300,122200,30003,193097,193097
751.489723,4,120,50,70,-70,122300,122200,-2139,-30461,-23461
751.489723,5,4567,4563,4,-4,122300,122200,15424,-401624,-401224
751.489723,6,0,0,0,0,122300,122200,0,0,0
751.794936,0,735,806,-71,71,122200,122200,38763,299437,299437
751.794936,1,670,711,-41,41,122200,122200,34851,120149,120149
751.794936,2,6596,6596,0,0,122200,122200,28074,-601274,-601274
751.794936,3,974,974,0,0,122200,122200,30003,193097,193097
751.794936,4,120,50,70,-70,122200,122200,-2139,-30461,-30461
751.794936,5,4577,4563,14,-14,122200,122200,15668,-401868,-401868
751.794936,6,0,0,0,0,122200,122200,0,0,0
752.045762,0,735,806,-71,71,122200,122200,38763,299437,299437
752.045762,1,670,711,-41,41,122200,122200,34851,120149,120149
752.045762,2,6596,6596,0,0,122200,122200,28074,-601274,-601274
752.045762,3,974,974,0,0,122200,122200,30003,193097,193097
752.045762,4,120,50,70,-70,122200,122200,-2139,-30461,-30461
752.045762,5,4577,4563,14,-14,122200,122200,15668,-401868,-401868
752.045762,6,0,0,0,0,122200,122200,0,0,0
752.237062,0,735,806,-71,71,122200,122200,38763,299437,299437
752.237062,1,670,711,-41,41,122200,122200,34851,120149,120149
752.237062,2,6606,6596,10,-10,122200,122200,28318,-600518,-600518
752.237062,3,974,974,0,0,122200,122200,30003,193097,193097
752.237062,4,120,50,70,-70,122200,122200,-2139,-30461,-30461
752.237062,5,4577,4573,4,-4,122200,122200,15546,-404746,-404746
752.237062,6,0,0,0,0,122200,122200,0,0,0
752.488449,0,735,806,-71,71,122200,122200,38763,299437,299437
752.488449,1,670,711,-41,41,122200,122200,34851,120149,120149
752.488449,2,6606,6596,10,-10,122200,122200,28318,-600518,-600518
752.488449,3,974,974,0,0,122200,122200,30003,193097,193097
752.488449,4,120,50,70,-70,122200,122200,-2139,-30461,-30461
752.488449,5,4577,4573,4,-4,122200,122200,15546,-404746,-404746
752.488449,6,0,0,0,0,122200,122200,0,0,0
752.749555,0,735,806,-71,71,122200,122200,38763,299437,299437
752.749555,1,670,711,-41,41,122200,122200,34851,120149,120149
752.749555,2,6606,6596,10,-10,122200,122200,28318,-600518,-600518
752.749555,3,974,974,0,0,122200,122200,30003,193097,193097
752.749555,4,120,50,70,-70,122200,122200,-2139,-30461,-30461
752.749555,5,4577,4573,4,-4,122200,122200,15546,-404746,-404746
752.749555,6,0,0,0,0,122200,122200,0,0,0
752.972404,0,735,806,-71,71,122200,122200,38763,299437,299437
752.972404,1,670,711,-41,41,122200,122200,34851,120149,120149
752.972404,2,6606,6596,10,-10,122200,122200,28318,-600518,-600518
752.972404,3,974,974,0,0,122200,122200,30003,193097,193097
752.972404,4,120,50,70,-70,122200,122200,-2139,-30461,-30461
752.972404,5,4577,4573,4,-4,122200,122200,15546,-404746,-404746
752.972404,6,0,0,0,0,122200,122200,0,0,0
753.25726,0,735,806,-71,71,122200,122200,38763,299437,299437
753.25726,1,670,711,-41,41,122200,122200,34851,120149,120149
753.25726,2,6610,6596,14,-14,122200,122200,28269,-599669,-599669
753.25726,3,974,974,0,0,122200,122200,30003,193097,193097
753.25726,4,120,50,70,-70,122200,122200,-2139,-30461,-30461
753.25726,5,4587,4573,14,-14,122200,122200,15424,-403624,-403624
753.25726,6,0,0,0,0,122200,122200,0,0,0
753.474117,0,735,806,-71,71,122200,122200,38763,299437,299437
753.474117,1,670,711,-41,41,122200,122200,34851,120149,120149
753.474117,2,6610,6596,14,-14,122200,122200,28269,-599669,-599669
753.474117,3,974,974,0,0,122200,122200,30003,193097,193097
753.474117,4,120,50,70,-70,122200,122200,-2139,-30461,-30461
753.474117,5,4587,4573,14,-14,122200,122200,15424,-403624,-403624
753.474117,6,0,0,0,0,122200,122200,0,0,0
753.740993,0,735,806,-71,71,122200,122200,38763,299437,299437
753.740993,1,670,711,-41,41,122200,122200,34851,120149,120149
753.740993,2,6610,6596,14,-14,122200,122200,28269,-599669,-599669
753.740993,3,974,974,0,0,122200,122200,30003,193097,193097
753.740993,4,120,50,70,-70,122200,122200,-2139,-30461,-30461
753.740993,5,4597,4573,24,-24,122200,122200,15302,-401502,-401502
753.740993,6,0,0,0,0,122200,122200,0,0,0
754.04906,0,735,806,-71,71,122200,122200,38763,299437,299437
754.04906,1,670,711,-41,41,122200,122200,34851,120149,120149
754.04906,2,6610,6596,14,-14,122200,122200,28269,-599669,-599669
754.04906,3,974,974,0,0,122200,122200,30003,193097,193097
754.04906,4,120,50,70,-70,122200,122200,-2139,-30461,-30461
754.04906,5,4597,4573,24,-24,122200,122200,15302,-401502,-401502
754.04906,6,0,0,0,0,122200,122200,0,0,0
754.20499,0,735,806,-71,71,122100,122200,38763,299437,306537
754.20499,1,670,711,-41,41,122100,122200,34851,120149,124249
754.20499,2,6620,6596,24,-24,122100,122200,28147,-598547,-600947
754.20499,3,976,974,2,-2,122100,122200,29979,193721,193521
754.20499,4,120,50,70,-70,122100,122200,-2139,-30461,-37461
754.20499,5,4607,4573,34,-34,122100,122200,15180,-398380,-401780
754.20499,6,0,0,0,0,122100,122200,0,0,0
754.479776,0,735,806,-71,71,122100,122200,38763,299437,306537
754.479776,1,670,711,-41,41,122100,122200,34851,120149,124249
754.479776,2,6630,6596,34,-34,122100,122200,28025,-598425,-601825
754.479776,3,978,974,4,-4,122100,122200,29955,193945,193545
754.479776,4,120,50,70,-70,122100,122200,-2139,-30461,-37461
754.479776,5,4617,4573,44,-44,122100,122200,15058,-397258,-401658
754.479776,6,0,0,0,0,122100,122200,0,0,0
754.796301,0,735,806,-71,71,122100,122200,38763,299437,306537
754.796301,1,770,711,59,-59,122100,122200,37291,127709,121809
754.796301,2,6630,6599,31,-31,122100,122200,27988,-599288,-602388
754.796301,3,978,974,4,-4,122100,122200,29955,193945,193545
754.796301,4,120,50,70,-70,122100,122200,-2139,-30461,-37461
754.796301,5,4617,4573,44,-44,122100,122200,15058,-397258,-401658
754.796301,6,0,0,0,0,122100,122200,0,0,0
754.966783,0,742,806,-64,64,122100,122200,38934,300666,307066
754.966783,1,770,711,59,-59,122100,122200,37291,127709,121809
754.966783,2,6630,6606,24,-24,122100,122200,27903,-601303,-603703
754.966783,3,978,974,4,-4,122100,122200,29955,193945,193545
754.966783,4,120,50,70,-70,122100,122200,-2139,-30461,-37461
754.966783,5,4617,4573,44,-44,122100,122200,15058,-397258,-401658
754.966783,6,0,0,0,0,122100,122200,0,0,0
755.255163,0,742,806,-64,64,122100,122200,38934,300666,307066
755.255163,1,770,711,59,-59,122100,122200,37291,127709,121809
755.255163,2,6630,6606,24,-24,122100,122200,27903,-601303,-603703
755.255163,3,978,974,4,-4,122100,122200,29955,193945,193545
755.255163,4,120,50,70,-70,122100,122200,-2139,-30461,-37461
755.255163,5,4617,4573,44,-44,122100,122200,15058,-397258,-401658
755.255163,6,0,0,0,0,122100,122200,0,0,0
755.523546,0,742,806,-64,64,122100,122200,38934,300666,307066
755.523546,1,770,711,59,-59,122100,122200,37291,127709,121809
755.523546,2,6630,6606,24,-24,122100,122200,27903,-601303,-603703
755.523546,3,978,974,4,-4,122100,122200,29955,193945,193545
755.523546,4,120,50,70,-70,122100,122200,-2139,-30461,-37461
755.523546,5,4617,4573,44,-44,122100,122200,15058,-397258,-401658
755.523546,6,0,0,0,0,122100,122200,0,0,0
755.757118,0,742,806,-64,64,122100,122200,38934,300666,307066
755.757118,1,770,711,59,-59,122100,122200,37291,127709,121809
755.757118,2,6630,6606,24,-24,122100,122200,27903,-601303,-603703
755.757118,3,978,974,4,-4,122100,122200,29955,193945,193545
755.757118,4,120,50,70,-70,122100,122200,-2139,-30461,-37461
755.757118,5,4617,4573,44,-44,122100,122200,15058,-397258,-401658
755.757118,6,0,0,0,0,122100,122200,0,0,0
755.992149,0,742,806,-64,64,122100,122200,38934,300666,307066
755.992149,1,770,711,59,-59,122100,122200,37291,127709,121809
755.992149,2,6630,6606,24,-24,122100,122200,27903,-601303,-603703
755.992149,3,978,974,4,-4,122100,122200,29955,193945,193545
755.992149,4,120,50,70,-70,122100,122200,-2139,-30461,-37461
755.992149,5,4617,4573,44,-44,122100,122200,15058,-397258,-401658
755.992149,6,0,0,0,0,122100,122200,0,0,0
756.224256,0,762,806,-44,44,122200,122200,39422,305178,305178
756.224256,1,770,711,59,-59,122200,122200,37291,127709,127709
756.224256,2,6630,6616,14,-14,122200,122200,27781,-604181,-604181
756.224256,3,978,974,4,-4,122200,122200,29955,193945,193945
756.224256,4,120,50,70,-70,122200,122200,-2139,-30461,-30461
756.224256,5,4617,4583,34,-34,122200,122200,14936,-401136,-401136
756.224256,6,0,0,0,0,122200,122200,0,0,0
756.503367,0,762,806,-44,44,122200,122200,39422,305178,305178
756.503367,1,770,711,59,-59,122200,122200,37291,127709,127709
756.503367,2,6630,6616,14,-14,122200,122200,27781,-604181,-604181
756.503367,3,978,974,4,-4,122200,122200,29955,193945,193945
756.503367,4,120,50,70,-70,122200,122200,-2139,-30461,-30461
756.503367,5,4617,4583,34,-34,122200,122200,14936,-401136,-401136
756.503367,6,0,0,0,0,122200,122200,0,0,0
756.7071,0,762,806,-44,44,122300,122200,39422,305178,300778
756.7071,1,770,711,59,-59,122300,122200,37291,127709,133609
756.7071,2,6640,6616,24,-24,122300,122200,27659,-603059,-600659
756.7071,3,978,974,4,-4,122300,122200,29955,193945,194345
756.7071,4,120,50,70,-70,122300,122200,-2139,-30461,-23461
756.7071,5,4617,4593,24,-24,122300,122200,15181,-403381,-400981
756.7071,6,0,0,0,0,122300,122200,0,0,0
756.958278,0,762,806,-44,44,122300,122200,39422,305178,300778
756.958278,1,770,711,59,-59,122300,122200,37291,127709,133609
756.958278,2,6640,6618,22,-22,122300,122200,27635,-603435,-601235
756.958278,3,980,974,6,-6,122300,122200,30004,194096,194696
756.958278,4,120,50,70,-70,122300,122200,-2139,-30461,-23461
756.958278,5,4617,4593,24,-24,122300,122200,15181,-403381,-400981
756.958278,6,0,0,0,0,122300,122200,0,0,0
757.272097,0,762,806,-44,44,121800,122200,39422,305178,315914
757.272097,1,778,711,67,-67,121800,122200,37487,128313,111965
757.272097,2,6650,6626,24,-24,121800,122200,27415,-604815,-610671
757.272097,3,982,974,8,-8,121800,122200,29980,194320,192368
757.272097,4,120,50,70,-70,121800,122200,-2139,-30461,-47541
757.272097,5,4627,4593,34,-34,121800,122200,15059,-402259,-410555
757.272097,6,0,0,0,0,121800,122200,0,0,0
757.538531,0,762,806,-44,44,121800,122200,39422,305178,315914
757.538531,1,778,711,67,-67,121800,122200,37487,128313,111965
757.538531,2,6660,6626,34,-34,121800,122200,27293,-601693,-609989
757.538531,3,984,974,10,-10,121800,122200,29956,195144,192704
757.538531,4,120,50,70,-70,121800,122200,-2139,-30461,-47541
757.538531,5,4627,4593,34,-34,121800,122200,15059,-402259,-410555
757.538531,6,0,0,0,0,121800,122200,0,0,0
757.71161,0,762,806,-44,44,121800,122200,39422,305178,315914
757.71161,1,778,711,67,-67,121800,122200,37487,128313,111965
757.71161,2,6660,6626,34,-34,121800,122200,27293,-601693,-609989
757.71161,3,984,974,10,-10,121800,122200,29956,195144,192704
757.71161,4,120,50,70,-70,121800,122200,-2139,-30461,-47541
757.71161,5,4627,4593,34,-34,121800,122200,15059,-402259,-410555
757.71161,6,0,0,0,0,121800,122200,0,0,0
758.010265,0,762,806,-44,44,122100,122200,39422,305178,309578
758.010265,1,798,711,87,-87,122100,122200,37975,130825,122125
758.010265,2,6660,6636,24,-24,122100,122200,27171,-604571,-606971
758.010265,3,984,974,10,-10,122100,122200,29956,195144,194144
758.010265,4,120,50,70,-70,122100,122200,-2139,-30461,-37461
758.010265,5,4627,4603,24,-24,122100,122200,14937,-404137,-406537
758.010265,6,0,0,0,0,122100,122200,0,0,0
758.260414,0,762,806,-44,44,122100,122200,39422,305178,309578
758.260414,1,798,711,87,-87,122100,122200,37975,130825,122125
758.260414,2,6660,6636,24,-24,122100,122200,27171,-604571,-606971
758.260414,3,984,974,10,-10,122100,122200,29956,195144,194144
758.260414,4,120,50,70,-70,122100,122200,-2139,-30461,-37461
758.260414,5,4627,4603,24,-24,122100,122200,14937,-404137,-406537
758.260414,6,0,0,0,0,122100,122200,0,0,0
758.509072,0,762,806,-44,44,122100,122200,39422,305178,309578
758.509072,1,798,711,87,-87,122100,122200,37975,130825,122125
758.509072,2,6660,6636,24,-24,122100,122200,27171,-604571,-606971
758.509072,3,984,974,10,-10,122100,122200,29956,195144,194144
758.509072,4,120,50,70,-70,122100,122200,-2139,-30461,-37461
758.509072,5,4627,4603,24,-24,122100,122200,14937,-404137,-406537
758.509072,6,0,0,0,0,122100,122200,0,0,0
758.71123,0,762,806,-44,44,122100,122200,39422,305178,309578
758.71123,1,798,711,87,-87,122100,122200,37975,130825,122125
758.71123,2,6660,6636,24,-24,122100,122200,27171,-604571,-606971
758.71123,3,984,974,10,-10,122100,122200,29956,195144,194144
758.71123,4,120,50,70,-70,122100,122200,-2139,-30461,-37461
758.71123,5,4627,4603,24,-24,122100,122200,14937,-404137,-406537
758.71123,6,0,0,0,0,122100,122200,0,0,0
758.979254,0,762,806,-44,44,122100,122200,39422,305178,309578
758.979254,1,798,711,87,-87,122100,122200,37975,130825,122125
758.979254,2,6660,6636,24,-24,122100,122200,27171,-604571,-606971
758.979254,3,984,974,10,-10,122100,122200,29956,195144,194144
758.979254,4,120,50,70,-70,122100,122200,-2139,-30461,-37461
758.979254,5,4627,4603,24,-24,122100,122200,14937,-404137,-406537
758.979254,6,0,0,0,0,122100,122200,0,0,0
759.211894,0,762,806,-44,44,122100,122200,39422,305178,309578
759.211894,1,798,711,87,-87,122100,122200,37975,130825,122125
759.211894,2,6660,6636,24,-24,122100,122200,27171,-604571,-606971
759.211894,3,984,974,10,-10,122100,122200,29956,195144,194144
759.211894,4,120,50,70,-70,122100,122200,-2139,-30461,-37461
759.211894,5,4627,4603,24,-24,122100,122200,14937,-404137,-406537
759.211894,6,0,0,0,0,122100,122200,0,0,0
759.548725,0,762,806,-44,44,121600,122200,39422,305178,315914
759.548725,1,808,711,97,-97,121600,122200,38219,131581,107913
759.548725,2,6670,6646,24,-24,121600,122200,26927,-604327,-610183
759.548725,3,986,974,12,-12,121600,122200,29932,195768,192840
759.548725,4,120,50,70,-70,121600,122200,-2139,-30461,-47541
759.548725,5,4637,4603,34,-34,121600,122200,14815,-402015,-410311
759.548725,6,0,0,0,0,121600,122200,0,0,0
759.796796,0,762,806,-44,44,122800,122200,39422,305178,294442
759.796796,1,808,711,97,-97,122800,122200,38219,131581,155249
759.796796,2,6670,6656,14,-14,122800,122200,26805,-606205,-602789
759.796796,3,986,976,10,-10,122800,122200,29907,196393,198833
759.796796,4,120,50,70,-70,122800,122200,-2139,-30461,-13381
759.796796,5,4637,4603,34,-34,122800,122200,14815,-402015,-393719
759.796796,6,0,0,0,0,122800,122200,0,0,0
760.021698,0,762,806,-44,44,122800,122200,39422,305178,294442
760.021698,1,808,711,97,-97,122800,122200,38219,131581,155249
760.021698,2,6670,6656,14,-14,122800,122200,26805,-606205,-602789
760.021698,3,986,976,10,-10,122800,122200,29907,196393,198833
760.021698,4,120,50,70,-70,122800,122200,-2139,-30461,-13381
760.021698,5,4637,4603,34,-34,122800,122200,14815,-402015,-393719
760.021698,6,0,0,0,0,122800,122200,0,0,0
760.242912,0,762,806,-44,44,122200,122400,39422,305178,313978
760.242912,1,808,711,97,-97,122200,122400,38219,131581,112181
760.242912,2,6670,6666,4,-4,122200,122400,26683,-608083,-608883
760.242912,3,986,976,10,-10,122200,122400,29907,196393,194393
760.242912,4,120,50,70,-70,122200,122400,-2139,-30461,-44461
760.242912,5,4637,4603,34,-34,122200,122400,14815,-402015,-408815
760.242912,6,0,0,0,0,122200,122400,0,0,0
760.49624,0,762,806,-44,44,122300,122400,39422,305178,309578
760.49624,1,808,711,97,-97,122300,122400,38219,131581,121881
760.49624,2,6670,6666,4,-4,122300,122400,26683,-608083,-608483
760.49624,3,986,976,10,-10,122300,122400,29907,196393,195393
760.49624,4,120,50,70,-70,122300,122400,-2139,-30461,-37461
760.49624,5,4637,4613,24,-24,122300,122400,15060,-403260,-405660
760.49624,6,0,0,0,0,122300,122400,0,0,0
760.796177,0,762,806,-44,44,122000,122600,39422,305178,315958
760.796177,1,808,711,97,-97,122000,122600,38219,131581,107816
760.796177,2,6680,6666,14,-14,122000,122600,26928,-608328,-611758
760.796177,3,988,976,12,-12,122000,122600,29883,197417,194477
760.796177,4,120,50,70,-70,122000,122600,-2139,-30461,-47611
760.796177,5,4647,4623,24,-24,122000,122600,14816,-399016,-404896
760.796177,6,0,0,0,0,122000,122600,0,0,0
761.008429,0,762,806,-44,44,122000,122600,39422,305178,315958
761.008429,1,808,711,97,-97,122000,122600,38219,131581,107816
761.008429,2,6680,6666,14,-14,122000,122600,26928,-608328,-611758
761.008429,3,988,976,12,-12,122000,122600,29883,197417,194477
761.008429,4,120,50,70,-70,122000,122600,-2139,-30461,-47611
761.008429,5,4647,4623,24,-24,122000,122600,14816,-399016,-404896
761.008429,6,0,0,0,0,122000,122600,0,0,0
761.249406,0,762,806,-44,44,122600,122600,39422,305178,305178
761.249406,1,808,711,97,-97,122600,122600,38219,131581,131581
761.249406,2,6680,6669,11,-11,122600,122600,26891,-608591,-608591
761.249406,3,988,976,12,-12,122600,122600,29883,197417,197417
761.249406,4,120,50,70,-70,122600,122600,-2139,-30461,-30461
761.249406,5,4647,4623,24,-24,122600,122600,14816,-399016,-399016
761.249406,6,0,0,0,0,122600,122600,0,0,0
761.473532,0,762,806,-44,44,122600,122600,39422,305178,305178
761.473532,1,808,711,97,-97,122600,122600,38219,131581,131581
761.473532,2,6680,6669,11,-11,122600,122600,26891,-608591,-608591
761.473532,3,988,976,12,-12,122600,122600,29883,197417,197417
761.473532,4,120,50,70,-70,122600,122600,-2139,-30461,-30461
761.473532,5,4647,4623,24,-24,122600,122600,14816,-399016,-399016
761.473532,6,0,0,0,0,122600,122600,0,0,0
761.710854,0,762,806,-44,44,122600,122600,39422,305178,305178
761.710854,1,808,711,97,-97,122600,122600,38219,131581,131581
761.710854,2,6680,6669,11,-11,122600,122600,26891,-608591,-608591
761.710854,3,988,976,12,-12,122600,122600,29883,197417,197417
761.710854,4,120,50,70,-70,122600,122600,-2139,-30461,-30461
761.710854,5,4647,4623,24,-24,122600,122600,14816,-399016,-399016
761.710854,6,0,0,0,0,122600,122600,0,0,0
761.965904,0,762,806,-44,44,122600,122600,39422,305178,305178
761.965904,1,808,711,97,-97,122600,122600,38219,131581,131581
761.965904,2,6680,6669,11,-11,122600,122600,26891,-608591,-608591
761.965904,3,988,976,12,-12,122600,122600,29883,197417,197417
761.965904,4,120,50,70,-70,122600,122600,-2139,-30461,-30461
761.965904,5,4647,4623,24,-24,122600,122600,14816,-399016,-399016
761.965904,6,0,0,0,0,122600,122600,0,0,0
762.237828,0,762,806,-44,44,122600,122600,39422,305178,305178
762.237828,1,808,711,97,-97,122600,122600,38219,131581,131581
762.237828,2,6680,6669,11,-11,122600,122600,26891,-608591,-608591
762.237828,3,988,976,12,-12,122600,122600,29883,197417,197417
762.237828,4,120,50,70,-70,122600,122600,-2139,-30461,-30461
762.237828,5,4647,4623,24,-24,122600,122600,14816,-399016,-399016
762.237828,6,0,0,0,0,122600,122600,0,0,0
762.5087,0,762,806,-44,44,122300,122600,39422,305178,315958
762.5087,1,808,711,97,-97,122300,122600,38219,131581,107816
762.5087,2,6690,6669,21,-21,122300,122600,26769,-610469,-615614
762.5087,3,990,976,14,-14,122300,122600,29859,197441,194011
762.5087,4,120,50,70,-70,122300,122600,-2139,-30461,-47611
762.5087,5,4657,4623,34,-34,122300,122600,14694,-398894,-407224
762.5087,6,0,0,0,0,122300,122600,0,0,0
762.735699,0,762,806,-44,44,122300,122600,39422,305178,315958
762.735699,1,808,711,97,-97,122300,122600,38219,131581,107816
762.735699,2,6690,6669,21,-21,122300,122600,26769,-610469,-615614
762.735699,3,990,976,14,-14,122300,122600,29859,197441,194011
762.735699,4,120,50,70,-70,122300,122600,-2139,-30461,-47611
762.735699,5,4657,4623,34,-34,122300,122600,14694,-398894,-407224
762.735699,6,0,0,0,0,122300,122600,0,0,0
762.951006,0,762,806,-44,44,122300,122600,39422,305178,315958
762.951006,1,808,711,97,-97,122300,122600,38219,131581,107816
762.951006,2,6690,6669,21,-21,122300,122600,26769,-610469,-615614
762.951006,3,990,976,14,-14,122300,122600,29859,197441,194011
762.951006,4,120,50,70,-70,122300,122600,-2139,-30461,-47611
762.951006,5,4657,4623,34,-34,122300,122600,14694,-398894,-407224
762.951006,6,0,0,0,0,122300,122600,0,0,0
763.29145,0,772,806,-34,34,122300,122600,39667,304933,313263
763.29145,1,808,711,97,-97,122300,122600,38219,131581,107816
763.29145,2,6690,6679,11,-11,122300,122600,26647,-612347,-615042
763.29145,3,990,976,14,-14,122300,122600,29859,197441,194011
763.29145,4,120,50,70,-70,122300,122600,-2139,-30461,-47611
763.29145,5,4657,4623,34,-34,122300,122600,14694,-398894,-407224
763.29145,6,0,0,0,0,122300,122600,0,0,0
763.545624,0,772,806,-34,34,121800,122600,39667,304933,313263
763.545624,1,808,711,97,-97,121800,122600,38219,131581,107816
763.545624,2,6710,6679,31,-31,121800,122600,26403,-611103,-618698
763.545624,3,992,976,16,-16,121800,122600,29835,198065,194145
763.545624,4,120,50,70,-70,121800,122600,-2139,-30461,-47611
763.545624,5,4667,4633,34,-34,121800,122600,14817,-397017,-405347
763.545624,6,0,0,0,0,121800,122600,0,0,0
763.716863,0,772,806,-34,34,122100,122600,39667,304933,313263
763.716863,1,808,711,97,-97,122100,122600,38219,131581,107816
763.716863,2,6710,6689,21,-21,122100,122600,26647,-614347,-619492
763.716863,3,992,976,16,-16,122100,122600,29835,198065,194145
763.716863,4,120,50,70,-70,122100,122600,-2139,-30461,-47611
763.716863,5,4677,4633,44,-44,122100,122600,14695,-394895,-405675
763.716863,6,0,0,0,0,122100,122600,0,0,0
764.012434,0,772,806,-34,34,122100,122600,39667,304933,313263
764.012434,1,808,711,97,-97,122100,122600,38219,131581,107816
764.012434,2,6710,6689,21,-21,122100,122600,26647,-614347,-619492
764.012434,3,992,976,16,-16,122100,122600,29835,198065,194145
764.012434,4,120,50,70,-70,122100,122600,-2139,-30461,-47611
764.012434,5,4677,4633,44,-44,122100,122600,14695,-394895,-405675
764.012434,6,0,0,0,0,122100,122600,0,0,0
764.289477,0,802,806,-4,4,122300,122600,40401,310199,311179
764.289477,1,808,711,97,-97,122300,122600,38219,131581,107816
764.289477,2,6720,6699,21,-21,122300,122600,26770,-615470,-620615
764.289477,3,992,976,16,-16,122300,122600,29835,198065,194145
764.289477,4,120,50,70,-70,122300,122600,-2139,-30461,-47611
764.289477,5,4677,4633,44,-44,122300,122600,14695,-394895,-405675
764.289477,6,0,0,0,0,122300,122600,0,0,0
764.458753,0,815,806,9,-9,122300,122600,40719,312481,310276
764.458753,1,808,711,97,-97,122300,122600,38219,131581,107816
764.458753,2,6720,6699,21,-21,122300,122600,26770,-615470,-620615
764.458753,3,992,976,16,-16,122300,122600,29835,198065,194145
764.458753,4,120,50,70,-70,122300,122600,-2139,-30461,-47611
764.458753,5,4677,4643,34,-34,122300,122600,14573,-397773,-406103
764.458753,6,0,0,0,0,122300,122600,0,0,0
764.745023,0,815,806,9,-9,122300,122600,40719,312481,310276
764.745023,1,808,711,97,-97,122300,122600,38219,131581,107816
764.745023,2,6720,6699,21,-21,122300,122600,26770,-615470,-620615
764.745023,3,992,976,16,-16,122300,122600,29835,198065,194145
764.745023,4,120,50,70,-70,122300,122600,-2139,-30461,-47611
764.745023,5,4677,4643,34,-34,122300,122600,14573,-397773,-406103
764.745023,6,0,0,0,0,122300,122600,0,0,0
765.027867,0,815,806,9,-9,122400,122600,40719,312481,310681
765.027867,1,808,711,97,-97,122400,122600,38219,131581,112181
765.027867,2,6720,6701,19,-19,122400,122600,26746,-615846,-619646
765.027867,3,994,976,18,-18,122400,122600,29884,198216,194616
765.027867,4,120,50,70,-70,122400,122600,-2139,-30461,-44461
765.027867,5,4677,4643,34,-34,122400,122600,14573,-397773,-404573
765.027867,6,0,0,0,0,122400,122600,0,0,0
765.273016,0,815,806,9,-9,122400,122600,40719,312481,310681
765.273016,1,808,711,97,-97,122400,122600,38219,131581,112181
765.273016,2,6730,6701,29,-29,122400,122600,26991,-615091,-620891
765.273016,3,994,976,18,-18,122400,122600,29884,198216,194616
765.273016,4,120,50,70,-70,122400,122600,-2139,-30461,-44461
765.273016,5,4677,4653,24,-24,122400,122600,14451,-399651,-404451
765.273016,6,0,0,0,0,122400,122600,0,0,0
765.516913,0,815,806,9,-9,122400,122600,40719,312481,310681
765.516913,1,808,711,97,-97,122400,122600,38219,131581,112181
765.516913,2,6730,6701,29,-29,122400,122600,26991,-615091,-620891
765.516913,3,994,976,18,-18,122400,122600,29884,198216,194616
765.516913,4,120,50,70,-70,122400,122600,-2139,-30461,-44461
765.516913,5,4677,4653,24,-24,122400,122600,14451,-399651,-404451
765.516913,6,0,0,0,0,122400,122600,0,0,0
765.753375,0,815,806,9,-9,122900,122500,40719,312481,314686
765.753375,1,808,711,97,-97,122900,122500,38219,131581,155346
765.753375,2,6740,6711,29,-29,122900,122500,27114,-615214,-608109
765.753375,3,994,976,18,-18,122900,122500,29884,198216,202626
765.753375,4,120,50,70,-70,122900,122500,-2139,-30461,-13311
765.753375,5,4687,4663,24,-24,122900,122500,14574,-401774,-395894
765.753375,6,0,0,0,0,122900,122500,0,0,0
765.995059,0,815,806,9,-9,122900,122500,40719,312481,314686
765.995059,1,808,711,97,-97,122900,122500,38219,131581,155346
765.995059,2,6740,6711,29,-29,122900,122500,27114,-615214,-608109
765.995059,3,994,976,18,-18,122900,122500,29884,198216,202626
765.995059,4,120,50,70,-70,122900,122500,-2139,-30461,-13311
765.995059,5,4687,4663,24,-24,122900,122500,14574,-401774,-395894
765.995059,6,0,0,0,0,122900,122500,0,0,0
766.288455,0,815,806,9,-9,122900,122500,40719,312481,314686
766.288455,1,808,711,97,-97,122900,122500,38219,131581,155346
766.288455,2,6740,6711,29,-29,122900,122500,27114,-615214,-608109
766.288455,3,994,976,18,-18,122900,122500,29884,198216,202626
766.288455,4,120,50,70,-70,122900,122500,-2139,-30461,-13311
766.288455,5,4687,4663,24,-24,122900,122500,14574,-401774,-395894
766.288455,6,0,0,0,0,122900,122500,0,0,0
766.499072,0,815,806,9,-9,122900,122500,40719,312481,314686
766.499072,1,808,711,97,-97,122900,122500,38219,131581,155346
766.499072,2,6740,6711,29,-29,122900,122500,27114,-615214,-608109
766.499072,3,994,976,18,-18,122900,122500,29884,198216,202626
766.499072,4,120,50,70,-70,122900,122500,-2139,-30461,-13311
766.499072,5,4687,4663,24,-24,122900,122500,14574,-401774,-395894
766.499072,6,0,0,0,0,122900,122500,0,0,0
766.731338,0,815,806,9,-9,122900,122300,40719,312481,314686
766.731338,1,808,711,97,-97,122900,122300,38219,131581,155346
766.731338,2,6740,6711,29,-29,122900,122300,27114,-615214,-608109
766.731338,3,994,976,18,-18,122900,122300,29884,198216,202626
766.731338,4,120,50,70,-70,122900,122300,-2139,-30461,-13311
766.731338,5,4687,4663,24,-24,122900,122300,14574,-401774,-395894
766.731338,6,0,0,0,0,122900,122300,0,0,0
767.025813,0,815,806,9,-9,122100,122300,40719,312481,310681
767.025813,1,808,711,97,-97,122100,122300,38219,131581,112181
767.025813,2,6740,6721,19,-19,122100,122300,27358,-617458,-621258
767.025813,3,994,976,18,-18,122100,122300,29884,198216,194616
767.025813,4,120,50,70,-70,122100,122300,-2139,-30461,-44461
767.025813,5,4697,4663,34,-34,122100,122300,14452,-400652,-407452
767.025813,6,0,0,0,0,122100,122300,0,0,0
767.208816,0,815,806,9,-9,122100,122300,40719,312481,310681
767.208816,1,808,711,97,-97,122100,122300,38219,131581,112181
767.208816,2,6740,6721,19,-19,122100,122300,27358,-617458,-621258
767.208816,3,994,976,18,-18,122100,122300,29884,198216,194616
767.208816,4,120,50,70,-70,122100,122300,-2139,-30461,-44461
767.208816,5,4697,4663,34,-34,122100,122300,14452,-400652,-407452
767.208816,6,0,0,0,0,122100,122300,0,0,0
767.492856,0,815,806,9,-9,122100,122300,40719,312481,310681
767.492856,1,808,711,97,-97,122100,122300,38219,131581,112181
767.492856,2,6741,6721,20,-20,122100,122300,27346,-617346,-621346
767.492856,3,994,976,18,-18,122100,122300,29884,198216,194616
767.492856,4,120,50,70,-70,122100,122300,-2139,-30461,-44461
767.492856,5,4697,4663,34,-34,122100,122300,14452,-400652,-407452
767.492856,6,0,0,0,0,122100,122300,0,0,0
767.741703,0,815,806,9,-9,122100,122300,40719,312481,310681
767.741703,1,808,711,97,-97,122100,122300,38219,131581,112181
767.741703,2,6741,6721,20,-20,122100,122300,27346,-617346,-621346
767.741703,3,994,976,18,-18,122100,122300,29884,198216,194616
767.741703,4,120,50,70,-70,122100,122300,-2139,-30461,-44461
767.741703,5,4697,4663,34,-34,122100,122300,14452,-400652,-407452
767.741703,6,0,0,0,0,122100,122300,0,0,0
768.024279,0,815,806,9,-9,122100,122300,40719,312481,310681
768.024279,1,808,711,97,-97,122100,122300,38219,131581,112181
768.024279,2,6741,6721,20,-20,122100,122300,27346,-617346,-621346
768.024279,3,994,976,18,-18,122100,122300,29884,198216,194616
768.024279,4,120,50,70,-70,122100,122300,-2139,-30461,-44461
768.024279,5,4697,4663,34,-34,122100,122300,14452,-400652,-407452
768.024279,6,0,0,0,0,122100,122300,0,0,0
768.292691,0,815,806,9,-9,122100,122300,40719,312481,310681
768.292691,1,808,711,97,-97,122100,122300,38219,131581,112181
768.292691,2,6741,6721,20,-20,122100,122300,27346,-617346,-621346
768.292691,3,994,976,18,-18,122100,122300,29884,198216,194616
768.292691,4,120,50,70,-70,122100,122300,-2139,-30461,-44461
768.292691,5,4697,4663,34,-34,122100,122300,14452,-400652,-407452
768.292691,6,0,0,0,0,122100,122300,0,0,0
768.491435,0,815,806,9,-9,122100,122300,40719,312481,310681
768.491435,1,808,711,97,-97,122100,122300,38219,131581,112181
768.491435,2,6741,6721,20,-20,122100,122300,27346,-617346,-621346
768.491435,3,994,976,18,-18,122100,122300,29884,198216,194616
768.491435,4,120,50,70,-70,122100,122300,-2139,-30461,-44461
768.491435,5,4697,4663,34,-34,122100,122300,14452,-400652,-407452
768.491435,6,0,0,0,0,122100,122300,0,0,0
768.730931,0,815,806,9,-9,122000,122300,40719,312481,310276
768.730931,1,808,711,97,-97,122000,122300,38219,131581,107816
768.730931,2,6741,6721,20,-20,122000,122300,27346,-617346,-622246
768.730931,3,996,976,20,-20,122000,122300,29933,198367,193467
768.730931,4,120,50,70,-70,122000,122300,-2139,-30461,-47611
768.730931,5,4697,4663,34,-34,122000,122300,14452,-400652,-408982
768.730931,6,0,0,0,0,122000,122300,0,0,0
768.972132,0,815,806,9,-9,122000,122300,40719,312481,310276
768.972132,1,808,711,97,-97,122000,122300,38219,131581,107816
768.972132,2,6741,6721,20,-20,122000,122300,27346,-617346,-622246
768.972132,3,996,976,20,-20,122000,122300,29933,198367,193467
768.972132,4,120,50,70,-70,122000,122300,-2139,-30461,-47611
768.972132,5,4697,4663,34,-34,122000,122300,14452,-400652,-408982
768.972132,6,0,0,0,0,122000,122300,0,0,0
769.258367,0,845,806,39,-39,122800,122300,41451,317749,327304
769.258367,1,808,711,97,-97,122800,122300,38219,131581,155346
769.258367,2,6749,6731,18,-18,122800,122300,27419,-615819,-611409
769.258367,3,996,978,18,-18,122800,122300,29908,199392,203802
769.258367,4,120,50,70,-70,122800,122300,-2139,-30461,-13311
769.258367,5,4697,4673,24,-24,122800,122300,14330,-400530,-394650
769.258367,6,0,0,0,0,122800,122300,0,0,0
769.473588,0,845,806,39,-39,122800,122300,41451,317749,327304
769.473588,1,808,711,97,-97,122800,122300,38219,131581,155346
769.473588,2,6749,6731,18,-18,122800,122300,27419,-615819,-611409
769.473588,3,996,978,18,-18,122800,122300,29908,199392,203802
769.473588,4,120,50,70,-70,122800,122300,-2139,-30461,-13311
769.473588,5,4697,4673,24,-24,122800,122300,14330,-400530,-394650
769.473588,6,0,0,0,0,122800,122300,0,0,0
769.735663,0,845,806,39,-39,122100,122300,41451,317749,309949
769.735663,1,808,711,97,-97,122100,122300,38219,131581,112181
769.735663,2,6749,6741,8,-8,122100,122300,27297,-616697,-618297
769.735663,3,996,978,18,-18,122100,122300,29908,199392,195792
769.735663,4,120,50,70,-70,122100,122300,-2139,-30461,-44461
769.735663,5,4697,4673,24,-24,122100,122300,14330,-400530,-405330
769.735663,6,0,0,0,0,122100,122300,0,0,0
769.986039,0,845,806,39,-39,122300,122300,41451,317749,317749
769.986039,1,808,711,97,-97,122300,122300,38219,131581,131581
769.986039,2,6749,6751,-2,2,122300,122300,27542,-616942,-616942
769.986039,3,996,980,16,-16,122300,122300,29957,199343,199343
769.986039,4,120,50,70,-70,122300,122300,-2139,-30461,-30461
769.986039,5,4697,4683,14,-14,122300,122300,14575,-400775,-400775
769.986039,6,0,0,0,0,122300,122300,0,0,0
770.273577,0,845,806,39,-39,122300,122300,41451,317749,317749
770.273577,1,808,711,97,-97,122300,122300,38219,131581,131581
770.273577,2,6749,6751,-2,2,122300,122300,27542,-616942,-616942
770.273577,3,996,980,16,-16,122300,122300,29957,199343,199343
770.273577,4,120,50,70,-70,122300,122300,-2139,-30461,-30461
770.273577,5,4697,4683,14,-14,122300,122300,14575,-400775,-400775
770.273577,6,0,0,0,0,122300,122300,0,0,0
770.540208,0,845,806,39,-39,122300,122300,41451,317749,317749
770.540208,1,808,711,97,-97,122300,122300,38219,131581,131581
770.540208,2,6749,6757,-8,8,122300,122300,27689,-616489,-616489
770.540208,3,996,980,16,-16,122300,122300,29957,199343,199343
770.540208,4,120,50,70,-70,122300,122300,-2139,-30461,-30461
770.540208,5,4697,4683,14,-14,122300,122300,14575,-400775,-400775
770.540208,6,0,0,0,0,122300,122300,0,0,0
770.728351,0,845,806,39,-39,122300,122300,41451,317749,317749
770.728351,1,808,711,97,-97,122300,122300,38219,131581,131581
770.728351,2,6749,6757,-8,8,122300,122300,27689,-616489,-616489
770.728351,3,996,980,16,-16,122300,122300,29957,199343,199343
770.728351,4,120,50,70,-70,122300,122300,-2139,-30461,-30461
770.728351,5,4697,4683,14,-14,122300,122300,14575,-400775,-400775
770.728351,6,0,0,0,0,122300,122300,0,0,0
770.986735,0,845,806,39,-39,122300,122300,41451,317749,317749
770.986735,1,808,711,97,-97,122300,122300,38219,131581,131581
770.986735,2,6749,6757,-8,8,122300,122300,27689,-616489,-616489
770.986735,3,996,980,16,-16,122300,122300,29957,199343,199343
770.986735,4,120,50,70,-70,122300,122300,-2139,-30461,-30461
770.986735,5,4697,4683,14,-14,122300,122300,14575,-400775,-400775
770.986735,6,0,0,0,0,122300,122300,0,0,0
771.268584,0,845,806,39,-39,121900,122300,41451,317749,308194
771.268584,1,808,711,97,-97,121900,122300,38219,131581,107816
771.268584,2,6759,6767,-8,8,121900,122300,27812,-616612,-614652
771.268584,3,998,982,16,-16,121900,122300,29908,200392,196472
771.268584,4,120,50,70,-70,121900,122300,-2139,-30461,-47611
771.268584,5,4707,4693,14,-14,121900,122300,14331,-400531,-403961
771.268584,6,0,0,0,0,121900,122300,0,0,0
771.512317,0,875,806,69,-69,121900,122300,42182,323018,306113
771.512317,1,808,711,97,-97,121900,122300,38219,131581,107816
771.512317,2,6769,6767,2,-2,121900,122300,28056,-614856,-615346
771.512317,3,998,982,16,-16,121900,122300,29908,200392,196472
771.512317,4,120,50,70,-70,121900,122300,-2139,-30461,-47611
771.512317,5,4717,4693,24,-24,121900,122300,14575,-398775,-404655
771.512317,6,0,0,0,0,121900,122300,0,0,0
771.720836,0,899,806,93,-93,121900,122300,42767,327233,304448
771.720836,1,808,711,97,-97,121900,122300,38219,131581,107816
771.720836,2,6769,6767,2,-2,121900,122300,28056,-614856,-615346
771.720836,3,998,982,16,-16,121900,122300,29908,200392,196472
771.720836,4,120,50,70,-70,121900,122300,-2139,-30461,-47611
771.720836,5,4717,4693,24,-24,121900,122300,14575,-398775,-404655
771.720836,6,0,0,0,0,121900,122300,0,0,0
772.0054,0,899,806,93,-93,121900,122300,42767,327233,304448
772.0054,1,808,711,97,-97,121900,122300,38219,131581,107816
772.0054,2,6769,6767,2,-2,121900,122300,28056,-614856,-615346
772.0054,3,998,982,16,-16,121900,122300,29908,200392,196472
772.0054,4,120,50,70,-70,121900,122300,-2139,-30461,-47611
772.0054,5,4717,4693,24,-24,121900,122300,14575,-398775,-404655
772.0054,6,0,0,0,0,121900,122300,0,0,0
772.276464,0,899,806,93,-93,122300,122300,42767,327233,327233
772.276464,1,808,711,97,-97,122300,122300,38219,131581,131581
772.276464,2,6779,6767,12,-12,122300,122300,28301,-615101,-615101
772.276464,3,998,982,16,-16,122300,122300,29908,200392,200392
772.276464,4,120,50,70,-70,122300,122300,-2139,-30461,-30461
772.276464,5,4717,4703,14,-14,122300,122300,14453,-399653,-399653
772.276464,6,0,0,0,0,122300,122300,0,0,0
772.474701,0,899,806,93,-93,122300,122300,42767,327233,327233
772.474701,1,808,711,97,-97,122300,122300,38219,131581,131581
772.474701,2,6779,6767,12,-12,122300,122300,28301,-615101,-615101
772.474701,3,998,982,16,-16,122300,122300,29908,200392,200392
772.474701,4,120,50,70,-70,122300,122300,-2139,-30461,-30461
772.474701,5,4717,4703,14,-14,122300,122300,14453,-399653,-399653
772.474701,6,0,0,0,0,122300,122300,0,0,0
772.72085,0,899,806,93,-93,122200,122300,42767,327233,317933
772.72085,1,808,711,97,-97,122200,122300,38219,131581,121881
772.72085,2,6789,6767,22,-22,122200,122300,28179,-614979,-617179
772.72085,3,998,982,16,-16,122200,122300,29908,200392,198792
772.72085,4,120,50,70,-70,122200,122300,-2139,-30461,-37461
772.72085,5,4717,4713,4,-4,122200,122300,14697,-400897,-401297
772.72085,6,0,0,0,0,122200,122300,0,0,0
773.047696,0,899,806,93,-93,122100,122300,42767,327233,308633
773.047696,1,808,711,97,-97,122100,122300,38219,131581,112181
773.047696,2,6789,6777,12,-12,122100,122300,28423,-617223,-619623
773.047696,3,998,982,16,-16,122100,122300,29908,200392,197192
773.047696,4,120,50,70,-70,122100,122300,-2139,-30461,-44461
773.047696,5,4727,4713,14,-14,122100,122300,14575,-400775,-403575
773.047696,6,0,0,0,0,122100,122300,0,0,0
773.23352,0,899,806,93,-93,122100,122300,42767,327233,308633
773.23352,1,808,711,97,-97,122100,122300,38219,131581,112181
773.23352,2,6789,6777,12,-12,122100,122300,28423,-617223,-619623
773.23352,3,998,982,16,-16,122100,122300,29908,200392,197192
773.23352,4,120,50,70,-70,122100,122300,-2139,-30461,-44461
773.23352,5,4737,4713,24,-24,122100,122300,14819,-400019,-404819
773.23352,6,0,0,0,0,122100,122300,0,0,0
773.501489,0,899,806,93,-93,122100,122100,42767,327233,327233
773.501489,1,808,711,97,-97,122100,122100,38219,131581,131581
773.501489,2,6789,6777,12,-12,122100,122100,28423,-617223,-617223
773.501489,3,998,982,16,-16,122100,122100,29908,200392,200392
773.501489,4,120,50,70,-70,122100,122100,-2139,-30461,-30461
773.501489,5,4737,4713,24,-24,122100,122100,14819,-400019,-400019
773.501489,6,0,0,0,0,122100,122100,0,0,0
773.729315,0,899,806,93,-93,122100,122300,42767,327233,308633
773.729315,1,808,711,97,-97,122100,122300,38219,131581,112181
773.729315,2,6789,6777,12,-12,122100,122300,28423,-617223,-619623
773.729315,3,998,982,16,-16,122100,122300,29908,200392,197192
773.729315,4,120,50,70,-70,122100,122300,-2139,-30461,-44461
773.729315,5,4737,4713,24,-24,122100,122300,14819,-400019,-404819
773.729315,6,0,0,0,0,122100,122300,0,0,0
773.976664,0,906,806,100,-100,122100,122300,42938,328462,308462
773.976664,1,808,711,97,-97,122100,122300,38219,131581,112181
773.976664,2,6799,6777,22,-22,122100,122300,28667,-615467,-619867
773.976664,3,998,982,16,-16,122100,122300,29908,200392,197192
773.976664,4,120,50,70,-70,122100,122300,-2139,-30461,-44461
773.976664,5,4737,4713,24,-24,122100,122300,14819,-400019,-404819
773.976664,6,0,0,0,0,122100,122300,0,0,0
774.235026,0,906,806,100,-100,122100,122300,42938,328462,308462
774.235026,1,808,711,97,-97,122100,122300,38219,131581,112181
774.235026,2,6809,6777,32,-32,122100,122300,28911,-613711,-620111
774.235026,3,998,982,16,-16,122100,122300,29908,200392,197192
774.235026,4,120,50,70,-70,122100,122300,-2139,-30461,-44461
774.235026,5,4737,4713,24,-24,122100,122300,14819,-400019,-404819
774.235026,6,0,0,0,0,122100,122300,0,0,0
774.495946,0,906,806,100,-100,122100,122900,42938,328462,303862
774.495946,1,808,711,97,-97,122100,122900,38219,131581,107719
774.495946,2,6819,6777,42,-42,122100,122900,29155,-606955,-617287
774.495946,3,1002,982,20,-20,122100,122900,30006,203094,198174
774.495946,4,120,50,70,-70,122100,122900,-2139,-30461,-47681
774.495946,5,4747,4713,34,-34,122100,122900,15063,-393263,-401627
774.495946,6,0,0,0,0,122100,122900,0,0,0
774.77645,0,906,806,100,-100,122600,123400,42938,328462,303762
774.77645,1,808,711,97,-97,122600,123400,38219,131581,107622
774.77645,2,6819,6789,30,-30,122600,123400,29008,-614608,-622018
774.77645,3,1004,982,22,-22,122600,123400,30055,203645,198211
774.77645,4,120,50,70,-70,122600,123400,-2139,-30461,-47751
774.77645,5,4747,4723,24,-24,122600,123400,14941,-399141,-405069
774.77645,6,0,0,0,0,122600,123400,0,0,0
774.984421,0,906,806,100,-100,122900,123400,42938,328462,303762
774.984421,1,808,711,97,-97,122900,123400,38219,131581,107622
774.984421,2,6829,6797,32,-32,122900,123400,29156,-616656,-624560
774.984421,3,1006,982,24,-24,122900,123400,30104,204396,198468
774.984421,4,120,50,70,-70,122900,123400,-2139,-30461,-47751
774.984421,5,4757,4723,34,-34,122900,123400,15186,-393786,-402184
774.984421,6,0,0,0,0,122900,123400,0,0,0
775.220429,0,906,806,100,-100,122900,123400,42938,328462,303762
775.220429,1,808,711,97,-97,122900,123400,38219,131581,107622
775.220429,2,6839,6797,42,-42,122900,123400,29402,-613902,-624276
775.220429,3,1008,982,26,-26,122900,123400,30153,204947,198525
775.220429,4,120,50,70,-70,122900,123400,-2139,-30461,-47751
775.220429,5,4767,4723,44,-44,122900,123400,15432,-391032,-401900
775.220429,6,0,0,0,0,122900,123400,0,0,0
775.457902,0,906,806,100,-100,122900,123400,42938,328462,303762
775.457902,1,808,711,97,-97,122900,123400,38219,131581,107622
775.457902,2,6849,6797,52,-52,122900,123400,29648,-610148,-622992
775.457902,3,1010,982,28,-28,122900,123400,30202,205698,198782
775.457902,4,120,50,70,-70,122900,123400,-2139,-30461,-47751
775.457902,5,4767,4723,44,-44,122900,123400,15432,-391032,-401900
775.457902,6,0,0,0,0,122900,123400,0,0,0
775.710355,0,906,806,100,-100,122900,123400,42938,328462,303762
775.710355,1,808,711,97,-97,122900,123400,38219,131581,107622
775.710355,2,6849,6797,52,-52,122900,123400,29648,-610148,-622992
775.710355,3,1014,982,32,-32,122900,123400,30300,206800,198896
775.710355,4,120,50,70,-70,122900,123400,-2139,-30461,-47751
775.710355,5,4767,4723,44,-44,122900,123400,15432,-391032,-401900
775.710355,6,0,0,0,0,122900,123400,0,0,0
775.996281,0,906,806,100,-100,122800,123400,42938,328462,303762
775.996281,1,808,711,97,-97,122800,123400,38219,131581,107622
775.996281,2,6849,6807,42,-42,122800,123400,29894,-615394,-625768
775.996281,3,1014,982,32,-32,122800,123400,30300,206800,198896
775.996281,4,120,50,70,-70,122800,123400,-2139,-30461,-47751
775.996281,5,4777,4723,54,-54,122800,123400,15309,-387909,-401247
775.996281,6,0,0,0,0,122800,123400,0,0,0
776.268019,0,906,806,100,-100,122800,123400,42938,328462,303762
776.268019,1,808,711,97,-97,122800,123400,38219,131581,107622
776.268019,2,6849,6811,38,-38,122800,123400,29918,-617018,-626404
776.268019,3,1018,982,36,-36,122800,123400,30324,207976,199084
776.268019,4,120,50,70,-70,122800,123400,-2139,-30461,-47751
776.268019,5,4777,4723,54,-54,122800,123400,15309,-387909,-401247
776.268019,6,0,0,0,0,122800,123400,0,0,0
776.54063,0,906,806,100,-100,122600,123400,42938,328462,303762
776.54063,1,808,711,97,-97,122600,123400,38219,131581,107622
776.54063,2,6859,6811,48,-48,122600,123400,30164,-615264,-627120
776.54063,3,1020,982,38,-38,122600,123400,30373,208527,199141
776.54063,4,120,50,70,-70,122600,123400,-2139,-30461,-47751
776.54063,5,4787,4725,62,-62,122600,123400,15161,-384761,-400075
776.54063,6,0,0,0,0,122600,123400,0,0,0
776.758912,0,906,806,100,-100,122600,123400,42938,328462,303762
776.758912,1,808,711,97,-97,122600,123400,38219,131581,107622
776.758912,2,6859,6811,48,-48,122600,123400,30164,-615264,-627120
776.758912,3,1020,982,38,-38,122600,123400,30373,208527,199141
776.758912,4,120,50,70,-70,122600,123400,-2139,-30461,-47751
776.758912,5,4787,4725,62,-62,122600,123400,15161,-384761,-400075
776.758912,6,0,0,0,0,122600,123400,0,0,0
776.950991,0,906,806,100,-100,122900,123400,42938,328462,303762
776.950991,1,808,711,97,-97,122900,123400,38219,131581,107622
776.950991,2,6859,6811,48,-48,122900,123400,30164,-615264,-627120
776.950991,3,1022,982,40,-40,122900,123400,30422,209078,199198
776.950991,4,120,50,70,-70,122900,123400,-2139,-30461,-47751
776.950991,5,4787,4725,62,-62,122900,123400,15161,-384761,-400075
776.950991,6,0,0,0,0,122900,123400,0,0,0
777.264362,0,906,806,100,-100,123000,123200,42938,328462,308462
777.264362,1,808,711,97,-97,123000,123200,38219,131581,112181
777.264362,2,6859,6811,48,-48,123000,123200,30164,-615264,-624864
777.264362,3,1024,982,42,-42,123000,123200,30471,209629,201229
777.264362,4,120,50,70,-70,123000,123200,-2139,-30461,-44461
777.264362,5,4787,4735,52,-52,123000,123200,15038,-389638,-400038
777.264362,6,0,0,0,0,123000,123200,0,0,0
777.535228,0,906,806,100,-100,122900,123200,42938,328462,303862
777.535228,1,808,711,97,-97,122900,123200,38219,131581,107719
777.535228,2,6859,6811,48,-48,122900,123200,30164,-615264,-627072
777.535228,3,1026,982,44,-44,122900,123200,30520,209980,199156
777.535228,4,120,50,70,-70,122900,123200,-2139,-30461,-47681
777.535228,5,4787,4737,50,-50,122900,123200,15013,-390413,-402713
777.535228,6,0,0,0,0,122900,123200,0,0,0
777.706854,0,906,806,100,-100,122600,123200,42938,328462,303862
777.706854,1,808,711,97,-97,122600,123200,38219,131581,107719
777.706854,2,6869,6811,58,-58,122600,123200,30262,-611362,-625630
777.706854,3,1028,982,46,-46,122600,123200,30569,210731,199415
777.706854,4,120,50,70,-70,122600,123200,-2139,-30461,-47681
777.706854,5,4797,4745,52,-52,122600,123200,14791,-388191,-400983
777.706854,6,0,0,0,0,122600,123200,0,0,0
778.013418,0,906,806,100,-100,123000,123200,42938,328462,308462
778.013418,1,808,711,97,-97,123000,123200,38219,131581,112181
778.013418,2,6869,6821,48,-48,123000,123200,30139,-616239,-625839
778.013418,3,1030,982,48,-48,123000,123200,30618,211282,201682
778.013418,4,120,50,70,-70,123000,123200,-2139,-30461,-44461
778.013418,5,4797,4745,52,-52,123000,123200,14791,-388191,-398591
778.013418,6,0,0,0,0,123000,123200,0,0,0
778.237372,0,906,806,100,-100,123000,123200,42938,328462,308462
778.237372,1,808,711,97,-97,123000,123200,38219,131581,112181
778.237372,2,6869,6821,48,-48,123000,123200,30139,-616239,-625839
778.237372,3,1030,982,48,-48,123000,123200,30618,211282,201682
778.237372,4,120,50,70,-70,123000,123200,-2139,-30461,-44461
778.237372,5,4797,4745,52,-52,123000,123200,14791,-388191,-398591
778.237372,6,0,0,0,0,123000,123200,0,0,0
778.507416,0,906,806,100,-100,123000,123200,42938,328462,308462
778.507416,1,808,711,97,-97,123000,123200,38219,131581,112181
778.507416,2,6869,6821,48,-48,123000,123200,30139,-616239,-625839
778.507416,3,1030,982,48,-48,123000,123200,30618,211282,201682
778.507416,4,120,50,70,-70,123000,123200,-2139,-30461,-44461
778.507416,5,4797,4745,52,-52,123000,123200,14791,-388191,-398591
778.507416,6,0,0,0,0,123000,123200,0,0,0
778.725653,0,906,806,100,-100,123000,123200,42938,328462,308462
778.725653,1,808,711,97,-97,123000,123200,38219,131581,112181
778.725653,2,6869,6821,48,-48,123000,123200,30139,-616239,-625839
778.725653,3,1032,982,50,-50,123000,123200,30667,211833,201833
778.725653,4,120,50,70,-70,123000,123200,-2139,-30461,-44461
778.725653,5,4797,4745,52,-52,123000,123200,14791,-388191,-398591
778.725653,6,0,0,0,0,123000,123200,0,0,0
778.981655,0,906,806,100,-100,123100,123600,42938,328462,303762
778.981655,1,808,711,97,-97,123100,123600,38219,131581,107622
778.981655,2,6869,6831,38,-38,123100,123600,30016,-623116,-632502
778.981655,3,1034,982,52,-52,123100,123600,30716,212384,199540
778.981655,4,120,50,70,-70,123100,123600,-2139,-30461,-47751
778.981655,5,4797,4755,42,-42,123100,123600,14668,-395068,-405442
778.981655,6,0,0,0,0,123100,123600,0,0,0
779.272423,0,906,806,100,-100,123100,123600,42938,328462,303762
779.272423,1,808,711,97,-97,123100,123600,38219,131581,107622
779.272423,2,6879,6831,48,-48,123100,123600,30262,-619362,-631218
779.272423,3,1036,982,54,-54,123100,123600,30765,213135,199797
779.272423,4,120,50,70,-70,123100,123600,-2139,-30461,-47751
779.272423,5,4797,4755,42,-42,123100,123600,14668,-395068,-405442
779.272423,6,0,0,0,0,123100,123600,0,0,0
779.491307,0,906,806,100,-100,123100,123500,42938,328462,303762
779.491307,1,808,711,97,-97,123100,123500,38219,131581,107622
779.491307,2,6889,6831,58,-58,123100,123500,30508,-615608,-629934
779.491307,3,1038,982,56,-56,123100,123500,30814,213886,200054
779.491307,4,120,50,70,-70,123100,123500,-2139,-30461,-47751
779.491307,5,4797,4755,42,-42,123100,123500,14668,-395068,-405442
779.491307,6,0,0,0,0,123100,123500,0,0,0
779.785947,0,906,806,100,-100,123100,123500,42938,328462,303762
779.785947,1,808,711,97,-97,123100,123500,38219,131581,107622
779.785947,2,6889,6831,58,-58,123100,123500,30508,-615608,-629934
779.785947,3,1040,982,58,-58,123100,123500,30863,214637,200311
779.785947,4,120,50,70,-70,123100,123500,-2139,-30461,-47751
779.785947,5,4807,4755,52,-52,123100,123500,14914,-391314,-404158
779.785947,6,0,0,0,0,123100,123500,0,0,0
780.03356,0,906,806,100,-100,123100,123900,42938,328462,303662
780.03356,1,808,711,97,-97,123100,123900,38219,131581,107525
780.03356,2,6889,6831,58,-58,123100,123900,30508,-615608,-629992
780.03356,3,1042,982,60,-60,123100,123900,30912,215388,200508
780.03356,4,120,50,70,-70,123100,123900,-2139,-30461,-47821
780.03356,5,4807,4755,52,-52,123100,123900,14914,-391314,-404210
780.03356,6,0,0,0,0,123100,123900,0,0,0
780.278224,0,906,806,100,-100,123200,123900,42938,328462,303662
780.278224,1,808,711,97,-97,123200,123900,38219,131581,107525
780.278224,2,6899,6831,68,-68,123200,123900,30754,-608854,-625718
780.278224,3,1044,982,62,-62,123200,123900,30962,216638,201262
780.278224,4,120,50,70,-70,123200,123900,-2139,-30461,-47821
780.278224,5,4817,4755,62,-62,123200,123900,15160,-384560,-399936
780.278224,6,0,0,0,0,123200,123900,0,0,0
780.468418,0,906,806,100,-100,123300,123900,42938,328462,303662
780.468418,1,808,711,97,-97,123300,123900,38219,131581,107525
780.468418,2,6899,6831,68,-68,123300,123900,30754,-608854,-625718
780.468418,3,1046,982,64,-64,123300,123900,31011,217389,201517
780.468418,4,120,50,70,-70,123300,123900,-2139,-30461,-47821
780.468418,5,4817,4755,62,-62,123300,123900,15160,-384560,-399936
780.468418,6,0,0,0,0,123300,123900,0,0,0
780.732892,0,906,806,100,-100,123200,123900,42938,328462,303662
780.732892,1,808,711,97,-97,123200,123900,38219,131581,107525
780.732892,2,6909,6831,78,-78,123200,123900,30631,-603731,-623075
780.732892,3,1048,982,66,-66,123200,123900,31060,218140,201772
780.732892,4,120,50,70,-70,123200,123900,-2139,-30461,-47821
780.732892,5,4817,4755,62,-62,123200,123900,15160,-384560,-399936
780.732892,6,0,0,0,0,123200,123900,0,0,0
781.022592,0,906,806,100,-100,123700,124300,42938,328462,303562
781.022592,1,808,711,97,-97,123700,124300,38219,131581,107428
781.022592,2,6909,6841,68,-68,123700,124300,30877,-610977,-627909
781.022592,3,1050,982,68,-68,123700,124300,31109,219091,202159
781.022592,4,120,50,70,-70,123700,124300,-2139,-30461,-47891
781.022592,5,4817,4765,52,-52,123700,124300,15037,-393437,-406385
781.022592,6,0,0,0,0,123700,124300,0,0,0
781.256005,0,906,806,100,-100,123800,124200,42938,328462,303662
781.256005,1,808,711,97,-97,123800,124200,38219,131581,107525
781.256005,2,6909,6851,58,-58,123800,124200,31124,-617224,-631608
781.256005,3,1054,982,72,-72,123800,124200,31209,220591,202735
781.256005,4,120,50,70,-70,123800,124200,-2139,-30461,-47821
781.256005,5,4817,4765,52,-52,123800,124200,15037,-393437,-406333
781.256005,6,0,0,0,0,123800,124200,0,0,0
781.532955,0,906,806,100,-100,123700,124200,42938,328462,303662
781.532955,1,808,711,97,-97,123700,124200,38219,131581,107525
781.532955,2,6909,6853,56,-56,123700,124200,31099,-617999,-631887
781.532955,3,1056,982,74,-74,123700,124200,31258,221142,202790
781.532955,4,120,50,70,-70,123700,124200,-2139,-30461,-47821
781.532955,5,4817,4765,52,-52,123700,124200,15037,-393437,-406333
781.532955,6,0,0,0,0,123700,124200,0,0,0
781.734103,0,906,806,100,-100,123800,124200,42938,328462,303662
781.734103,1,808,711,97,-97,123800,124200,38219,131581,107525
781.734103,2,6909,6861,48,-48,123800,124200,31000,-622700,-634604
781.734103,3,1058,982,76,-76,123800,124200,31308,221692,202844
781.734103,4,120,50,70,-70,123800,124200,-2139,-30461,-47821
781.734103,5,4825,4765,60,-60,123800,124200,15235,-390435,-405315
781.734103,6,0,0,0,0,123800,124200,0,0,0
782.011013,0,906,806,100,-100,123800,124200,42938,328462,303662
782.011013,1,808,711,97,-97,123800,124200,38219,131581,107525
782.011013,2,6909,6861,48,-48,123800,124200,31000,-622700,-634604
782.011013,3,1060,982,78,-78,123800,124200,31358,222242,202898
782.011013,4,120,50,70,-70,123800,124200,-2139,-30461,-47821
782.011013,5,4825,4765,60,-60,123800,124200,15235,-390435,-405315
782.011013,6,0,0,0,0,123800,124200,0,0,0
782.207952,0,906,806,100,-100,123800,124200,42938,328462,303662
782.207952,1,808,711,97,-97,123800,124200,38219,131581,107525
782.207952,2,6919,6861,58,-58,123800,124200,31248,-618948,-633332
782.207952,3,1062,982,80,-80,123800,124200,31408,222992,203152
782.207952,4,120,50,70,-70,123800,124200,-2139,-30461,-47821
782.207952,5,4825,4766,59,-59,123800,124200,15223,-391023,-405655
782.207952,6,0,0,0,0,123800,124200,0,0,0
782.545124,0,906,806,100,-100,123900,124200,42938,328462,303662
782.545124,1,808,711,97,-97,123900,124200,38219,131581,107525
782.545124,2,6919,6871,48,-48,123900,124200,31124,-623824,-635728
782.545124,3,1066,982,84,-84,123900,124200,31508,224492,203660
782.545124,4,120,50,70,-70,123900,124200,-2139,-30461,-47821
782.545124,5,4825,4775,50,-50,123900,124200,15111,-395411,-407811
782.545124,6,0,0,0,0,123900,124200,0,0,0
782.786395,0,906,806,100,-100,123600,124100,42938,328462,303662
782.786395,1,808,711,97,-97,123600,124100,38219,131581,107525
782.786395,2,6929,6871,58,-58,123600,124100,31000,-620700,-635084
782.786395,3,1068,982,86,-86,123600,124100,31558,225042,203714
782.786395,4,120,50,70,-70,123600,124100,-2139,-30461,-47821
782.786395,5,4835,4777,58,-58,123600,124100,14962,-392062,-406446
782.786395,6,0,0,0,0,123600,124100,0,0,0
782.970857,0,906,806,100,-100,123700,124100,42938,328462,303662
782.970857,1,808,711,97,-97,123700,124100,38219,131581,107525
782.970857,2,6929,6873,56,-56,123700,124100,30975,-621675,-635563
782.970857,3,1070,982,88,-88,123700,124100,31607,225593,203769
782.970857,4,120,50,70,-70,123700,124100,-2139,-30461,-47821
782.970857,5,4835,4777,58,-58,123700,124100,14962,-392062,-406446
782.970857,6,0,0,0,0,123700,124100,0,0,0
783.231431,0,906,806,100,-100,123700,124100,42938,328462,303662
783.231431,1,808,711,97,-97,123700,124100,38219,131581,107525
783.231431,2,6929,6873,56,-56,123700,124100,30975,-621675,-635563
783.231431,3,1070,982,88,-88,123700,124100,31607,225593,203769
783.231431,4,120,50,70,-70,123700,124100,-2139,-30461,-47821
783.231431,5,4835,4777,58,-58,123700,124100,14962,-392062,-406446
783.231431,6,0,0,0,0,123700,124100,0,0,0
783.473691,0,906,806,100,-100,123700,124100,42938,328462,303662
783.473691,1,808,711,97,-97,123700,124100,38219,131581,107525
783.473691,2,6929,6881,48,-48,123700,124100,30876,-627176,-639080
783.473691,3,1070,982,88,-88,123700,124100,31607,225593,203769
783.473691,4,120,50,70,-70,123700,124100,-2139,-30461,-47821
783.473691,5,4835,4777,58,-58,123700,124100,14962,-392062,-406446
783.473691,6,0,0,0,0,123700,124100,0,0,0
783.767726,0,906,806,100,-100,123900,124100,42938,328462,308462
783.767726,1,808,711,97,-97,123900,124100,38219,131581,112181
783.767726,2,6939,6883,56,-56,123900,124100,31099,-624599,-635799
783.767726,3,1072,982,90,-90,123900,124100,31657,226543,208543
783.767726,4,120,50,70,-70,123900,124100,-2139,-30461,-44461
783.767726,5,4835,4777,58,-58,123900,124100,14962,-392062,-403662
783.767726,6,0,0,0,0,123900,124100,0,0,0
783.957158,0,906,806,100,-100,124000,124300,42938,328462,303562
783.957158,1,808,711,97,-97,124000,124300,38219,131581,107428
783.957158,2,6939,6893,46,-46,124000,124300,30975,-628475,-639929
783.957158,3,1072,982,90,-90,124000,124300,31657,226543,204133
783.957158,4,120,50,70,-70,124000,124300,-2139,-30461,-47891
783.957158,5,4835,4787,48,-48,124000,124300,14838,-395938,-407890
783.957158,6,0,0,0,0,124000,124300,0,0,0
784.258529,0,906,806,100,-100,124000,124300,42938,328462,303562
784.258529,1,808,711,97,-97,124000,124300,38219,131581,107428
784.258529,2,6939,6893,46,-46,124000,124300,30975,-628475,-639929
784.258529,3,1072,982,90,-90,124000,124300,31657,226543,204133
784.258529,4,120,50,70,-70,124000,124300,-2139,-30461,-47891
784.258529,5,4835,4787,48,-48,124000,124300,14838,-395938,-407890
784.258529,6,0,0,0,0,124000,124300,0,0,0
784.467982,0,906,806,100,-100,124000,124000,42938,328462,328462
784.467982,1,808,711,97,-97,124000,124000,38219,131581,131581
784.467982,2,6939,6893,46,-46,124000,124000,30975,-628475,-628475
784.467982,3,1072,982,90,-90,124000,124000,31657,226543,226543
784.467982,4,120,50,70,-70,124000,124000,-2139,-30461,-30461
784.467982,5,4835,4787,48,-48,124000,124000,14838,-395938,-395938
784.467982,6,0,0,0,0,124000,124000,0,0,0
784.703208,0,906,806,100,-100,124000,124000,42938,328462,328462
784.703208,1,808,711,97,-97,124000,124000,38219,131581,131581
784.703208,2,6939,6893,46,-46,124000,124000,30975,-628475,-628475
784.703208,3,1072,982,90,-90,124000,124000,31657,226543,226543
784.703208,4,120,50,70,-70,124000,124000,-2139,-30461,-30461
784.703208,5,4835,4787,48,-48,124000,124000,14838,-395938,-395938
784.703208,6,0,0,0,0,124000,124000,0,0,0
784.959806,0,906,806,100,-100,123800,124000,42938,328462,308462
784.959806,1,808,711,97,-97,123800,124000,38219,131581,112181
784.959806,2,6939,6893,46,-46,123800,124000,30975,-628475,-637675
784.959806,3,1074,982,92,-92,123800,124000,31707,227093,208693
784.959806,4,120,50,70,-70,123800,124000,-2139,-30461,-44461
784.959806,5,4835,4789,46,-46,123800,124000,14813,-396913,-406113
784.959806,6,0,0,0,0,123800,124000,0,0,0
785.26341,0,906,806,100,-100,123800,124000,42938,328462,308462
785.26341,1,808,711,97,-97,123800,124000,38219,131581,112181
785.26341,2,6939,6893,46,-46,123800,124000,30975,-628475,-637675
785.26341,3,1074,982,92,-92,123800,124000,31707,227093,208693
785.26341,4,120,50,70,-70,123800,124000,-2139,-30461,-44461
785.26341,5,4835,4789,46,-46,123800,124000,14813,-396913,-406113
785.26341,6,0,0,0,0,123800,124000,0,0,0
785.528704,0,906,806,100,-100,124000,124000,42938,328462,328462
785.528704,1,808,711,97,-97,124000,124000,38219,131581,131581
785.528704,2,6939,6893,46,-46,124000,124000,30975,-628475,-628475
785.528704,3,1074,982,92,-92,124000,124000,31707,227093,227093
785.528704,4,120,50,70,-70,124000,124000,-2139,-30461,-30461
785.528704,5,4835,4789,46,-46,124000,124000,14813,-396913,-396913
785.528704,6,0,0,0,0,124000,124000,0,0,0
785.747599,0,906,806,100,-100,124000,124000,42938,328462,328462
785.747599,1,808,711,97,-97,124000,124000,38219,131581,131581
785.747599,2,6939,6893,46,-46,124000,124000,30975,-628475,-628475
785.747599,3,1074,982,92,-92,124000,124000,31707,227093,227093
785.747599,4,120,50,70,-70,124000,124000,-2139,-30461,-30461
785.747599,5,4835,4789,46,-46,124000,124000,14813,-396913,-396913
785.747599,6,0,0,0,0,124000,124000,0,0,0
786.040322,0,906,806,100,-100,124000,124000,42938,328462,328462
786.040322,1,808,711,97,-97,124000,124000,38219,131581,131581
786.040322,2,6939,6893,46,-46,124000,124000,30975,-628475,-628475
786.040322,3,1074,982,92,-92,124000,124000,31707,227093,227093
786.040322,4,120,50,70,-70,124000,124000,-2139,-30461,-30461
786.040322,5,4835,4789,46,-46,124000,124000,14813,-396913,-396913
786.040322,6,0,0,0,0,124000,124000,0,0,0
786.295079,0,906,806,100,-100,124000,124000,42938,328462,328462
786.295079,1,808,711,97,-97,124000,124000,38219,131581,131581
786.295079,2,6939,6893,46,-46,124000,124000,30975,-628475,-628475
786.295079,3,1074,982,92,-92,124000,124000,31707,227093,227093
786.295079,4,120,50,70,-70,124000,124000,-2139,-30461,-30461
786.295079,5,4835,4789,46,-46,124000,124000,14813,-396913,-396913
786.295079,6,0,0,0,0,124000,124000,0,0,0
786.5304,0,906,806,100,-100,124000,124500,42938,328462,303562
786.5304,1,808,711,97,-97,124000,124500,38219,131581,107428
786.5304,2,6939,6893,46,-46,124000,124500,30975,-628475,-639929
786.5304,3,1074,982,92,-92,124000,124500,31707,227093,204185
786.5304,4,120,50,70,-70,124000,124500,-2139,-30461,-47891
786.5304,5,4835,4789,46,-46,124000,124500,14813,-396913,-408367
786.5304,6,0,0,0,0,124000,124500,0,0,0
786.707692,0,906,806,100,-100,124000,124500,42938,328462,303562
786.707692,1,808,711,97,-97,124000,124500,38219,131581,107428
786.707692,2,6939,6893,46,-46,124000,124500,30975,-628475,-639929
786.707692,3,1074,982,92,-92,124000,124500,31707,227093,204185
786.707692,4,120,50,70,-70,124000,124500,-2139,-30461,-47891
786.707692,5,4845,4789,56,-56,124000,124500,15061,-394161,-408105
786.707692,6,0,0,0,0,124000,124500,0,0,0
786.99107,0,906,806,100,-100,124000,124500,42938,328462,303562
786.99107,1,808,711,97,-97,124000,124500,38219,131581,107428
786.99107,2,6949,6893,56,-56,124000,124500,31223,-623723,-637667
786.99107,3,1074,982,92,-92,124000,124500,31707,227093,204185
786.99107,4,120,50,70,-70,124000,124500,-2139,-30461,-47891
786.99107,5,4845,4789,56,-56,124000,124500,15061,-394161,-408105
786.99107,6,0,0,0,0,124000,124500,0,0,0
787.278145,0,906,806,100,-100,124100,124800,42938,328462,303462
787.278145,1,808,711,97,-97,124100,124800,38219,131581,107331
787.278145,2,6959,6893,66,-66,124100,124800,31471,-618971,-635471
787.278145,3,1074,982,92,-92,124100,124800,31707,227093,204093
787.278145,4,120,50,70,-70,124100,124800,-2139,-30461,-47961
787.278145,5,4845,4789,56,-56,124100,124800,15061,-394161,-408161
787.278145,6,0,0,0,0,124100,124800,0,0,0
787.521762,0,906,806,100,-100,124200,124800,42938,328462,303462
787.521762,1,808,711,97,-97,124200,124800,38219,131581,107331
787.521762,2,6969,6893,76,-76,124200,124800,31719,-613219,-632219
787.521762,3,1074,982,92,-92,124200,124800,31707,227093,204093
787.521762,4,120,50,70,-70,124200,124800,-2139,-30461,-47961
787.521762,5,4855,4789,66,-66,124200,124800,15309,-388409,-404909
787.521762,6,0,0,0,0,124200,124800,0,0,0
787.726007,0,906,806,100,-100,124200,124800,42938,328462,303462
787.726007,1,808,711,97,-97,124200,124800,38219,131581,107331
787.726007,2,6969,6903,66,-66,124200,124800,31967,-620467,-636967
787.726007,3,1074,982,92,-92,124200,124800,31707,227093,204093
787.726007,4,120,50,70,-70,124200,124800,-2139,-30461,-47961
787.726007,5,4855,4789,66,-66,124200,124800,15309,-388409,-404909
787.726007,6,0,0,0,0,124200,124800,0,0,0
787.957175,0,906,806,100,-100,124200,124800,42938,328462,303462
787.957175,1,808,711,97,-97,124200,124800,38219,131581,107331
787.957175,2,6969,6903,66,-66,124200,124800,31967,-620467,-636967
787.957175,3,1074,982,92,-92,124200,124800,31707,227093,204093
787.957175,4,120,50,70,-70,124200,124800,-2139,-30461,-47961
787.957175,5,4855,4789,66,-66,124200,124800,15309,-388409,-404909
787.957175,6,0,0,0,0,124200,124800,0,0,0
788.203666,0,906,806,100,-100,124200,124800,42938,328462,303462
788.203666,1,808,711,97,-97,124200,124800,38219,131581,107331
788.203666,2,6969,6903,66,-66,124200,124800,31967,-620467,-636967
788.203666,3,1074,982,92,-92,124200,124800,31707,227093,204093
788.203666,4,120,50,70,-70,124200,124800,-2139,-30461,-47961
788.203666,5,4855,4789,66,-66,124200,124800,15309,-388409,-404909
788.203666,6,0,0,0,0,124200,124800,0,0,0
788.460877,0,906,806,100,-100,124200,125200,42938,328462,303462
788.460877,1,808,711,97,-97,124200,125200,38219,131581,107331
788.460877,2,6969,6903,66,-66,124200,125200,31967,-620467,-636967
788.460877,3,1074,982,92,-92,124200,125200,31707,227093,204093
788.460877,4,120,50,70,-70,124200,125200,-2139,-30461,-47961
788.460877,5,4855,4789,66,-66,124200,125200,15309,-388409,-404909
788.460877,6,0,0,0,0,124200,125200,0,0,0
788.71202,0,906,806,100,-100,124400,125100,42938,328462,303462
788.71202,1,808,711,97,-97,124400,125100,38219,131581,107331
788.71202,2,6979,6913,66,-66,124400,125100,32092,-622592,-639092
788.71202,3,1074,982,92,-92,124400,125100,31707,227093,204093
788.71202,4,120,50,70,-70,124400,125100,-2139,-30461,-47961
788.71202,5,4865,4789,76,-76,124400,125100,15558,-380658,-399658
788.71202,6,0,0,0,0,124400,125100,0,0,0
788.965418,0,906,806,100,-100,124400,124900,42938,328462,303462
788.965418,1,808,711,97,-97,124400,124900,38219,131581,107331
788.965418,2,6979,6913,66,-66,124400,124900,32092,-622592,-639092
788.965418,3,1074,982,92,-92,124400,124900,31707,227093,204093
788.965418,4,120,50,70,-70,124400,124900,-2139,-30461,-47961
788.965418,5,4865,4789,76,-76,124400,124900,15558,-380658,-399658
788.965418,6,0,0,0,0,124400,124900,0,0,0
789.205485,0,906,806,100,-100,124400,124900,42938,328462,303462
789.205485,1,808,711,97,-97,124400,124900,38219,131581,107331
789.205485,2,6979,6913,66,-66,124400,124900,32092,-622592,-639092
789.205485,3,1074,982,92,-92,124400,124900,31707,227093,204093
789.205485,4,120,50,70,-70,124400,124900,-2139,-30461,-47961
789.205485,5,4865,4789,76,-76,124400,124900,15558,-380658,-399658
789.205485,6,0,0,0,0,124400,124900,0,0,0
789.463833,0,906,806,100,-100,124400,124900,42938,328462,303462
789.463833,1,808,711,97,-97,124400,124900,38219,131581,107331
789.463833,2,6979,6913,66,-66,124400,124900,32092,-622592,-639092
789.463833,3,1074,982,92,-92,124400,124900,31707,227093,204093
789.463833,4,120,50,70,-70,124400,124900,-2139,-30461,-47961
789.463833,5,4865,4789,76,-76,124400,124900,15558,-380658,-399658
789.463833,6,0,0,0,0,124400,124900,0,0,0
789.766012,0,906,806,100,-100,124200,124600,42938,328462,303562
789.766012,1,808,711,97,-97,124200,124600,38219,131581,107428
789.766012,2,6979,6923,56,-56,124200,124600,32340,-628840,-642784
789.766012,3,1074,982,92,-92,124200,124600,31707,227093,204185
789.766012,4,120,50,70,-70,124200,124600,-2139,-30461,-47891
789.766012,5,4865,4789,76,-76,124200,124600,15558,-380658,-399582
789.766012,6,0,0,0,0,124200,124600,0,0,0
790.011943,0,906,806,100,-100,124400,124600,42938,328462,308462
790.011943,1,808,711,97,-97,124400,124600,38219,131581,112181
790.011943,2,6979,6933,46,-46,124400,124600,32216,-634716,-643916
790.011943,3,1074,982,92,-92,124400,124600,31707,227093,208693
790.011943,4,120,50,70,-70,124400,124600,-2139,-30461,-44461
790.011943,5,4865,4789,76,-76,124400,124600,15558,-380658,-395858
790.011943,6,0,0,0,0,124400,124600,0,0,0
790.299477,0,906,806,100,-100,124400,124600,42938,328462,308462
790.299477,1,808,711,97,-97,124400,124600,38219,131581,112181
790.299477,2,6989,6933,56,-56,124400,124600,32465,-631965,-643165
790.299477,3,1074,982,92,-92,124400,124600,31707,227093,208693
790.299477,4,120,50,70,-70,124400,124600,-2139,-30461,-44461
790.299477,5,4865,4789,76,-76,124400,124600,15558,-380658,-395858
790.299477,6,0,0,0,0,124400,124600,0,0,0
790.475796,0,906,806,100,-100,124400,124600,42938,328462,308462
790.475796,1,808,711,97,-97,124400,124600,38219,131581,112181
790.475796,2,6989,6933,56,-56,124400,124600,32465,-631965,-643165
790.475796,3,1074,982,92,-92,124400,124600,31707,227093,208693
790.475796,4,120,50,70,-70,124400,124600,-2139,-30461,-44461
790.475796,5,4865,4799,66,-66,124400,124600,15806,-387906,-401106
790.475796,6,0,0,0,0,124400,124600,0,0,0
790.710034,0,906,806,100,-100,124400,124600,42938,328462,308462
790.710034,1,808,711,97,-97,124400,124600,38219,131581,112181
790.710034,2,6989,6933,56,-56,124400,124600,32465,-631965,-643165
790.710034,3,1074,982,92,-92,124400,124600,31707,227093,208693
790.710034,4,120,50,70,-70,124400,124600,-2139,-30461,-44461
790.710034,5,4865,4799,66,-66,124400,124600,15806,-387906,-401106
790.710034,6,0,0,0,0,124400,124600,0,0,0
790.9655,0,906,806,100,-100,124400,124600,42938,328462,308462
790.9655,1,808,711,97,-97,124400,124600,38219,131581,112181
790.9655,2,6989,6933,56,-56,124400,124600,32465,-631965,-643165
790.9655,3,1074,982,92,-92,124400,124600,31707,227093,208693
790.9655,4,120,50,70,-70,124400,124600,-2139,-30461,-44461
790.9655,5,4865,4799,66,-66,124400,124600,15806,-387906,-401106
790.9655,6,0,0,0,0,124400,124600,0,0,0
791.203914,0,906,806,100,-100,124400,124600,42938,328462,308462
791.203914,1,808,711,97,-97,124400,124600,38219,131581,112181
791.203914,2,6989,6933,56,-56,124400,124600,32465,-631965,-643165
791.203914,3,1074,982,92,-92,124400,124600,31707,227093,208693
791.203914,4,120,50,70,-70,124400,124600,-2139,-30461,-44461
791.203914,5,4865,4799,66,-66,124400,124600,15806,-387906,-401106
791.203914,6,0,0,0,0,124400,124600,0,0,0
791.470957,0,906,806,100,-100,124400,124600,42938,328462,308462
791.470957,1,808,711,97,-97,124400,124600,38219,131581,112181
791.470957,2,6999,6933,66,-66,124400,124600,32714,-626214,-639414
791.470957,3,1074,982,92,-92,124400,124600,31707,227093,208693
791.470957,4,120,50,70,-70,124400,124600,-2139,-30461,-44461
791.470957,5,4865,4799,66,-66,124400,124600,15806,-387906,-401106
791.470957,6,0,0,0,0,124400,124600,0,0,0
791.722514,0,906,806,100,-100,124600,124600,42938,328462,328462
791.722514,1,808,711,97,-97,124600,124600,38219,131581,131581
791.722514,2,6999,6943,56,-56,124600,124600,32590,-634090,-634090
791.722514,3,1074,982,92,-92,124600,124600,31707,227093,227093
791.722514,4,120,50,70,-70,124600,124600,-2139,-30461,-30461
791.722514,5,4865,4809,56,-56,124600,124600,15681,-394781,-394781
791.722514,6,0,0,0,0,124600,124600,0,0,0
791.965039,0,906,806,100,-100,124700,125200,42938,328462,303462
791.965039,1,808,711,97,-97,124700,125200,38219,131581,107331
791.965039,2,7009,6943,66,-66,124700,125200,32839,-630339,-646839
791.965039,3,1074,982,92,-92,124700,125200,31707,227093,204093
791.965039,4,120,50,70,-70,124700,125200,-2139,-30461,-47961
791.965039,5,4865,4809,56,-56,124700,125200,15681,-394781,-408781
791.965039,6,0,0,0,0,124700,125200,0,0,0
792.266878,0,906,806,100,-100,124600,125200,42938,328462,303462
792.266878,1,808,711,97,-97,124600,125200,38219,131581,107331
792.266878,2,7009,6953,56,-56,124600,125200,33088,-635588,-649588
792.266878,3,1074,982,92,-92,124600,125200,31707,227093,204093
792.266878,4,120,50,70,-70,124600,125200,-2139,-30461,-47961
792.266878,5,4875,4809,66,-66,124600,125200,15556,-390656,-407156
792.266878,6,0,0,0,0,124600,125200,0,0,0
792.467719,0,906,806,100,-100,124500,125200,42938,328462,303462
792.467719,1,808,711,97,-97,124500,125200,38219,131581,107331
792.467719,2,7019,6953,66,-66,124500,125200,33337,-630837,-647337
792.467719,3,1074,982,92,-92,124500,125200,31707,227093,204093
792.467719,4,120,50,70,-70,124500,125200,-2139,-30461,-47961
792.467719,5,4875,4819,56,-56,124500,125200,15432,-397532,-411532
792.467719,6,0,0,0,0,124500,125200,0,0,0
792.707194,0,906,806,100,-100,124500,125200,42938,328462,303462
792.707194,1,808,711,97,-97,124500,125200,38219,131581,107331
792.707194,2,7019,6953,66,-66,124500,125200,33337,-630837,-647337
792.707194,3,1074,982,92,-92,124500,125200,31707,227093,204093
792.707194,4,120,50,70,-70,124500,125200,-2139,-30461,-47961
792.707194,5,4875,4819,56,-56,124500,125200,15432,-397532,-411532
792.707194,6,0,0,0,0,124500,125200,0,0,0
793.007585,0,906,806,100,-100,124700,125200,42938,328462,303462
793.007585,1,808,711,97,-97,124700,125200,38219,131581,107331
793.007585,2,7019,6953,66,-66,124700,125200,33337,-630837,-647337
793.007585,3,1074,982,92,-92,124700,125200,31707,227093,204093
793.007585,4,120,50,70,-70,124700,125200,-2139,-30461,-47961
793.007585,5,4875,4819,56,-56,124700,125200,15432,-397532,-411532
793.007585,6,0,0,0,0,124700,125200,0,0,0
793.289442,0,906,806,100,-100,124700,125200,42938,328462,303462
793.289442,1,808,711,97,-97,124700,125200,38219,131581,107331
793.289442,2,7019,6963,56,-56,124700,125200,33586,-637086,-651086
793.289442,3,1074,982,92,-92,124700,125200,31707,227093,204093
793.289442,4,120,50,70,-70,124700,125200,-2139,-30461,-47961
793.289442,5,4875,4819,56,-56,124700,125200,15432,-397532,-411532
793.289442,6,0,0,0,0,124700,125200,0,0,0
793.461327,0,906,806,100,-100,124700,125200,42938,328462,303462
793.461327,1,808,711,97,-97,124700,125200,38219,131581,107331
793.461327,2,7019,6964,55,-55,124700,125200,33574,-637574,-651324
793.461327,3,1074,982,92,-92,124700,125200,31707,227093,204093
793.461327,4,120,50,70,-70,124700,125200,-2139,-30461,-47961
793.461327,5,4875,4819,56,-56,124700,125200,15432,-397532,-411532
793.461327,6,0,0,0,0,124700,125200,0,0,0
793.792356,0,906,806,100,-100,124800,125200,42938,328462,303462
793.792356,1,808,711,97,-97,124800,125200,38219,131581,107331
793.792356,2,7029,6973,56,-56,124800,125200,33337,-636737,-650737
793.792356,3,1074,982,92,-92,124800,125200,31707,227093,204093
793.792356,4,120,50,70,-70,124800,125200,-2139,-30461,-47961
793.792356,5,4875,4819,56,-56,124800,125200,15432,-397532,-411532
793.792356,6,0,0,0,0,124800,125200,0,0,0
794.032976,0,906,806,100,-100,124800,125100,42938,328462,303462
794.032976,1,808,711,97,-97,124800,125100,38219,131581,107331
794.032976,2,7029,6973,56,-56,124800,125100,33337,-636737,-650737
794.032976,3,1074,982,92,-92,124800,125100,31707,227093,204093
794.032976,4,120,50,70,-70,124800,125100,-2139,-30461,-47961
794.032976,5,4875,4819,56,-56,124800,125100,15432,-397532,-411532
794.032976,6,0,0,0,0,124800,125100,0,0,0
794.239006,0,906,806,100,-100,124800,125100,42938,328462,303462
794.239006,1,808,711,97,-97,124800,125100,38219,131581,107331
794.239006,2,7029,6973,56,-56,124800,125100,33337,-636737,-650737
794.239006,3,1074,982,92,-92,124800,125100,31707,227093,204093
794.239006,4,120,50,70,-70,124800,125100,-2139,-30461,-47961
794.239006,5,4875,4819,56,-56,124800,125100,15432,-397532,-411532
794.239006,6,0,0,0,0,124800,125100,0,0,0
794.528904,0,906,806,100,-100,124900,125100,42938,328462,308462
794.528904,1,808,711,97,-97,124900,125100,38219,131581,112181
794.528904,2,7029,6983,46,-46,124900,125100,33586,-641986,-651186
794.528904,3,1074,982,92,-92,124900,125100,31707,227093,208693
794.528904,4,120,50,70,-70,124900,125100,-2139,-30461,-44461
794.528904,5,4875,4819,56,-56,124900,125100,15432,-397532,-408732
794.528904,6,0,0,0,0,124900,125100,0,0,0
794.769187,0,906,806,100,-100,124400,125100,42938,328462,303462
794.769187,1,808,711,97,-97,124400,125100,38219,131581,107331
794.769187,2,7039,6983,56,-56,124400,125100,33462,-637862,-651862
794.769187,3,1074,982,92,-92,124400,125100,31707,227093,204093
794.769187,4,120,50,70,-70,124400,125100,-2139,-30461,-47961
794.769187,5,4875,4819,56,-56,124400,125100,15432,-397532,-411532
794.769187,6,0,0,0,0,124400,125100,0,0,0
795.045451,0,906,806,100,-100,124400,125100,42938,328462,303462
795.045451,1,808,711,97,-97,124400,125100,38219,131581,107331
795.045451,2,7039,6983,56,-56,124400,125100,33462,-637862,-651862
795.045451,3,1074,982,92,-92,124400,125100,31707,227093,204093
795.045451,4,120,50,70,-70,124400,125100,-2139,-30461,-47961
795.045451,5,4875,4819,56,-56,124400,125100,15432,-397532,-411532
795.045451,6,0,0,0,0,124400,125100,0,0,0
795.214667,0,906,806,100,-100,124400,125100,42938,328462,303462
795.214667,1,808,711,97,-97,124400,125100,38219,131581,107331
795.214667,2,7039,6983,56,-56,124400,125100,33462,-637862,-651862
795.214667,3,1074,982,92,-92,124400,125100,31707,227093,204093
795.214667,4,120,50,70,-70,124400,125100,-2139,-30461,-47961
795.214667,5,4875,4819,56,-56,124400,125100,15432,-397532,-411532
795.214667,6,0,0,0,0,124400,125100,0,0,0
795.491033,0,906,806,100,-100,124400,125100,42938,328462,303462
795.491033,1,808,711,97,-97,124400,125100,38219,131581,107331
795.491033,2,7039,6983,56,-56,124400,125100,33462,-637862,-651862
795.491033,3,1074,982,92,-92,124400,125100,31707,227093,204093
795.491033,4,120,50,70,-70,124400,125100,-2139,-30461,-47961
795.491033,5,4875,4819,56,-56,124400,125100,15432,-397532,-411532
795.491033,6,0,0,0,0,124400,125100,0,0,0
795.742121,0,906,806,100,-100,124400,125100,42938,328462,303462
795.742121,1,808,711,97,-97,124400,125100,38219,131581,107331
795.742121,2,7049,6993,56,-56,124400,125100,33587,-637987,-651987
795.742121,3,1074,982,92,-92,124400,125100,31707,227093,204093
795.742121,4,120,50,70,-70,124400,125100,-2139,-30461,-47961
795.742121,5,4885,4819,66,-66,124400,125100,15308,-393408,-409908
795.742121,6,0,0,0,0,124400,125100,0,0,0
796.047809,0,906,806,100,-100,124400,125100,42938,328462,303462
796.047809,1,808,711,97,-97,124400,125100,38219,131581,107331
796.047809,2,7049,6993,56,-56,124400,125100,33587,-637987,-651987
796.047809,3,1074,982,92,-92,124400,125100,31707,227093,204093
796.047809,4,120,50,70,-70,124400,125100,-2139,-30461,-47961
796.047809,5,4885,4819,66,-66,124400,125100,15308,-393408,-409908
796.047809,6,0,0,0,0,124400,125100,0,0,0
796.207844,0,906,806,100,-100,124400,125100,42938,328462,303462
796.207844,1,808,711,97,-97,124400,125100,38219,131581,107331
796.207844,2,7049,6993,56,-56,124400,125100,33587,-637987,-651987
796.207844,3,1074,982,92,-92,124400,125100,31707,227093,204093
796.207844,4,120,50,70,-70,124400,125100,-2139,-30461,-47961
796.207844,5,4885,4819,66,-66,124400,125100,15308,-393408,-409908
796.207844,6,0,0,0,0,124400,125100,0,0,0
796.469957,0,906,806,100,-100,124400,125500,42938,328462,303362
796.469957,1,808,711,97,-97,124400,125500,38219,131581,107234
796.469957,2,7049,6993,56,-56,124400,125500,33587,-637987,-652043
796.469957,3,1074,982,92,-92,124400,125500,31707,227093,204001
796.469957,4,120,50,70,-70,124400,125500,-2139,-30461,-48031
796.469957,5,4885,4819,66,-66,124400,125500,15308,-393408,-409974
796.469957,6,0,0,0,0,124400,125500,0,0,0
796.72571,0,906,806,100,-100,125000,125500,42938,328462,303362
796.72571,1,808,711,97,-97,125000,125500,38219,131581,107234
796.72571,2,7059,7003,56,-56,125000,125500,33712,-642112,-656168
796.72571,3,1074,982,92,-92,125000,125500,31707,227093,204001
796.72571,4,120,50,70,-70,125000,125500,-2139,-30461,-48031
796.72571,5,4895,4819,76,-76,125000,125500,15557,-384657,-403733
796.72571,6,0,0,0,0,125000,125500,0,0,0
797.004591,0,906,806,100,-100,125000,125500,42938,328462,303362
797.004591,1,808,711,97,-97,125000,125500,38219,131581,107234
797.004591,2,7059,7003,56,-56,125000,125500,33712,-642112,-656168
797.004591,3,1074,982,92,-92,125000,125500,31707,227093,204001
797.004591,4,120,50,70,-70,125000,125500,-2139,-30461,-48031
797.004591,5,4895,4819,76,-76,125000,125500,15557,-384657,-403733
797.004591,6,0,0,0,0,125000,125500,0,0,0
797.242858,0,906,806,100,-100,125000,125500,42938,328462,303362
797.242858,1,808,711,97,-97,125000,125500,38219,131581,107234
797.242858,2,7059,7003,56,-56,125000,125500,33712,-642112,-656168
797.242858,3,1074,982,92,-92,125000,125500,31707,227093,204001
797.242858,4,120,50,70,-70,125000,125500,-2139,-30461,-48031
797.242858,5,4895,4819,76,-76,125000,125500,15557,-384657,-403733
797.242858,6,0,0,0,0,125000,125500,0,0,0
797.515635,0,906,806,100,-100,125000,125500,42938,328462,303362
797.515635,1,808,711,97,-97,125000,125500,38219,131581,107234
797.515635,2,7069,7003,66,-66,125000,125500,33962,-637362,-653928
797.515635,3,1074,982,92,-92,125000,125500,31707,227093,204001
797.515635,4,120,50,70,-70,125000,125500,-2139,-30461,-48031
797.515635,5,4895,4829,66,-66,125000,125500,15432,-390532,-407098
797.515635,6,0,0,0,0,125000,125500,0,0,0
797.758566,0,906,806,100,-100,124800,125500,42938,328462,303362
797.758566,1,808,711,97,-97,124800,125500,38219,131581,107234
797.758566,2,7079,7013,66,-66,124800,125500,34087,-637487,-654053
797.758566,3,1074,982,92,-92,124800,125500,31707,227093,204001
797.758566,4,120,50,70,-70,124800,125500,-2139,-30461,-48031
797.758566,5,4905,4829,76,-76,124800,125500,15307,-385407,-404483
797.758566,6,0,0,0,0,124800,125500,0,0,0
798.019107,0,906,806,100,-100,124800,125500,42938,328462,303362
798.019107,1,808,711,97,-97,124800,125500,38219,131581,107234
798.019107,2,7079,7013,66,-66,124800,125500,34087,-637487,-654053
798.019107,3,1074,982,92,-92,124800,125500,31707,227093,204001
798.019107,4,120,50,70,-70,124800,125500,-2139,-30461,-48031
798.019107,5,4905,4829,76,-76,124800,125500,15307,-385407,-404483
798.019107,6,0,0,0,0,124800,125500,0,0,0
798.22404,0,906,806,100,-100,124800,125500,42938,328462,303362
798.22404,1,808,711,97,-97,124800,125500,38219,131581,107234
798.22404,2,7079,7013,66,-66,124800,125500,34087,-637487,-654053
798.22404,3,1074,982,92,-92,124800,125500,31707,227093,204001
798.22404,4,120,50,70,-70,124800,125500,-2139,-30461,-48031
798.22404,5,4905,4829,76,-76,124800,125500,15307,-385407,-404483
798.22404,6,0,0,0,0,124800,125500,0,0,0
798.489332,0,906,806,100,-100,124800,125500,42938,328462,303362
798.489332,1,808,711,97,-97,124800,125500,38219,131581,107234
798.489332,2,7079,7013,66,-66,124800,125500,34087,-637487,-654053
798.489332,3,1074,982,92,-92,124800,125500,31707,227093,204001
798.489332,4,120,50,70,-70,124800,125500,-2139,-30461,-48031
798.489332,5,4905,4829,76,-76,124800,125500,15307,-385407,-404483
798.489332,6,0,0,0,0,124800,125500,0,0,0
798.77184,0,906,806,100,-100,124800,125500,42938,328462,303362
798.77184,1,808,711,97,-97,124800,125500,38219,131581,107234
798.77184,2,7079,7013,66,-66,124800,125500,34087,-637487,-654053
798.77184,3,1074,982,92,-92,124800,125500,31707,227093,204001
798.77184,4,120,50,70,-70,124800,125500,-2139,-30461,-48031
798.77184,5,4905,4829,76,-76,124800,125500,15307,-385407,-404483
798.77184,6,0,0,0,0,124800,125500,0,0,0
798.972159,0,906,806,100,-100,124800,125500,42938,328462,303362
798.972159,1,808,711,97,-97,124800,125500,38219,131581,107234
798.972159,2,7079,7013,66,-66,124800,125500,34087,-637487,-654053
798.972159,3,1074,982,92,-92,124800,125500,31707,227093,204001
798.972159,4,120,50,70,-70,124800,125500,-2139,-30461,-48031
798.972159,5,4905,4829,76,-76,124800,125500,15307,-385407,-404483
798.972159,6,0,0,0,0,124800,125500,0,0,0
799.297602,0,906,806,100,-100,125100,125500,42938,328462,303362
799.297602,1,808,711,97,-97,125100,125500,38219,131581,107234
799.297602,2,7079,7013,66,-66,125100,125500,34087,-637487,-654053
799.297602,3,1074,982,92,-92,125100,125500,31707,227093,204001
799.297602,4,120,50,70,-70,125100,125500,-2139,-30461,-48031
799.297602,5,4905,4839,66,-66,125100,125500,15182,-391282,-407848
799.297602,6,0,0,0,0,125100,125500,0,0,0
799.487234,0,906,806,100,-100,125100,125500,42938,328462,303362
799.487234,1,808,711,97,-97,125100,125500,38219,131581,107234
799.487234,2,7079,7023,56,-56,125100,125500,34337,-642737,-656793
799.487234,3,1074,982,92,-92,125100,125500,31707,227093,204001
799.487234,4,120,50,70,-70,125100,125500,-2139,-30461,-48031
799.487234,5,4905,4849,56,-56,125100,125500,15432,-396532,-410588
799.487234,6,0,0,0,0,125100,125500,0,0,0
799.765567,0,906,806,100,-100,125100,125500,42938,328462,303362
799.765567,1,808,711,97,-97,125100,125500,38219,131581,107234
799.765567,2,7079,7023,56,-56,125100,125500,34337,-642737,-656793
799.765567,3,1074,982,92,-92,125100,125500,31707,227093,204001
799.765567,4,120,50,70,-70,125100,125500,-2139,-30461,-48031
799.765567,5,4905,4849,56,-56,125100,125500,15432,-396532,-410588
799.765567,6,0,0,0,0,125100,125500,0,0,0
800.001936,0,906,806,100,-100,125000,125500,42938,328462,303362
800.001936,1,808,711,97,-97,125000,125500,38219,131581,107234
800.001936,2,7079,7033,46,-46,125000,125500,34587,-647987,-659533
800.001936,3,1074,982,92,-92,125000,125500,31707,227093,204001
800.001936,4,120,50,70,-70,125000,125500,-2139,-30461,-48031
800.001936,5,4905,4849,56,-56,125000,125500,15432,-396532,-410588
800.001936,6,0,0,0,0,125000,125500,0,0,0
800.277838,0,906,806,100,-100,125000,125200,42938,328462,308462
800.277838,1,808,711,97,-97,125000,125200,38219,131581,112181
800.277838,2,7079,7033,46,-46,125000,125200,34587,-647987,-657187
800.277838,3,1074,982,92,-92,125000,125200,31707,227093,208693
800.277838,4,120,50,70,-70,125000,125200,-2139,-30461,-44461
800.277838,5,4905,4849,56,-56,125000,125200,15432,-396532,-407732
800.277838,6,0,0,0,0,125000,125200,0,0,0
800.498332,0,906,806,100,-100,125000,125200,42938,328462,308462
800.498332,1,808,711,97,-97,125000,125200,38219,131581,112181
800.498332,2,7079,7043,36,-36,125000,125200,34837,-650237,-657437
800.498332,3,1074,982,92,-92,125000,125200,31707,227093,208693
800.498332,4,120,50,70,-70,125000,125200,-2139,-30461,-44461
800.498332,5,4905,4849,56,-56,125000,125200,15432,-396532,-407732
800.498332,6,0,0,0,0,125000,125200,0,0,0
800.755581,0,906,806,100,-100,125000,125200,42938,328462,308462
800.755581,1,808,711,97,-97,125000,125200,38219,131581,112181
800.755581,2,7079,7053,26,-26,125000,125200,35087,-652487,-657687
800.755581,3,1074,982,92,-92,125000,125200,31707,227093,208693
800.755581,4,120,50,70,-70,125000,125200,-2139,-30461,-44461
800.755581,5,4905,4849,56,-56,125000,125200,15432,-396532,-407732
800.755581,6,0,0,0,0,125000,125200,0,0,0
800.978487,0,906,806,100,-100,125000,125200,42938,328462,308462
800.978487,1,808,711,97,-97,125000,125200,38219,131581,112181
800.978487,2,7079,7063,16,-16,125000,125200,35337,-654737,-657937
800.978487,3,1074,982,92,-92,125000,125200,31707,227093,208693
800.978487,4,120,50,70,-70,125000,125200,-2139,-30461,-44461
800.978487,5,4905,4849,56,-56,125000,125200,15432,-396532,-407732
800.978487,6,0,0,0,0,125000,125200,0,0,0
801.220488,0,906,806,100,-100,124900,125200,42938,328462,303462
801.220488,1,808,711,97,-97,124900,125200,38219,131581,107331
801.220488,2,7079,7063,16,-16,124900,125200,35337,-654737,-658737
801.220488,3,1074,982,92,-92,124900,125200,31707,227093,204093
801.220488,4,120,50,70,-70,124900,125200,-2139,-30461,-47961
801.220488,5,4905,4859,46,-46,124900,125200,15682,-399382,-410882
801.220488,6,0,0,0,0,124900,125200,0,0,0
801.549723,0,906,806,100,-100,125100,125600,42938,328462,303362
801.549723,1,808,711,97,-97,125100,125600,38219,131581,107234
801.549723,2,7089,7063,26,-26,125100,125600,35587,-653987,-660513
801.549723,3,1074,982,92,-92,125100,125600,31707,227093,204001
801.549723,4,120,50,70,-70,125100,125600,-2139,-30461,-48031
801.549723,5,4905,4859,46,-46,125100,125600,15682,-399382,-410928
801.549723,6,0,0,0,0,125100,125600,0,0,0
801.77123,0,906,806,100,-100,125300,125600,42938,328462,303362
801.77123,1,808,711,97,-97,125300,125600,38219,131581,107234
801.77123,2,7099,7063,36,-36,125300,125600,35837,-650237,-659273
801.77123,3,1074,982,92,-92,125300,125600,31707,227093,204001
801.77123,4,120,50,70,-70,125300,125600,-2139,-30461,-48031
801.77123,5,4905,4859,46,-46,125300,125600,15682,-399382,-410928
801.77123,6,0,0,0,0,125300,125600,0,0,0
802.034842,0,906,806,100,-100,125000,125600,42938,328462,303362
802.034842,1,808,711,97,-97,125000,125600,38219,131581,107234
802.034842,2,7109,7063,46,-46,125000,125600,35712,-647112,-658658
802.034842,3,1074,982,92,-92,125000,125600,31707,227093,204001
802.034842,4,120,50,70,-70,125000,125600,-2139,-30461,-48031
802.034842,5,4915,4859,56,-56,125000,125600,15557,-394257,-408313
802.034842,6,0,0,0,0,125000,125600,0,0,0
802.207912,0,906,806,100,-100,125000,125600,42938,328462,303362
802.207912,1,808,711,97,-97,125000,125600,38219,131581,107234
802.207912,2,7109,7063,46,-46,125000,125600,35712,-647112,-658658
802.207912,3,1074,982,92,-92,125000,125600,31707,227093,204001
802.207912,4,120,50,70,-70,125000,125600,-2139,-30461,-48031
802.207912,5,4915,4859,56,-56,125000,125600,15557,-394257,-408313
802.207912,6,0,0,0,0,125000,125600,0,0,0
802.507525,0,906,806,100,-100,125000,125500,42938,328462,303362
802.507525,1,808,711,97,-97,125000,125500,38219,131581,107234
802.507525,2,7109,7063,46,-46,125000,125500,35712,-647112,-658658
802.507525,3,1074,982,92,-92,125000,125500,31707,227093,204001
802.507525,4,120,50,70,-70,125000,125500,-2139,-30461,-48031
802.507525,5,4915,4859,56,-56,125000,125500,15557,-394257,-408313
802.507525,6,0,0,0,0,125000,125500,0,0,0
802.73236,0,906,806,100,-100,125000,125500,42938,328462,303362
802.73236,1,808,711,97,-97,125000,125500,38219,131581,107234
802.73236,2,7109,7063,46,-46,125000,125500,35712,-647112,-658658
802.73236,3,1074,982,92,-92,125000,125500,31707,227093,204001
802.73236,4,120,50,70,-70,125000,125500,-2139,-30461,-48031
802.73236,5,4915,4859,56,-56,125000,125500,15557,-394257,-408313
802.73236,6,0,0,0,0,125000,125500,0,0,0
803.000393,0,906,806,100,-100,125000,125500,42938,328462,303362
803.000393,1,808,711,97,-97,125000,125500,38219,131581,107234
803.000393,2,7109,7063,46,-46,125000,125500,35712,-647112,-658658
803.000393,3,1074,982,92,-92,125000,125500,31707,227093,204001
803.000393,4,120,50,70,-70,125000,125500,-2139,-30461,-48031
803.000393,5,4915,4859,56,-56,125000,125500,15557,-394257,-408313
803.000393,6,0,0,0,0,125000,125500,0,0,0
803.224864,0,906,806,100,-100,124900,125500,42938,328462,303362
803.224864,1,808,711,97,-97,124900,125500,38219,131581,107234
803.224864,2,7119,7063,56,-56,124900,125500,35587,-642987,-657043
803.224864,3,1074,982,92,-92,124900,125500,31707,227093,204001
803.224864,4,120,50,70,-70,124900,125500,-2139,-30461,-48031
803.224864,5,4925,4859,66,-66,124900,125500,15432,-389132,-405698
803.224864,6,0,0,0,0,124900,125500,0,0,0
803.543068,0,906,806,100,-100,124900,125500,42938,328462,303362
803.543068,1,808,711,97,-97,124900,125500,38219,131581,107234
803.543068,2,7119,7063,56,-56,124900,125500,35587,-642987,-657043
803.543068,3,1074,982,92,-92,124900,125500,31707,227093,204001
803.543068,4,120,50,70,-70,124900,125500,-2139,-30461,-48031
803.543068,5,4925,4859,66,-66,124900,125500,15432,-389132,-405698
803.543068,6,0,0,0,0,124900,125500,0,0,0
803.761165,0,906,806,100,-100,124900,125500,42938,328462,303362
803.761165,1,808,711,97,-97,124900,125500,38219,131581,107234
803.761165,2,7129,7063,66,-66,124900,125500,35462,-638862,-655428
803.761165,3,1074,982,92,-92,124900,125500,31707,227093,204001
803.761165,4,120,50,70,-70,124900,125500,-2139,-30461,-48031
803.761165,5,4925,4869,56,-56,124900,125500,15682,-395382,-409438
803.761165,6,0,0,0,0,124900,125500,0,0,0
804.027673,0,906,806,100,-100,125000,125500,42938,328462,303362
804.027673,1,808,711,97,-97,125000,125500,38219,131581,107234
804.027673,2,7129,7073,56,-56,125000,125500,35337,-644737,-658793
804.027673,3,1074,982,92,-92,125000,125500,31707,227093,204001
804.027673,4,120,50,70,-70,125000,125500,-2139,-30461,-48031
804.027673,5,4935,4869,66,-66,125000,125500,15932,-391632,-408198
804.027673,6,0,0,0,0,125000,125500,0,0,0
804.232249,0,906,806,100,-100,125000,125500,42938,328462,303362
804.232249,1,808,711,97,-97,125000,125500,38219,131581,107234
804.232249,2,7129,7073,56,-56,125000,125500,35337,-644737,-658793
804.232249,3,1074,982,92,-92,125000,125500,31707,227093,204001
804.232249,4,120,50,70,-70,125000,125500,-2139,-30461,-48031
804.232249,5,4935,4869,66,-66,125000,125500,15932,-391632,-408198
804.232249,6,0,0,0,0,125000,125500,0,0,0
804.491456,0,906,806,100,-100,125000,125500,42938,328462,303362
804.491456,1,808,711,97,-97,125000,125500,38219,131581,107234
804.491456,2,7129,7073,56,-56,125000,125500,35337,-644737,-658793
804.491456,3,1074,982,92,-92,125000,125500,31707,227093,204001
804.491456,4,120,50,70,-70,125000,125500,-2139,-30461,-48031
804.491456,5,4935,4869,66,-66,125000,125500,15932,-391632,-408198
804.491456,6,0,0,0,0,125000,125500,0,0,0
804.737655,0,906,806,100,-100,125000,125400,42938,328462,303362
804.737655,1,808,711,97,-97,125000,125400,38219,131581,107234
804.737655,2,7129,7073,56,-56,125000,125400,35337,-644737,-658793
804.737655,3,1074,982,92,-92,125000,125400,31707,227093,204001
804.737655,4,120,50,70,-70,125000,125400,-2139,-30461,-48031
804.737655,5,4935,4869,66,-66,125000,125400,15932,-391632,-408198
804.737655,6,0,0,0,0,125000,125400,0,0,0
804.957147,0,906,806,100,-100,125000,125200,42938,328462,308462
804.957147,1,808,711,97,-97,125000,125200,38219,131581,112181
804.957147,2,7129,7073,56,-56,125000,125200,35337,-644737,-655937
804.957147,3,1074,982,92,-92,125000,125200,31707,227093,208693
804.957147,4,120,50,70,-70,125000,125200,-2139,-30461,-44461
804.957147,5,4935,4869,66,-66,125000,125200,15932,-391632,-404832
804.957147,6,0,0,0,0,125000,125200,0,0,0
805.298287,0,906,806,100,-100,124800,125200,42938,328462,303462
805.298287,1,808,711,97,-97,124800,125200,38219,131581,107331
805.298287,2,7129,7083,46,-46,124800,125200,35587,-649987,-661487
805.298287,3,1074,982,92,-92,124800,125200,31707,227093,204093
805.298287,4,120,50,70,-70,124800,125200,-2139,-30461,-47961
805.298287,5,4935,4869,66,-66,124800,125200,15932,-391632,-408132
805.298287,6,0,0,0,0,124800,125200,0,0,0
805.532381,0,906,806,100,-100,124800,125200,42938,328462,303462
805.532381,1,808,711,97,-97,124800,125200,38219,131581,107331
805.532381,2,7139,7083,56,-56,124800,125200,35462,-645862,-659862
805.532381,3,1074,982,92,-92,124800,125200,31707,227093,204093
805.532381,4,120,50,70,-70,124800,125200,-2139,-30461,-47961
805.532381,5,4935,4879,56,-56,124800,125200,16182,-396882,-410882
805.532381,6,0,0,0,0,124800,125200,0,0,0
805.721924,0,906,806,100,-100,124900,125200,42938,328462,303462
805.721924,1,808,711,97,-97,124900,125200,38219,131581,107331
805.721924,2,7139,7093,46,-46,124900,125200,35337,-651737,-663237
805.721924,3,1074,982,92,-92,124900,125200,31707,227093,204093
805.721924,4,120,50,70,-70,124900,125200,-2139,-30461,-47961
805.721924,5,4945,4879,66,-66,124900,125200,16432,-393132,-409632
805.721924,6,0,0,0,0,124900,125200,0,0,0
806.036006,0,906,806,100,-100,124900,125200,42938,328462,303462
806.036006,1,808,711,97,-97,124900,125200,38219,131581,107331
806.036006,2,7149,7093,56,-56,124900,125200,35587,-647987,-661987
806.036006,3,1074,982,92,-92,124900,125200,31707,227093,204093
806.036006,4,120,50,70,-70,124900,125200,-2139,-30461,-47961
806.036006,5,4945,4889,56,-56,124900,125200,16307,-399007,-413007
806.036006,6,0,0,0,0,124900,125200,0,0,0
806.275502,0,906,806,100,-100,124900,125200,42938,328462,303462
806.275502,1,808,711,97,-97,124900,125200,38219,131581,107331
806.275502,2,7149,7093,56,-56,124900,125200,35587,-647987,-661987
806.275502,3,1074,982,92,-92,124900,125200,31707,227093,204093
806.275502,4,120,50,70,-70,124900,125200,-2139,-30461,-47961
806.275502,5,4945,4889,56,-56,124900,125200,16307,-399007,-413007
806.275502,6,0,0,0,0,124900,125200,0,0,0
806.487837,0,906,806,100,-100,124900,125200,42938,328462,303462
806.487837,1,808,711,97,-97,124900,125200,38219,131581,107331
806.487837,2,7149,7093,56,-56,124900,125200,35587,-647987,-661987
806.487837,3,1074,982,92,-92,124900,125200,31707,227093,204093
806.487837,4,120,50,70,-70,124900,125200,-2139,-30461,-47961
806.487837,5,4945,4889,56,-56,124900,125200,16307,-399007,-413007
806.487837,6,0,0,0,0,124900,125200,0,0,0
806.711683,0,906,806,100,-100,124900,125200,42938,328462,303462
806.711683,1,808,711,97,-97,124900,125200,38219,131581,107331
806.711683,2,7149,7093,56,-56,124900,125200,35587,-647987,-661987
806.711683,3,1074,982,92,-92,124900,125200,31707,227093,204093
806.711683,4,120,50,70,-70,124900,125200,-2139,-30461,-47961
806.711683,5,4945,4889,56,-56,124900,125200,16307,-399007,-413007
806.711683,6,0,0,0,0,124900,125200,0,0,0
806.977868,0,906,806,100,-100,124900,125200,42938,328462,303462
806.977868,1,808,711,97,-97,124900,125200,38219,131581,107331
806.977868,2,7149,7093,56,-56,124900,125200,35587,-647987,-661987
806.977868,3,1074,982,92,-92,124900,125200,31707,227093,204093
806.977868,4,120,50,70,-70,124900,125200,-2139,-30461,-47961
806.977868,5,4945,4889,56,-56,124900,125200,16307,-399007,-413007
806.977868,6,0,0,0,0,124900,125200,0,0,0
807.207592,0,906,806,100,-100,125300,125800,42938,328462,303262
807.207592,1,808,711,97,-97,125300,125800,38219,131581,107137
807.207592,2,7149,7103,46,-46,125300,125800,35462,-653862,-665454
807.207592,3,1074,982,92,-92,125300,125800,31707,227093,203909
807.207592,4,120,50,70,-70,125300,125800,-2139,-30461,-48101
807.207592,5,4945,4889,56,-56,125300,125800,16307,-399007,-413119
807.207592,6,0,0,0,0,125300,125800,0,0,0
807.457218,0,906,806,100,-100,125300,125900,42938,328462,303262
807.457218,1,808,711,97,-97,125300,125900,38219,131581,107137
807.457218,2,7149,7103,46,-46,125300,125900,35462,-653862,-665454
807.457218,3,1074,982,92,-92,125300,125900,31707,227093,203909
807.457218,4,120,50,70,-70,125300,125900,-2139,-30461,-48101
807.457218,5,4945,4889,56,-56,125300,125900,16307,-399007,-413119
807.457218,6,0,0,0,0,125300,125900,0,0,0
807.730417,0,906,806,100,-100,125300,125800,42938,328462,303262
807.730417,1,808,711,97,-97,125300,125800,38219,131581,107137
807.730417,2,7149,7103,46,-46,125300,125800,35462,-653862,-665454
807.730417,3,1074,982,92,-92,125300,125800,31707,227093,203909
807.730417,4,120,50,70,-70,125300,125800,-2139,-30461,-48101
807.730417,5,4945,4889,56,-56,125300,125800,16307,-399007,-413119
807.730417,6,0,0,0,0,125300,125800,0,0,0
808.049821,0,906,806,100,-100,125300,125800,42938,328462,303262
808.049821,1,808,711,97,-97,125300,125800,38219,131581,107137
808.049821,2,7159,7103,56,-56,125300,125800,35713,-649113,-663225
808.049821,3,1074,982,92,-92,125300,125800,31707,227093,203909
808.049821,4,120,50,70,-70,125300,125800,-2139,-30461,-48101
808.049821,5,4945,4889,56,-56,125300,125800,16307,-399007,-413119
808.049821,6,0,0,0,0,125300,125800,0,0,0
808.206612,0,906,806,100,-100,125300,125800,42938,328462,303262
808.206612,1,808,711,97,-97,125300,125800,38219,131581,107137
808.206612,2,7159,7103,56,-56,125300,125800,35713,-649113,-663225
808.206612,3,1074,982,92,-92,125300,125800,31707,227093,203909
808.206612,4,120,50,70,-70,125300,125800,-2139,-30461,-48101
808.206612,5,4945,4889,56,-56,125300,125800,16307,-399007,-413119
808.206612,6,0,0,0,0,125300,125800,0,0,0
808.477973,0,906,806,100,-100,125300,125800,42938,328462,303262
808.477973,1,808,711,97,-97,125300,125800,38219,131581,107137
808.477973,2,7159,7103,56,-56,125300,125800,35713,-649113,-663225
808.477973,3,1074,982,92,-92,125300,125800,31707,227093,203909
808.477973,4,120,50,70,-70,125300,125800,-2139,-30461,-48101
808.477973,5,4945,4889,56,-56,125300,125800,16307,-399007,-413119
808.477973,6,0,0,0,0,125300,125800,0,0,0
808.734092,0,906,806,100,-100,125300,125800,42938,328462,303262
808.734092,1,808,711,97,-97,125300,125800,38219,131581,107137
808.734092,2,7159,7103,56,-56,125300,125800,35713,-649113,-663225
808.734092,3,1074,982,92,-92,125300,125800,31707,227093,203909
808.734092,4,120,50,70,-70,125300,125800,-2139,-30461,-48101
808.734092,5,4945,4889,56,-56,125300,125800,16307,-399007,-413119
808.734092,6,0,0,0,0,125300,125800,0,0,0
809.010843,0,906,806,100,-100,125100,125800,42938,328462,303262
809.010843,1,808,711,97,-97,125100,125800,38219,131581,107137
809.010843,2,7159,7113,46,-46,125100,125800,35588,-654988,-666580
809.010843,3,1074,982,92,-92,125100,125800,31707,227093,203909
809.010843,4,120,50,70,-70,125100,125800,-2139,-30461,-48101
809.010843,5,4945,4889,56,-56,125100,125800,16307,-399007,-413119
809.010843,6,0,0,0,0,125100,125800,0,0,0
809.207186,0,906,806,100,-100,125100,125800,42938,328462,303262
809.207186,1,808,711,97,-97,125100,125800,38219,131581,107137
809.207186,2,7159,7113,46,-46,125100,125800,35588,-654988,-666580
809.207186,3,1074,982,92,-92,125100,125800,31707,227093,203909
809.207186,4,120,50,70,-70,125100,125800,-2139,-30461,-48101
809.207186,5,4945,4889,56,-56,125100,125800,16307,-399007,-413119
809.207186,6,0,0,0,0,125100,125800,0,0,0
809.504333,0,906,806,100,-100,125200,125800,42938,328462,303262
809.504333,1,808,711,97,-97,125200,125800,38219,131581,107137
809.504333,2,7169,7113,56,-56,125200,125800,35463,-651863,-665975
809.504333,3,1074,982,92,-92,125200,125800,31707,227093,203909
809.504333,4,120,50,70,-70,125200,125800,-2139,-30461,-48101
809.504333,5,4945,4889,56,-56,125200,125800,16307,-399007,-413119
809.504333,6,0,0,0,0,125200,125800,0,0,0
809.709824,0,906,806,100,-100,125200,125800,42938,328462,303262
809.709824,1,808,711,97,-97,125200,125800,38219,131581,107137
809.709824,2,7169,7113,56,-56,125200,125800,35463,-651863,-665975
809.709824,3,1074,982,92,-92,125200,125800,31707,227093,203909
809.709824,4,120,50,70,-70,125200,125800,-2139,-30461,-48101
809.709824,5,4945,4889,56,-56,125200,125800,16307,-399007,-413119
809.709824,6,0,0,0,0,125200,125800,0,0,0
809.987112,0,906,806,100,-100,125400,125900,42938,328462,303262
809.987112,1,808,711,97,-97,125400,125900,38219,131581,107137
809.987112,2,7169,7113,56,-56,125400,125900,35463,-651863,-665975
809.987112,3,1074,982,92,-92,125400,125900,31707,227093,203909
809.987112,4,120,50,70,-70,125400,125900,-2139,-30461,-48101
809.987112,5,4945,4889,56,-56,125400,125900,16307,-399007,-413119
809.987112,6,0,0,0,0,125400,125900,0,0,0
810.220549,0,906,806,100,-100,125400,125900,42938,328462,303262
810.220549,1,808,711,97,-97,125400,125900,38219,131581,107137
810.220549,2,7169,7113,56,-56,125400,125900,35463,-651863,-665975
810.220549,3,1074,982,92,-92,125400,125900,31707,227093,203909
810.220549,4,120,50,70,-70,125400,125900,-2139,-30461,-48101
810.220549,5,4945,4889,56,-56,125400,125900,16307,-399007,-413119
810.220549,6,0,0,0,0,125400,125900,0,0,0
810.537052,0,906,806,100,-100,125400,125800,42938,328462,303262
810.537052,1,808,711,97,-97,125400,125800,38219,131581,107137
810.537052,2,7169,7113,56,-56,125400,125800,35463,-651863,-665975
810.537052,3,1074,982,92,-92,125400,125800,31707,227093,203909
810.537052,4,120,50,70,-70,125400,125800,-2139,-30461,-48101
810.537052,5,4945,4889,56,-56,125400,125800,16307,-399007,-413119
810.537052,6,0,0,0,0,125400,125800,0,0,0
810.701779,0,906,806,100,-100,125400,125800,42938,328462,303262
810.701779,1,808,711,97,-97,125400,125800,38219,131581,107137
810.701779,2,7169,7113,56,-56,125400,125800,35463,-651863,-665975
810.701779,3,1074,982,92,-92,125400,125800,31707,227093,203909
810.701779,4,120,50,70,-70,125400,125800,-2139,-30461,-48101
810.701779,5,4945,4889,56,-56,125400,125800,16307,-399007,-413119
810.701779,6,0,0,0,0,125400,125800,0,0,0
811.008193,0,906,806,100,-100,125400,125700,42938,328462,303362
811.008193,1,808,711,97,-97,125400,125700,38219,131581,107234
811.008193,2,7169,7113,56,-56,125400,125700,35463,-651863,-665919
811.008193,3,1074,982,92,-92,125400,125700,31707,227093,204001
811.008193,4,120,50,70,-70,125400,125700,-2139,-30461,-48031
811.008193,5,4945,4889,56,-56,125400,125700,16307,-399007,-413063
811.008193,6,0,0,0,0,125400,125700,0,0,0
811.277802,0,906,806,100,-100,125400,125700,42938,328462,303362
811.277802,1,808,711,97,-97,125400,125700,38219,131581,107234
811.277802,2,7169,7123,46,-46,125400,125700,35713,-657113,-668659
811.277802,3,1074,982,92,-92,125400,125700,31707,227093,204001
811.277802,4,120,50,70,-70,125400,125700,-2139,-30461,-48031
811.277802,5,4945,4889,56,-56,125400,125700,16307,-399007,-413063
811.277802,6,0,0,0,0,125400,125700,0,0,0
811.525777,0,906,806,100,-100,125400,125700,42938,328462,303362
811.525777,1,808,711,97,-97,125400,125700,38219,131581,107234
811.525777,2,7169,7123,46,-46,125400,125700,35713,-657113,-668659
811.525777,3,1074,982,92,-92,125400,125700,31707,227093,204001
811.525777,4,120,50,70,-70,125400,125700,-2139,-30461,-48031
811.525777,5,4945,4889,56,-56,125400,125700,16307,-399007,-413063
811.525777,6,0,0,0,0,125400,125700,0,0,0
811.73259,0,906,806,100,-100,125400,125700,42938,328462,303362
811.73259,1,808,711,97,-97,125400,125700,38219,131581,107234
811.73259,2,7169,7123,46,-46,125400,125700,35713,-657113,-668659
811.73259,3,1074,982,92,-92,125400,125700,31707,227093,204001
811.73259,4,120,50,70,-70,125400,125700,-2139,-30461,-48031
811.73259,5,4945,4889,56,-56,125400,125700,16307,-399007,-413063
811.73259,6,0,0,0,0,125400,125700,0,0,0
812.023063,0,906,806,100,-100,125400,125700,42938,328462,303362
812.023063,1,808,711,97,-97,125400,125700,38219,131581,107234
812.023063,2,7169,7123,46,-46,125400,125700,35713,-657113,-668659
812.023063,3,1074,982,92,-92,125400,125700,31707,227093,204001
812.023063,4,120,50,70,-70,125400,125700,-2139,-30461,-48031
812.023063,5,4945,4889,56,-56,125400,125700,16307,-399007,-413063
812.023063,6,0,0,0,0,125400,125700,0,0,0
812.220589,0,906,806,100,-100,125400,125700,42938,328462,303362
812.220589,1,808,711,97,-97,125400,125700,38219,131581,107234
812.220589,2,7169,7123,46,-46,125400,125700,35713,-657113,-668659
812.220589,3,1074,982,92,-92,125400,125700,31707,227093,204001
812.220589,4,120,50,70,-70,125400,125700,-2139,-30461,-48031
812.220589,5,4945,4899,46,-46,125400,125700,16182,-403882,-415428
812.220589,6,0,0,0,0,125400,125700,0,0,0
812.505032,0,906,806,100,-100,125400,125700,42938,328462,303362
812.505032,1,808,711,97,-97,125400,125700,38219,131581,107234
812.505032,2,7169,7123,46,-46,125400,125700,35713,-657113,-668659
812.505032,3,1074,982,92,-92,125400,125700,31707,227093,204001
812.505032,4,120,50,70,-70,125400,125700,-2139,-30461,-48031
812.505032,5,4945,4899,46,-46,125400,125700,16182,-403882,-415428
812.505032,6,0,0,0,0,125400,125700,0,0,0
812.704883,0,906,806,100,-100,125100,125700,42938,328462,303362
812.704883,1,808,711,97,-97,125100,125700,38219,131581,107234
812.704883,2,7179,7123,56,-56,125100,125700,35588,-652988,-667044
812.704883,3,1074,982,92,-92,125100,125700,31707,227093,204001
812.704883,4,120,50,70,-70,125100,125700,-2139,-30461,-48031
812.704883,5,4955,4899,56,-56,125100,125700,16057,-398757,-412813
812.704883,6,0,0,0,0,125100,125700,0,0,0
812.977026,0,906,806,100,-100,125100,125700,42938,328462,303362
812.977026,1,808,711,97,-97,125100,125700,38219,131581,107234
812.977026,2,7179,7123,56,-56,125100,125700,35588,-652988,-667044
812.977026,3,1074,982,92,-92,125100,125700,31707,227093,204001
812.977026,4,120,50,70,-70,125100,125700,-2139,-30461,-48031
812.977026,5,4955,4899,56,-56,125100,125700,16057,-398757,-412813
812.977026,6,0,0,0,0,125100,125700,0,0,0
813.275258,0,906,806,100,-100,125100,125700,42938,328462,303362
813.275258,1,808,711,97,-97,125100,125700,38219,131581,107234
813.275258,2,7179,7123,56,-56,125100,125700,35588,-652988,-667044
813.275258,3,1074,982,92,-92,125100,125700,31707,227093,204001
813.275258,4,120,50,70,-70,125100,125700,-2139,-30461,-48031
813.275258,5,4955,4899,56,-56,125100,125700,16057,-398757,-412813
813.275258,6,0,0,0,0,125100,125700,0,0,0
813.489629,0,906,806,100,-100,125000,125700,42938,328462,303362
813.489629,1,808,711,97,-97,125000,125700,38219,131581,107234
813.489629,2,7179,7133,46,-46,125000,125700,35838,-658238,-669784
813.489629,3,1074,982,92,-92,125000,125700,31707,227093,204001
813.489629,4,120,50,70,-70,125000,125700,-2139,-30461,-48031
813.489629,5,4955,4899,56,-56,125000,125700,16057,-398757,-412813
813.489629,6,0,0,0,0,125000,125700,0,0,0
813.75966,0,906,806,100,-100,125000,125700,42938,328462,303362
813.75966,1,808,711,97,-97,125000,125700,38219,131581,107234
813.75966,2,7179,7133,46,-46,125000,125700,35838,-658238,-669784
813.75966,3,1074,982,92,-92,125000,125700,31707,227093,204001
813.75966,4,120,50,70,-70,125000,125700,-2139,-30461,-48031
813.75966,5,4955,4899,56,-56,125000,125700,16057,-398757,-412813
813.75966,6,0,0,0,0,125000,125700,0,0,0
813.962009,0,906,806,100,-100,125000,125700,42938,328462,303362
813.962009,1,808,711,97,-97,125000,125700,38219,131581,107234
813.962009,2,7189,7133,56,-56,125000,125700,35713,-654113,-668169
813.962009,3,1074,982,92,-92,125000,125700,31707,227093,204001
813.962009,4,120,50,70,-70,125000,125700,-2139,-30461,-48031
813.962009,5,4957,4909,48,-48,125000,125700,16282,-404182,-416230
813.962009,6,0,0,0,0,125000,125700,0,0,0
814.214438,0,906,806,100,-100,125000,125500,42938,328462,303362
814.214438,1,808,711,97,-97,125000,125500,38219,131581,107234
814.214438,2,7189,7133,56,-56,125000,125500,35713,-654113,-668169
814.214438,3,1074,982,92,-92,125000,125500,31707,227093,204001
814.214438,4,120,50,70,-70,125000,125500,-2139,-30461,-48031
814.214438,5,4957,4909,48,-48,125000,125500,16282,-404182,-416230
814.214438,6,0,0,0,0,125000,125500,0,0,0
814.534862,0,906,806,100,-100,125000,125500,42938,328462,303362
814.534862,1,808,711,97,-97,125000,125500,38219,131581,107234
814.534862,2,7189,7141,48,-48,125000,125500,35913,-658313,-670361
814.534862,3,1074,982,92,-92,125000,125500,31707,227093,204001
814.534862,4,120,50,70,-70,125000,125500,-2139,-30461,-48031
814.534862,5,4965,4909,56,-56,125000,125500,16182,-400882,-414938
814.534862,6,0,0,0,0,125000,125500,0,0,0
814.722609,0,906,806,100,-100,125000,125500,42938,328462,303362
814.722609,1,808,711,97,-97,125000,125500,38219,131581,107234
814.722609,2,7189,7141,48,-48,125000,125500,35913,-658313,-670361
814.722609,3,1074,982,92,-92,125000,125500,31707,227093,204001
814.722609,4,120,50,70,-70,125000,125500,-2139,-30461,-48031
814.722609,5,4965,4909,56,-56,125000,125500,16182,-400882,-414938
814.722609,6,0,0,0,0,125000,125500,0,0,0
814.981838,0,906,806,100,-100,125000,125400,42938,328462,303362
814.981838,1,808,711,97,-97,125000,125400,38219,131581,107234
814.981838,2,7189,7141,48,-48,125000,125400,35913,-658313,-670361
814.981838,3,1074,982,92,-92,125000,125400,31707,227093,204001
814.981838,4,120,50,70,-70,125000,125400,-2139,-30461,-48031
814.981838,5,4965,4909,56,-56,125000,125400,16182,-400882,-414938
814.981838,6,0,0,0,0,125000,125400,0,0,0
815.251308,0,906,806,100,-100,125000,125400,42938,328462,303362
815.251308,1,808,711,97,-97,125000,125400,38219,131581,107234
815.251308,2,7189,7141,48,-48,125000,125400,35913,-658313,-670361
815.251308,3,1074,982,92,-92,125000,125400,31707,227093,204001
815.251308,4,120,50,70,-70,125000,125400,-2139,-30461,-48031
815.251308,5,4965,4909,56,-56,125000,125400,16182,-400882,-414938
815.251308,6,0,0,0,0,125000,125400,0,0,0
815.471391,0,906,806,100,-100,125000,125400,42938,328462,303362
815.471391,1,808,711,97,-97,125000,125400,38219,131581,107234
815.471391,2,7189,7141,48,-48,125000,125400,35913,-658313,-670361
815.471391,3,1074,982,92,-92,125000,125400,31707,227093,204001
815.471391,4,120,50,70,-70,125000,125400,-2139,-30461,-48031
815.471391,5,4965,4909,56,-56,125000,125400,16182,-400882,-414938
815.471391,6,0,0,0,0,125000,125400,0,0,0
815.721713,0,906,806,100,-100,125000,125400,42938,328462,303362
815.721713,1,808,711,97,-97,125000,125400,38219,131581,107234
815.721713,2,7189,7141,48,-48,125000,125400,35913,-658313,-670361
815.721713,3,1074,982,92,-92,125000,125400,31707,227093,204001
815.721713,4,120,50,70,-70,125000,125400,-2139,-30461,-48031
815.721713,5,4965,4909,56,-56,125000,125400,16182,-400882,-414938
815.721713,6,0,0,0,0,125000,125400,0,0,0
815.963896,0,906,806,100,-100,125100,125800,42938,328462,303262
815.963896,1,808,711,97,-97,125100,125800,38219,131581,107137
815.963896,2,7189,7151,38,-38,125100,125800,35788,-667188,-676764
815.963896,3,1074,982,92,-92,125100,125800,31707,227093,203909
815.963896,4,120,50,70,-70,125100,125800,-2139,-30461,-48101
815.963896,5,4965,4909,56,-56,125100,125800,16182,-400882,-414994
815.963896,6,0,0,0,0,125100,125800,0,0,0
816.266751,0,906,806,100,-100,125400,125800,42938,328462,303262
816.266751,1,808,711,97,-97,125400,125800,38219,131581,107137
816.266751,2,7199,7151,48,-48,125400,125800,36039,-663439,-675535
816.266751,3,1074,982,92,-92,125400,125800,31707,227093,203909
816.266751,4,120,50,70,-70,125400,125800,-2139,-30461,-48101
816.266751,5,4965,4909,56,-56,125400,125800,16182,-400882,-414994
816.266751,6,0,0,0,0,125400,125800,0,0,0
816.457538,0,906,806,100,-100,125400,125800,42938,328462,303262
816.457538,1,808,711,97,-97,125400,125800,38219,131581,107137
816.457538,2,7209,7151,58,-58,125400,125800,36290,-659690,-674306
816.457538,3,1074,982,92,-92,125400,125800,31707,227093,203909
816.457538,4,120,50,70,-70,125400,125800,-2139,-30461,-48101
816.457538,5,4965,4909,56,-56,125400,125800,16182,-400882,-414994
816.457538,6,0,0,0,0,125400,125800,0,0,0
816.788465,0,906,806,100,-100,125300,125800,42938,328462,303262
816.788465,1,808,711,97,-97,125300,125800,38219,131581,107137
816.788465,2,7218,7151,67,-67,125300,125800,36177,-655077,-671961
816.788465,3,1074,982,92,-92,125300,125800,31707,227093,203909
816.788465,4,120,50,70,-70,125300,125800,-2139,-30461,-48101
816.788465,5,4965,4909,56,-56,125300,125800,16182,-400882,-414994
816.788465,6,0,0,0,0,125300,125800,0,0,0
816.975258,0,906,806,100,-100,125300,125800,42938,328462,303262
816.975258,1,808,711,97,-97,125300,125800,38219,131581,107137
816.975258,2,7218,7151,67,-67,125300,125800,36177,-655077,-671961
816.975258,3,1074,982,92,-92,125300,125800,31707,227093,203909
816.975258,4,120,50,70,-70,125300,125800,-2139,-30461,-48101
816.975258,5,4965,4909,56,-56,125300,125800,16182,-400882,-414994
816.975258,6,0,0,0,0,125300,125800,0,0,0
817.230074,0,906,806,100,-100,125500,126000,42938,328462,303262
817.230074,1,808,711,97,-97,125500,126000,38219,131581,107137
817.230074,2,7218,7161,57,-57,125500,126000,36052,-662952,-677316
817.230074,3,1074,982,92,-92,125500,126000,31707,227093,203909
817.230074,4,120,50,70,-70,125500,126000,-2139,-30461,-48101
817.230074,5,4965,4909,56,-56,125500,126000,16182,-400882,-414994
817.230074,6,0,0,0,0,125500,126000,0,0,0
817.455257,0,906,806,100,-100,125500,126100,42938,328462,303262
817.455257,1,808,711,97,-97,125500,126100,38219,131581,107137
817.455257,2,7218,7161,57,-57,125500,126100,36052,-662952,-677316
817.455257,3,1074,982,92,-92,125500,126100,31707,227093,203909
817.455257,4,120,50,70,-70,125500,126100,-2139,-30461,-48101
817.455257,5,4965,4909,56,-56,125500,126100,16182,-400882,-414994
817.455257,6,0,0,0,0,125500,126100,0,0,0
817.710176,0,906,806,100,-100,125500,126000,42938,328462,303262
817.710176,1,808,711,97,-97,125500,126000,38219,131581,107137
817.710176,2,7218,7161,57,-57,125500,126000,36052,-662952,-677316
817.710176,3,1074,982,92,-92,125500,126000,31707,227093,203909
817.710176,4,120,50,70,-70,125500,126000,-2139,-30461,-48101
817.710176,5,4965,4909,56,-56,125500,126000,16182,-400882,-414994
817.710176,6,0,0,0,0,125500,126000,0,0,0
818.036084,0,906,806,100,-100,125600,125900,42938,328462,303262
818.036084,1,808,711,97,-97,125600,125900,38219,131581,107137
818.036084,2,7218,7161,57,-57,125600,125900,36052,-662952,-677316
818.036084,3,1074,982,92,-92,125600,125900,31707,227093,203909
818.036084,4,120,50,70,-70,125600,125900,-2139,-30461,-48101
818.036084,5,4965,4909,56,-56,125600,125900,16182,-400882,-414994
818.036084,6,0,0,0,0,125600,125900,0,0,0
818.2446,0,906,806,100,-100,125600,125900,42938,328462,303262
818.2446,1,808,711,97,-97,125600,125900,38219,131581,107137
818.2446,2,7228,7171,57,-57,125600,125900,36178,-664078,-678442
818.2446,3,1074,982,92,-92,125600,125900,31707,227093,203909
818.2446,4,120,50,70,-70,125600,125900,-2139,-30461,-48101
818.2446,5,4975,4919,56,-56,125600,125900,16308,-404008,-418120
818.2446,6,0,0,0,0,125600,125900,0,0,0
818.500116,0,906,806,100,-100,125200,125900,42938,328462,303262
818.500116,1,808,711,97,-97,125200,125900,38219,131581,107137
818.500116,2,7238,7181,57,-57,125200,125900,35928,-663828,-678192
818.500116,3,1074,982,92,-92,125200,125900,31707,227093,203909
818.500116,4,120,50,70,-70,125200,125900,-2139,-30461,-48101
818.500116,5,4985,4919,66,-66,125200,125900,16183,-399883,-416515
818.500116,6,0,0,0,0,125200,125900,0,0,0
818.746706,0,906,806,100,-100,125200,125900,42938,328462,303262
818.746706,1,808,711,97,-97,125200,125900,38219,131581,107137
818.746706,2,7238,7181,57,-57,125200,125900,35928,-663828,-678192
818.746706,3,1074,982,92,-92,125200,125900,31707,227093,203909
818.746706,4,120,50,70,-70,125200,125900,-2139,-30461,-48101
818.746706,5,4985,4919,66,-66,125200,125900,16183,-399883,-416515
818.746706,6,0,0,0,0,125200,125900,0,0,0
818.985827,0,906,806,100,-100,125200,125900,42938,328462,303262
818.985827,1,808,711,97,-97,125200,125900,38219,131581,107137
818.985827,2,7238,7181,57,-57,125200,125900,35928,-663828,-678192
818.985827,3,1074,982,92,-92,125200,125900,31707,227093,203909
818.985827,4,120,50,70,-70,125200,125900,-2139,-30461,-48101
818.985827,5,4985,4919,66,-66,125200,125900,16183,-399883,-416515
818.985827,6,0,0,0,0,125200,125900,0,0,0
819.232415,0,906,806,100,-100,125200,125900,42938,328462,303262
819.232415,1,808,711,97,-97,125200,125900,38219,131581,107137
819.232415,2,7238,7181,57,-57,125200,125900,35928,-663828,-678192
819.232415,3,1074,982,92,-92,125200,125900,31707,227093,203909
819.232415,4,120,50,70,-70,125200,125900,-2139,-30461,-48101
819.232415,5,4985,4919,66,-66,125200,125900,16183,-399883,-416515
819.232415,6,0,0,0,0,125200,125900,0,0,0
819.500109,0,906,806,100,-100,125200,125900,42938,328462,303262
819.500109,1,808,711,97,-97,125200,125900,38219,131581,107137
819.500109,2,7238,7181,57,-57,125200,125900,35928,-663828,-678192
819.500109,3,1074,982,92,-92,125200,125900,31707,227093,203909
819.500109,4,120,50,70,-70,125200,125900,-2139,-30461,-48101
819.500109,5,4985,4919,66,-66,125200,125900,16183,-399883,-416515
819.500109,6,0,0,0,0,125200,125900,0,0,0
819.750801,0,906,806,100,-100,125500,125900,42938,328462,303262
819.750801,1,808,711,97,-97,125500,125900,38219,131581,107137
819.750801,2,7248,7181,67,-67,125500,125900,36179,-659079,-675963
819.750801,3,1074,982,92,-92,125500,125900,31707,227093,203909
819.750801,4,120,50,70,-70,125500,125900,-2139,-30461,-48101
819.750801,5,4985,4929,56,-56,125500,125900,16057,-405757,-419869
819.750801,6,0,0,0,0,125500,125900,0,0,0
820.001431,0,906,806,100,-100,125600,125900,42938,328462,303262
820.001431,1,808,711,97,-97,125600,125900,38219,131581,107137
820.001431,2,7248,7181,67,-67,125600,125900,36179,-659079,-675963
820.001431,3,1074,982,92,-92,125600,125900,31707,227093,203909
820.001431,4,120,50,70,-70,125600,125900,-2139,-30461,-48101
820.001431,5,4985,4929,56,-56,125600,125900,16057,-405757,-419869
820.001431,6,0,0,0,0,125600,125900,0,0,0
820.22977,0,906,806,100,-100,125800,126500,42938,328462,303162
820.22977,1,808,711,97,-97,125800,126500,38219,131581,107040
820.22977,2,7248,7191,57,-57,125800,126500,36053,-666953,-681374
820.22977,3,1074,982,92,-92,125800,126500,31707,227093,203817
820.22977,4,120,50,70,-70,125800,126500,-2139,-30461,-48171
820.22977,5,4985,4929,56,-56,125800,126500,16057,-405757,-419925
820.22977,6,0,0,0,0,125800,126500,0,0,0
820.548371,0,906,806,100,-100,126000,126600,42938,328462,303162
820.548371,1,808,711,97,-97,126000,126600,38219,131581,107040
820.548371,2,7258,7191,67,-67,126000,126600,36305,-662205,-679156
820.548371,3,1074,982,92,-92,126000,126600,31707,227093,203817
820.548371,4,120,50,70,-70,126000,126600,-2139,-30461,-48171
820.548371,5,4995,4929,66,-66,126000,126600,16309,-401009,-417707
820.548371,6,0,0,0,0,126000,126600,0,0,0
820.773309,0,906,806,100,-100,126400,126600,42938,328462,308462
820.773309,1,808,711,97,-97,126400,126600,38219,131581,112181
820.773309,2,7268,7191,77,-77,126400,126600,36557,-652457,-667857
820.773309,3,1074,982,92,-92,126400,126600,31707,227093,208693
820.773309,4,120,50,70,-70,126400,126600,-2139,-30461,-44461
820.773309,5,5005,4929,76,-76,126400,126600,16561,-391261,-406461
820.773309,6,0,0,0,0,126400,126600,0,0,0
821.039885,0,906,806,100,-100,126700,126600,42938,328462,338462
821.039885,1,808,711,97,-97,126700,126600,38219,131581,141281
821.039885,2,7268,7201,67,-67,126700,126600,36810,-659710,-653010
821.039885,3,1074,982,92,-92,126700,126600,31707,227093,236293
821.039885,4,120,50,70,-70,126700,126600,-2139,-30461,-23461
821.039885,5,5005,4939,66,-66,126700,126600,16435,-400135,-393535
821.039885,6,0,0,0,0,126700,126600,0,0,0
821.29496,0,906,806,100,-100,126700,127100,42938,328462,303062
821.29496,1,808,711,97,-97,126700,127100,38219,131581,106943
821.29496,2,7268,7201,67,-67,126700,127100,36810,-659710,-676728
821.29496,3,1074,982,92,-92,126700,127100,31707,227093,203725
821.29496,4,120,50,70,-70,126700,127100,-2139,-30461,-48241
821.29496,5,5005,4939,66,-66,126700,127100,16435,-400135,-416899
821.29496,6,0,0,0,0,126700,127100,0,0,0
821.496792,0,906,806,100,-100,126600,127200,42938,328462,303062
821.496792,1,808,711,97,-97,126600,127200,38219,131581,106943
821.496792,2,7268,7211,57,-57,126600,127200,37063,-666963,-681441
821.496792,3,1074,982,92,-92,126600,127200,31707,227093,203725
821.496792,4,120,50,70,-70,126600,127200,-2139,-30461,-48241
821.496792,5,5005,4939,66,-66,126600,127200,16435,-400135,-416899
821.496792,6,0,0,0,0,126600,127200,0,0,0
821.781438,0,906,806,100,-100,126700,127200,42938,328462,303062
821.781438,1,808,711,97,-97,126700,127200,38219,131581,106943
821.781438,2,7268,7221,47,-47,126700,127200,36936,-669836,-681774
821.781438,3,1074,982,92,-92,126700,127200,31707,227093,203725
821.781438,4,120,50,70,-70,126700,127200,-2139,-30461,-48241
821.781438,5,5005,4949,56,-56,126700,127200,16688,-405388,-419612
821.781438,6,0,0,0,0,126700,127200,0,0,0
821.993391,0,906,806,100,-100,126800,126800,42938,328462,328462
821.993391,1,808,711,97,-97,126800,126800,38219,131581,131581
821.993391,2,7268,7231,37,-37,126800,126800,37190,-672090,-672090
821.993391,3,1074,982,92,-92,126800,126800,31707,227093,227093
821.993391,4,120,50,70,-70,126800,126800,-2139,-30461,-30461
821.993391,5,5005,4949,56,-56,126800,126800,16688,-405388,-405388
821.993391,6,0,0,0,0,126800,126800,0,0,0
822.299612,0,906,806,100,-100,126300,126700,42938,328462,303162
822.299612,1,808,711,97,-97,126300,126700,38219,131581,107040
822.299612,2,7273,7241,32,-32,126300,126700,37381,-670781,-678877
822.299612,3,1074,989,85,-85,126300,126700,31884,224416,202911
822.299612,4,120,50,70,-70,126300,126700,-2139,-30461,-48171
822.299612,5,5005,4949,56,-56,126300,126700,16688,-405388,-419556
822.299612,6,0,0,0,0,126300,126700,0,0,0
822.484065,0,906,806,100,-100,126300,126900,42938,328462,303062
822.484065,1,808,711,97,-97,126300,126900,38219,131581,106943
822.484065,2,7273,7241,32,-32,126300,126900,37381,-670781,-678909
822.484065,3,1074,989,85,-85,126300,126900,31884,224416,202826
822.484065,4,120,50,70,-70,126300,126900,-2139,-30461,-48241
822.484065,5,5005,4949,56,-56,126300,126900,16688,-405388,-419612
822.484065,6,0,0,0,0,126300,126900,0,0,0
822.710015,0,906,806,100,-100,126600,126900,42938,328462,303062
822.710015,1,808,711,97,-97,126600,126900,38219,131581,106943
822.710015,2,7281,7247,34,-34,126600,126900,37318,-669318,-677954
822.710015,3,1076,989,87,-87,126600,126900,31859,225241,203143
822.710015,4,120,50,70,-70,126600,126900,-2139,-30461,-48241
822.710015,5,5005,4959,46,-46,126600,126900,16827,-411527,-423211
822.710015,6,0,0,0,0,126600,126900,0,0,0
823.005038,0,906,806,100,-100,126600,126900,42938,328462,303062
823.005038,1,808,711,97,-97,126600,126900,38219,131581,106943
823.005038,2,7281,7247,34,-34,126600,126900,37318,-669318,-677954
823.005038,3,1076,989,87,-87,126600,126900,31859,225241,203143
823.005038,4,120,50,70,-70,126600,126900,-2139,-30461,-48241
823.005038,5,5005,4959,46,-46,126600,126900,16827,-411527,-423211
823.005038,6,0,0,0,0,126600,126900,0,0,0
823.233567,0,906,806,100,-100,126600,126900,42938,328462,303062
823.233567,1,808,711,97,-97,126600,126900,38219,131581,106943
823.233567,2,7291,7247,44,-44,126600,126900,37571,-665571,-676747
823.233567,3,1080,989,91,-91,126600,126900,31961,226739,203625
823.233567,4,120,50,70,-70,126600,126900,-2139,-30461,-48241
823.233567,5,5005,4959,46,-46,126600,126900,16827,-411527,-423211
823.233567,6,0,0,0,0,126600,126900,0,0,0
823.45427,0,906,806,100,-100,126600,127200,42938,328462,303062
823.45427,1,808,711,97,-97,126600,127200,38219,131581,106943
823.45427,2,7301,7247,54,-54,126600,127200,37824,-661824,-675540
823.45427,3,1080,989,91,-91,126600,127200,31961,226739,203625
823.45427,4,120,50,70,-70,126600,127200,-2139,-30461,-48241
823.45427,5,5005,4959,46,-46,126600,127200,16827,-411527,-423211
823.45427,6,0,0,0,0,126600,127200,0,0,0
823.709457,0,906,806,100,-100,126900,127200,42938,328462,303062
823.709457,1,808,711,97,-97,126900,127200,38219,131581,106943
823.709457,2,7301,7257,44,-44,126900,127200,37698,-666898,-678074
823.709457,3,1082,989,93,-93,126900,127200,32012,227288,203666
823.709457,4,120,50,70,-70,126900,127200,-2139,-30461,-48241
823.709457,5,5005,4959,46,-46,126900,127200,16827,-411527,-423211
823.709457,6,0,0,0,0,126900,127200,0,0,0
824.013805,0,906,806,100,-100,126900,127200,42938,328462,303062
824.013805,1,808,711,97,-97,126900,127200,38219,131581,106943
824.013805,2,7301,7257,44,-44,126900,127200,37698,-666898,-678074
824.013805,3,1082,989,93,-93,126900,127200,32012,227288,203666
824.013805,4,120,50,70,-70,126900,127200,-2139,-30461,-48241
824.013805,5,5005,4959,46,-46,126900,127200,16827,-411527,-423211
824.013805,6,0,0,0,0,126900,127200,0,0,0
824.243327,0,906,806,100,-100,127200,127200,42938,328462,328462
824.243327,1,808,711,97,-97,127200,127200,38219,131581,131581
824.243327,2,7301,7267,34,-34,127200,127200,37571,-669771,-669771
824.243327,3,1082,989,93,-93,127200,127200,32012,227288,227288
824.243327,4,120,50,70,-70,127200,127200,-2139,-30461,-30461
824.243327,5,5005,4969,36,-36,127200,127200,16700,-413400,-413400
824.243327,6,0,0,0,0,127200,127200,0,0,0
824.509935,0,906,806,100,-100,127200,127300,42938,328462,318462
824.509935,1,808,711,97,-97,127200,127300,38219,131581,121881
824.509935,2,7301,7267,34,-34,127200,127300,37571,-669771,-673171
824.509935,3,1082,989,93,-93,127200,127300,32012,227288,217988
824.509935,4,120,50,70,-70,127200,127300,-2139,-30461,-37461
824.509935,5,5005,4969,36,-36,127200,127300,16700,-413400,-417000
824.509935,6,0,0,0,0,127200,127300,0,0,0
824.790996,0,906,806,100,-100,127200,127300,42938,328462,318462
824.790996,1,808,711,97,-97,127200,127300,38219,131581,121881
824.790996,2,7301,7267,34,-34,127200,127300,37571,-669771,-673171
824.790996,3,1082,989,93,-93,127200,127300,32012,227288,217988
824.790996,4,120,50,70,-70,127200,127300,-2139,-30461,-37461
824.790996,5,5005,4969,36,-36,127200,127300,16700,-413400,-417000
824.790996,6,0,0,0,0,127200,127300,0,0,0
824.950892,0,906,806,100,-100,127200,127200,42938,328462,328462
824.950892,1,808,711,97,-97,127200,127200,38219,131581,131581
824.950892,2,7301,7267,34,-34,127200,127200,37571,-669771,-669771
824.950892,3,1082,989,93,-93,127200,127200,32012,227288,227288
824.950892,4,120,50,70,-70,127200,127200,-2139,-30461,-30461
824.950892,5,5005,4969,36,-36,127200,127200,16700,-413400,-413400
824.950892,6,0,0,0,0,127200,127200,0,0,0
825.206122,0,906,806,100,-100,126800,127200,42938,328462,303062
825.206122,1,808,711,97,-97,126800,127200,38219,131581,106943
825.206122,2,7311,7267,44,-44,126800,127200,37444,-666644,-677820
825.206122,3,1082,989,93,-93,126800,127200,32012,227288,203666
825.206122,4,120,50,70,-70,126800,127200,-2139,-30461,-48241
825.206122,5,5005,4969,36,-36,126800,127200,16700,-413400,-422544
825.206122,6,0,0,0,0,126800,127200,0,0,0
825.479527,0,906,806,100,-100,126800,127100,42938,328462,303062
825.479527,1,808,711,97,-97,126800,127100,38219,131581,106943
825.479527,2,7311,7267,44,-44,126800,127100,37444,-666644,-677820
825.479527,3,1082,989,93,-93,126800,127100,32012,227288,203666
825.479527,4,120,50,70,-70,126800,127100,-2139,-30461,-48241
825.479527,5,5005,4969,36,-36,126800,127100,16700,-413400,-422544
825.479527,6,0,0,0,0,126800,127100,0,0,0
825.753044,0,906,806,100,-100,126700,126800,42938,328462,318462
825.753044,1,808,711,97,-97,126700,126800,38219,131581,121881
825.753044,2,7311,7277,34,-34,126700,126800,37697,-668897,-672297
825.753044,3,1082,989,93,-93,126700,126800,32012,227288,217988
825.753044,4,120,50,70,-70,126700,126800,-2139,-30461,-37461
825.753044,5,5015,4969,46,-46,126700,126800,16573,-413273,-417873
825.753044,6,0,0,0,0,126700,126800,0,0,0
826.044602,0,906,806,100,-100,126700,126700,42938,328462,328462
826.044602,1,808,711,97,-97,126700,126700,38219,131581,131581
826.044602,2,7311,7277,34,-34,126700,126700,37697,-668897,-668897
826.044602,3,1082,989,93,-93,126700,126700,32012,227288,227288
826.044602,4,120,50,70,-70,126700,126700,-2139,-30461,-30461
826.044602,5,5015,4969,46,-46,126700,126700,16573,-413273,-413273
826.044602,6,0,0,0,0,126700,126700,0,0,0
826.299733,0,906,806,100,-100,126700,126700,42938,328462,328462
826.299733,1,808,711,97,-97,126700,126700,38219,131581,131581
826.299733,2,7311,7277,34,-34,126700,126700,37697,-668897,-668897
826.299733,3,1082,989,93,-93,126700,126700,32012,227288,227288
826.299733,4,120,50,70,-70,126700,126700,-2139,-30461,-30461
826.299733,5,5015,4969,46,-46,126700,126700,16573,-413273,-413273
826.299733,6,0,0,0,0,126700,126700,0,0,0
826.518407,0,906,806,100,-100,126700,126600,42938,328462,338462
826.518407,1,808,711,97,-97,126700,126600,38219,131581,141281
826.518407,2,7311,7277,34,-34,126700,126600,37697,-668897,-665497
826.518407,3,1082,989,93,-93,126700,126600,32012,227288,236588
826.518407,4,120,50,70,-70,126700,126600,-2139,-30461,-23461
826.518407,5,5015,4969,46,-46,126700,126600,16573,-413273,-408673
826.518407,6,0,0,0,0,126700,126600,0,0,0
826.712387,0,906,806,100,-100,126700,126600,42938,328462,338462
826.712387,1,808,711,97,-97,126700,126600,38219,131581,141281
826.712387,2,7311,7277,34,-34,126700,126600,37697,-668897,-665497
826.712387,3,1082,989,93,-93,126700,126600,32012,227288,236588
826.712387,4,120,50,70,-70,126700,126600,-2139,-30461,-23461
826.712387,5,5015,4969,46,-46,126700,126600,16573,-413273,-408673
826.712387,6,0,0,0,0,126700,126600,0,0,0
827.03212,0,906,806,100,-100,126000,126500,42938,328462,303162
827.03212,1,808,711,97,-97,126000,126500,38219,131581,107040
827.03212,2,7321,7277,44,-44,126000,126500,37571,-665771,-676903
827.03212,3,1082,989,93,-93,126000,126500,32012,227288,203759
827.03212,4,120,50,70,-70,126000,126500,-2139,-30461,-48171
827.03212,5,5025,4969,56,-56,126000,126500,16447,-409147,-423315
827.03212,6,0,0,0,0,126000,126500,0,0,0
827.294692,0,906,806,100,-100,126000,126500,42938,328462,303162
827.294692,1,808,711,97,-97,126000,126500,38219,131581,107040
827.294692,2,7321,7277,44,-44,126000,126500,37571,-665771,-676903
827.294692,3,1082,989,93,-93,126000,126500,32012,227288,203759
827.294692,4,120,50,70,-70,126000,126500,-2139,-30461,-48171
827.294692,5,5025,4969,56,-56,126000,126500,16447,-409147,-423315
827.294692,6,0,0,0,0,126000,126500,0,0,0
827.540858,0,906,806,100,-100,126000,126400,42938,328462,303162
827.540858,1,808,711,97,-97,126000,126400,38219,131581,107040
827.540858,2,7321,7277,44,-44,126000,126400,37571,-665771,-676903
827.540858,3,1082,989,93,-93,126000,126400,32012,227288,203759
827.540858,4,120,50,70,-70,126000,126400,-2139,-30461,-48171
827.540858,5,5025,4969,56,-56,126000,126400,16447,-409147,-423315
827.540858,6,0,0,0,0,126000,126400,0,0,0
827.798374,0,906,806,100,-100,126000,126400,42938,328462,303162
827.798374,1,808,711,97,-97,126000,126400,38219,131581,107040
827.798374,2,7331,7277,54,-54,126000,126400,37445,-661645,-675307
827.798374,3,1082,989,93,-93,126000,126400,32012,227288,203759
827.798374,4,120,50,70,-70,126000,126400,-2139,-30461,-48171
827.798374,5,5032,4969,63,-63,126000,126400,16359,-406259,-422198
827.798374,6,0,0,0,0,126000,126400,0,0,0
827.960974,0,906,806,100,-100,126000,126400,42938,328462,303162
827.960974,1,808,711,97,-97,126000,126400,38219,131581,107040
827.960974,2,7331,7277,54,-54,126000,126400,37445,-661645,-675307
827.960974,3,1082,989,93,-93,126000,126400,32012,227288,203759
827.960974,4,120,50,70,-70,126000,126400,-2139,-30461,-48171
827.960974,5,5032,4969,63,-63,126000,126400,16359,-406259,-422198
827.960974,6,0,0,0,0,126000,126400,0,0,0
828.218763,0,906,806,100,-100,126000,126400,42938,328462,303162
828.218763,1,808,711,97,-97,126000,126400,38219,131581,107040
828.218763,2,7331,7277,54,-54,126000,126400,37445,-661645,-675307
828.218763,3,1082,989,93,-93,126000,126400,32012,227288,203759
828.218763,4,120,50,70,-70,126000,126400,-2139,-30461,-48171
828.218763,5,5032,4969,63,-63,126000,126400,16359,-406259,-422198
828.218763,6,0,0,0,0,126000,126400,0,0,0
828.525401,0,906,806,100,-100,126000,126400,42938,328462,303162
828.525401,1,808,711,97,-97,126000,126400,38219,131581,107040
828.525401,2,7331,7277,54,-54,126000,126400,37445,-661645,-675307
828.525401,3,1082,989,93,-93,126000,126400,32012,227288,203759
828.525401,4,120,50,70,-70,126000,126400,-2139,-30461,-48171
828.525401,5,5032,4969,63,-63,126000,126400,16359,-406259,-422198
828.525401,6,0,0,0,0,126000,126400,0,0,0
828.742172,0,906,806,100,-100,126000,126400,42938,328462,303162
828.742172,1,808,711,97,-97,126000,126400,38219,131581,107040
828.742172,2,7331,7277,54,-54,126000,126400,37445,-661645,-675307
828.742172,3,1082,989,93,-93,126000,126400,32012,227288,203759
828.742172,4,120,50,70,-70,126000,126400,-2139,-30461,-48171
828.742172,5,5032,4969,63,-63,126000,126400,16359,-406259,-422198
828.742172,6,0,0,0,0,126000,126400,0,0,0
828.963643,0,906,806,100,-100,126000,126600,42938,328462,303162
828.963643,1,808,711,97,-97,126000,126600,38219,131581,107040
828.963643,2,7331,7277,54,-54,126000,126600,37445,-661645,-675307
828.963643,3,1082,989,93,-93,126000,126600,32012,227288,203759
828.963643,4,120,50,70,-70,126000,126600,-2139,-30461,-48171
828.963643,5,5032,4969,63,-63,126000,126600,16359,-406259,-422198
828.963643,6,0,0,0,0,126000,126600,0,0,0
829.239524,0,906,806,100,-100,126000,126600,42938,328462,303162
829.239524,1,808,711,97,-97,126000,126600,38219,131581,107040
829.239524,2,7331,7277,54,-54,126000,126600,37445,-661645,-675307
829.239524,3,1082,989,93,-93,126000,126600,32012,227288,203759
829.239524,4,120,50,70,-70,126000,126600,-2139,-30461,-48171
829.239524,5,5032,4969,63,-63,126000,126600,16359,-406259,-422198
829.239524,6,0,0,0,0,126000,126600,0,0,0
829.511124,0,906,806,100,-100,126000,126600,42938,328462,303162
829.511124,1,808,711,97,-97,126000,126600,38219,131581,107040
829.511124,2,7331,7277,54,-54,126000,126600,37445,-661645,-675307
829.511124,3,1082,989,93,-93,126000,126600,32012,227288,203759
829.511124,4,120,50,70,-70,126000,126600,-2139,-30461,-48171
829.511124,5,5032,4969,63,-63,126000,126600,16359,-406259,-422198
829.511124,6,0,0,0,0,126000,126600,0,0,0
829.769474,0,906,806,100,-100,126000,126600,42938,328462,303162
829.769474,1,808,711,97,-97,126000,126600,38219,131581,107040
829.769474,2,7331,7277,54,-54,126000,126600,37445,-661645,-675307
829.769474,3,1082,989,93,-93,126000,126600,32012,227288,203759
829.769474,4,120,50,70,-70,126000,126600,-2139,-30461,-48171
829.769474,5,5032,4969,63,-63,126000,126600,16359,-406259,-422198
829.769474,6,0,0,0,0,126000,126600,0,0,0
829.972044,0,906,806,100,-100,125800,126300,42938,328462,303162
829.972044,1,808,711,97,-97,125800,126300,38219,131581,107040
829.972044,2,7341,7277,64,-64,125800,126300,37319,-656519,-672711
829.972044,3,1082,989,93,-93,125800,126300,32012,227288,203759
829.972044,4,120,50,70,-70,125800,126300,-2139,-30461,-48171
829.972044,5,5042,4969,73,-73,125800,126300,16233,-401133,-419602
829.972044,6,0,0,0,0,125800,126300,0,0,0
830.211187,0,906,806,100,-100,125800,126100,42938,328462,303262
830.211187,1,808,711,97,-97,125800,126100,38219,131581,107137
830.211187,2,7341,7287,54,-54,125800,126100,37571,-660771,-674379
830.211187,3,1082,989,93,-93,125800,126100,32012,227288,203852
830.211187,4,120,50,70,-70,125800,126100,-2139,-30461,-48101
830.211187,5,5042,4969,73,-73,125800,126100,16233,-401133,-419529
830.211187,6,0,0,0,0,125800,126100,0,0,0
830.455511,0,906,806,100,-100,125600,126100,42938,328462,303262
830.455511,1,808,711,97,-97,125600,126100,38219,131581,107137
830.455511,2,7341,7297,44,-44,125600,126100,37784,-664184,-675272
830.455511,3,1082,989,93,-93,125600,126100,32012,227288,203852
830.455511,4,120,50,70,-70,125600,126100,-2139,-30461,-48101
830.455511,5,5042,4969,73,-73,125600,126100,16233,-401133,-419529
830.455511,6,0,0,0,0,125600,126100,0,0,0
830.749306,0,906,806,100,-100,125800,126100,42938,328462,303262
830.749306,1,808,711,97,-97,125800,126100,38219,131581,107137
830.749306,2,7341,7304,37,-37,125800,126100,37960,-666460,-675784
830.749306,3,1082,989,93,-93,125800,126100,32012,227288,203852
830.749306,4,120,50,70,-70,125800,126100,-2139,-30461,-48101
830.749306,5,5042,4969,73,-73,125800,126100,16233,-401133,-419529
830.749306,6,0,0,0,0,125800,126100,0,0,0
831.002566,0,906,806,100,-100,125500,126100,42938,328462,303262
831.002566,1,808,711,97,-97,125500,126100,38219,131581,107137
831.002566,2,7351,7304,47,-47,125500,126100,37834,-661334,-673178
831.002566,3,1082,989,93,-93,125500,126100,32012,227288,203852
831.002566,4,120,50,70,-70,125500,126100,-2139,-30461,-48101
831.002566,5,5042,4979,63,-63,125500,126100,16484,-408384,-424260
831.002566,6,0,0,0,0,125500,126100,0,0,0
831.261297,0,906,806,100,-100,125700,126100,42938,328462,303262
831.261297,1,808,711,97,-97,125700,126100,38219,131581,107137
831.261297,2,7361,7304,57,-57,125700,126100,37708,-657208,-671572
831.261297,3,1082,989,93,-93,125700,126100,32012,227288,203852
831.261297,4,120,50,70,-70,125700,126100,-2139,-30461,-48101
831.261297,5,5042,4989,53,-53,125700,126100,16735,-413635,-426991
831.261297,6,0,0,0,0,125700,126100,0,0,0
831.524428,0,906,806,100,-100,125700,126100,42938,328462,303262
831.524428,1,808,711,97,-97,125700,126100,38219,131581,107137
831.524428,2,7361,7304,57,-57,125700,126100,37708,-657208,-671572
831.524428,3,1082,989,93,-93,125700,126100,32012,227288,203852
831.524428,4,120,50,70,-70,125700,126100,-2139,-30461,-48101
831.524428,5,5042,4989,53,-53,125700,126100,16735,-413635,-426991
831.524428,6,0,0,0,0,125700,126100,0,0,0
831.786322,0,906,806,100,-100,125500,126100,42938,328462,303262
831.786322,1,808,711,97,-97,125500,126100,38219,131581,107137
831.786322,2,7371,7304,67,-67,125500,126100,37582,-653082,-669966
831.786322,3,1082,989,93,-93,125500,126100,32012,227288,203852
831.786322,4,120,50,70,-70,125500,126100,-2139,-30461,-48101
831.786322,5,5042,4999,43,-43,125500,126100,16986,-419886,-430722
831.786322,6,0,0,0,0,125500,126100,0,0,0
831.991971,0,906,806,100,-100,125600,126100,42938,328462,303262
831.991971,1,808,711,97,-97,125600,126100,38219,131581,107137
831.991971,2,7371,7314,57,-57,125600,126100,37456,-657956,-672320
831.991971,3,1082,989,93,-93,125600,126100,32012,227288,203852
831.991971,4,120,50,70,-70,125600,126100,-2139,-30461,-48101
831.991971,5,5052,4999,53,-53,125600,126100,17237,-417137,-430493
831.991971,6,0,0,0,0,125600,126100,0,0,0
832.277976,0,906,806,100,-100,126700,126100,42938,328462,353662
832.277976,1,808,711,97,-97,126700,126100,38219,131581,156025
832.277976,2,7371,7334,37,-37,126700,126100,37204,-669704,-660380
832.277976,3,1082,991,91,-91,126700,126100,31987,227913,250845
832.277976,4,120,50,70,-70,126700,126100,-2139,-30461,-12821
832.277976,5,5062,5009,53,-53,126700,126100,17362,-419262,-405906
832.277976,6,0,0,0,0,126700,126100,0,0,0
832.504235,0,906,806,100,-100,126700,126100,42938,328462,353662
832.504235,1,808,711,97,-97,126700,126100,38219,131581,156025
832.504235,2,7371,7334,37,-37,126700,126100,37204,-669704,-660380
832.504235,3,1082,991,91,-91,126700,126100,31987,227913,250845
832.504235,4,120,50,70,-70,126700,126100,-2139,-30461,-12821
832.504235,5,5062,5009,53,-53,126700,126100,17362,-419262,-405906
832.504235,6,0,0,0,0,126700,126100,0,0,0
832.735406,0,906,806,100,-100,125800,126100,42938,328462,303262
832.735406,1,808,711,97,-97,125800,126100,38219,131581,107137
832.735406,2,7381,7334,47,-47,125800,126100,37456,-666956,-678800
832.735406,3,1082,991,91,-91,125800,126100,31987,227913,204981
832.735406,4,120,50,70,-70,125800,126100,-2139,-30461,-48101
832.735406,5,5062,5019,43,-43,125800,126100,17236,-424136,-434972
832.735406,6,0,0,0,0,125800,126100,0,0,0
832.951457,0,906,806,100,-100,125800,126100,42938,328462,303262
832.951457,1,808,711,97,-97,125800,126100,38219,131581,107137
832.951457,2,7381,7334,47,-47,125800,126100,37456,-666956,-678800
832.951457,3,1082,991,91,-91,125800,126100,31987,227913,204981
832.951457,4,120,50,70,-70,125800,126100,-2139,-30461,-48101
832.951457,5,5062,5019,43,-43,125800,126100,17236,-424136,-434972
832.951457,6,0,0,0,0,125800,126100,0,0,0
833.224021,0,906,806,100,-100,125800,126100,42938,328462,303262
833.224021,1,808,711,97,-97,125800,126100,38219,131581,107137
833.224021,2,7381,7334,47,-47,125800,126100,37456,-666956,-678800
833.224021,3,1082,991,91,-91,125800,126100,31987,227913,204981
833.224021,4,120,50,70,-70,125800,126100,-2139,-30461,-48101
833.224021,5,5062,5019,43,-43,125800,126100,17236,-424136,-434972
833.224021,6,0,0,0,0,125800,126100,0,0,0
833.475602,0,906,806,100,-100,125700,126300,42938,328462,303162
833.475602,1,808,711,97,-97,125700,126300,38219,131581,107040
833.475602,2,7391,7344,47,-47,125700,126300,37204,-666704,-678595
833.475602,3,1082,991,91,-91,125700,126300,31987,227913,204890
833.475602,4,120,50,70,-70,125700,126300,-2139,-30461,-48171
833.475602,5,5072,5029,43,-43,125700,126300,17739,-426639,-437518
833.475602,6,0,0,0,0,125700,126300,0,0,0
833.776044,0,906,806,100,-100,125900,126100,42938,328462,308462
833.776044,1,808,711,97,-97,125900,126100,38219,131581,112181
833.776044,2,7391,7347,44,-44,125900,126100,37166,-668166,-676966
833.776044,3,1082,991,91,-91,125900,126100,31987,227913,209713
833.776044,4,120,50,70,-70,125900,126100,-2139,-30461,-44461
833.776044,5,5072,5029,43,-43,125900,126100,17739,-426639,-435239
833.776044,6,0,0,0,0,125900,126100,0,0,0
834.022143,0,906,806,100,-100,126700,126100,42938,328462,353662
834.022143,1,808,711,97,-97,126700,126100,38219,131581,156025
834.022143,2,7391,7357,34,-34,126700,126100,37040,-672040,-663472
834.022143,3,1082,993,89,-89,126700,126100,31962,228538,250966
834.022143,4,120,50,70,-70,126700,126100,-2139,-30461,-12821
834.022143,5,5072,5039,33,-33,126700,126100,17613,-430513,-422197
834.022143,6,0,0,0,0,126700,126100,0,0,0
834.28013,0,906,825,81,-81,126200,126100,43419,333681,341781
834.28013,1,808,711,97,-97,126200,126100,38219,131581,141281
834.28013,2,7391,7367,24,-24,126200,126100,36914,-675914,-673514
834.28013,3,1082,993,89,-89,126200,126100,31962,228538,237438
834.28013,4,120,50,70,-70,126200,126100,-2139,-30461,-23461
834.28013,5,5072,5044,28,-28,126200,126100,17550,-431950,-429150
834.28013,6,0,0,0,0,126200,126100,0,0,0
834.536886,0,906,825,81,-81,126200,126100,43419,333681,341781
834.536886,1,808,711,97,-97,126200,126100,38219,131581,141281
834.536886,2,7391,7367,24,-24,126200,126100,36914,-675914,-673514
834.536886,3,1082,993,89,-89,126200,126100,31962,228538,237438
834.536886,4,120,50,70,-70,126200,126100,-2139,-30461,-23461
834.536886,5,5072,5044,28,-28,126200,126100,17550,-431950,-429150
834.536886,6,0,0,0,0,126200,126100,0,0,0
834.739707,0,906,825,81,-81,126200,126100,43419,333681,341781
834.739707,1,808,711,97,-97,126200,126100,38219,131581,141281
834.739707,2,7391,7367,24,-24,126200,126100,36914,-675914,-673514
834.739707,3,1082,993,89,-89,126200,126100,31962,228538,237438
834.739707,4,120,50,70,-70,126200,126100,-2139,-30461,-23461
834.739707,5,5072,5044,28,-28,126200,126100,17550,-431950,-429150
834.739707,6,0,0,0,0,126200,126100,0,0,0
834.999851,0,906,825,81,-81,126200,126100,43419,333681,341781
834.999851,1,808,711,97,-97,126200,126100,38219,131581,141281
834.999851,2,7391,7367,24,-24,126200,126100,36914,-675914,-673514
834.999851,3,1082,993,89,-89,126200,126100,31962,228538,237438
834.999851,4,120,50,70,-70,126200,126100,-2139,-30461,-23461
834.999851,5,5072,5044,28,-28,126200,126100,17550,-431950,-429150
834.999851,6,0,0,0,0,126200,126100,0,0,0
835.206015,0,906,825,81,-81,126200,126100,43419,333681,341781
835.206015,1,808,711,97,-97,126200,126100,38219,131581,141281
835.206015,2,7391,7367,24,-24,126200,126100,36914,-675914,-673514
835.206015,3,1082,993,89,-89,126200,126100,31962,228538,237438
835.206015,4,120,50,70,-70,126200,126100,-2139,-30461,-23461
835.206015,5,5072,5044,28,-28,126200,126100,17550,-431950,-429150
835.206015,6,0,0,0,0,126200,126100,0,0,0
835.508261,0,906,825,81,-81,126200,126100,43419,333681,341781
835.508261,1,808,711,97,-97,126200,126100,38219,131581,141281
835.508261,2,7391,7367,24,-24,126200,126100,36914,-675914,-673514
835.508261,3,1082,993,89,-89,126200,126100,31962,228538,237438
835.508261,4,120,50,70,-70,126200,126100,-2139,-30461,-23461
835.508261,5,5072,5044,28,-28,126200,126100,17550,-431950,-429150
835.508261,6,0,0,0,0,126200,126100,0,0,0
835.715275,0,906,825,81,-81,126200,126400,43419,333681,317481
835.715275,1,808,711,97,-97,126200,126400,38219,131581,112181
835.715275,2,7391,7367,24,-24,126200,126400,36914,-675914,-680714
835.715275,3,1082,993,89,-89,126200,126400,31962,228538,210738
835.715275,4,120,50,70,-70,126200,126400,-2139,-30461,-44461
835.715275,5,5072,5044,28,-28,126200,126400,17550,-431950,-437550
835.715275,6,0,0,0,0,126200,126400,0,0,0
836.000825,0,916,825,91,-91,126200,126900,43671,336429,313315
836.000825,1,808,711,97,-97,126200,126900,38219,131581,106943
836.000825,2,7391,7377,14,-14,126200,126900,36788,-680788,-684344
836.000825,3,1082,993,89,-89,126200,126900,31962,228538,205932
836.000825,4,120,50,70,-70,126200,126900,-2139,-30461,-48241
836.000825,5,5072,5044,28,-28,126200,126900,17550,-431950,-439062
836.000825,6,0,0,0,0,126200,126900,0,0,0
836.268435,0,925,825,100,-100,126800,126900,43899,339801,329801
836.268435,1,808,711,97,-97,126800,126900,38219,131581,121881
836.268435,2,7401,7387,14,-14,126800,126900,36916,-685916,-687316
836.268435,3,1082,993,89,-89,126800,126900,31962,228538,219638
836.268435,4,120,50,70,-70,126800,126900,-2139,-30461,-37461
836.268435,5,5072,5053,19,-19,126800,126900,17436,-436336,-438236
836.268435,6,0,0,0,0,126800,126900,0,0,0
836.547458,0,925,825,100,-100,126800,126900,43899,339801,329801
836.547458,1,808,711,97,-97,126800,126900,38219,131581,121881
836.547458,2,7401,7387,14,-14,126800,126900,36916,-685916,-687316
836.547458,3,1082,993,89,-89,126800,126900,31962,228538,219638
836.547458,4,120,50,70,-70,126800,126900,-2139,-30461,-37461
836.547458,5,5072,5053,19,-19,126800,126900,17436,-436336,-438236
836.547458,6,0,0,0,0,126800,126900,0,0,0
836.780076,0,925,825,100,-100,126800,126900,43899,339801,329801
836.780076,1,808,711,97,-97,126800,126900,38219,131581,121881
836.780076,2,7402,7387,15,-15,126800,126900,36941,-685841,-687341
836.780076,3,1082,993,89,-89,126800,126900,31962,228538,219638
836.780076,4,120,50,70,-70,126800,126900,-2139,-30461,-37461
836.780076,5,5072,5053,19,-19,126800,126900,17436,-436336,-438236
836.780076,6,0,0,0,0,126800,126900,0,0,0
836.98605,0,925,825,100,-100,126800,127000,43899,339801,319801
836.98605,1,808,711,97,-97,126800,127000,38219,131581,112181
836.98605,2,7402,7387,15,-15,126800,127000,36941,-685841,-688841
836.98605,3,1082,993,89,-89,126800,127000,31962,228538,210738
836.98605,4,120,50,70,-70,126800,127000,-2139,-30461,-44461
836.98605,5,5072,5053,19,-19,126800,127000,17436,-436336,-440136
836.98605,6,0,0,0,0,126800,127000,0,0,0
837.267394,0,925,825,100,-100,127100,127000,43899,339801,349801
837.267394,1,808,711,97,-97,127100,127000,38219,131581,141281
837.267394,2,7402,7387,15,-15,127100,127000,36941,-685841,-684341
837.267394,3,1082,993,89,-89,127100,127000,31962,228538,237438
837.267394,4,120,50,70,-70,127100,127000,-2139,-30461,-23461
837.267394,5,5072,5053,19,-19,127100,127000,17436,-436336,-434436
837.267394,6,0,0,0,0,127100,127000,0,0,0
837.471298,0,925,825,100,-100,127100,127000,43899,339801,349801
837.471298,1,808,711,97,-97,127100,127000,38219,131581,141281
837.471298,2,7402,7387,15,-15,127100,127000,36941,-685841,-684341
837.471298,3,1082,993,89,-89,127100,127000,31962,228538,237438
837.471298,4,120,50,70,-70,127100,127000,-2139,-30461,-23461
837.471298,5,5072,5053,19,-19,127100,127000,17436,-436336,-434436
837.471298,6,0,0,0,0,127100,127000,0,0,0
837.71903,0,925,825,100,-100,127100,127200,43899,339801,329801
837.71903,1,808,711,97,-97,127100,127200,38219,131581,121881
837.71903,2,7412,7387,25,-25,127100,127200,37195,-687095,-689595
837.71903,3,1082,993,89,-89,127100,127200,31962,228538,219638
837.71903,4,120,50,70,-70,127100,127200,-2139,-30461,-37461
837.71903,5,5072,5053,19,-19,127100,127200,17436,-436336,-438236
837.71903,6,0,0,0,0,127100,127200,0,0,0
837.969237,0,925,825,100,-100,127100,127200,43899,339801,329801
837.969237,1,808,711,97,-97,127100,127200,38219,131581,121881
837.969237,2,7412,7387,25,-25,127100,127200,37195,-687095,-689595
837.969237,3,1082,993,89,-89,127100,127200,31962,228538,219638
837.969237,4,120,50,70,-70,127100,127200,-2139,-30461,-37461
837.969237,5,5072,5053,19,-19,127100,127200,17436,-436336,-438236
837.969237,6,0,0,0,0,127100,127200,0,0,0
838.266134,0,925,825,100,-100,127100,127200,43899,339801,329801
838.266134,1,808,711,97,-97,127100,127200,38219,131581,121881
838.266134,2,7412,7387,25,-25,127100,127200,37195,-687095,-689595
838.266134,3,1082,993,89,-89,127100,127200,31962,228538,219638
838.266134,4,120,50,70,-70,127100,127200,-2139,-30461,-37461
838.266134,5,5072,5053,19,-19,127100,127200,17436,-436336,-438236
838.266134,6,0,0,0,0,127100,127200,0,0,0
838.547678,0,925,825,100,-100,127000,127200,43899,339801,319801
838.547678,1,808,711,97,-97,127000,127200,38219,131581,112181
838.547678,2,7412,7397,15,-15,127000,127200,37068,-690968,-693968
838.547678,3,1082,993,89,-89,127000,127200,31962,228538,210738
838.547678,4,120,50,70,-70,127000,127200,-2139,-30461,-44461
838.547678,5,5082,5053,29,-29,127000,127200,17690,-434590,-440390
838.547678,6,0,0,0,0,127000,127200,0,0,0
838.736721,0,925,825,100,-100,127000,127200,43899,339801,319801
838.736721,1,808,711,97,-97,127000,127200,38219,131581,112181
838.736721,2,7412,7397,15,-15,127000,127200,37068,-690968,-693968
838.736721,3,1082,993,89,-89,127000,127200,31962,228538,210738
838.736721,4,120,50,70,-70,127000,127200,-2139,-30461,-44461
838.736721,5,5082,5053,29,-29,127000,127200,17690,-434590,-440390
838.736721,6,0,0,0,0,127000,127200,0,0,0
839.033228,0,925,825,100,-100,127000,127200,43899,339801,319801
839.033228,1,808,711,97,-97,127000,127200,38219,131581,112181
839.033228,2,7412,7397,15,-15,127000,127200,37068,-690968,-693968
839.033228,3,1082,993,89,-89,127000,127200,31962,228538,210738
839.033228,4,120,50,70,-70,127000,127200,-2139,-30461,-44461
839.033228,5,5082,5053,29,-29,127000,127200,17690,-434590,-440390
839.033228,6,0,0,0,0,127000,127200,0,0,0
839.233612,0,925,825,100,-100,126800,127200,43899,339801,314401
839.233612,1,808,711,97,-97,126800,127200,38219,131581,106943
839.233612,2,7419,7397,22,-22,126800,127200,36979,-690179,-695767
839.233612,3,1082,1000,82,-82,126800,127200,32140,226960,206132
839.233612,4,120,50,70,-70,126800,127200,-2139,-30461,-48241
839.233612,5,5082,5053,29,-29,126800,127200,17690,-434590,-441956
839.233612,6,0,0,0,0,126800,127200,0,0,0
839.478502,0,925,825,100,-100,126400,126900,43899,339801,314401
839.478502,1,808,711,97,-97,126400,126900,38219,131581,106943
839.478502,2,7429,7407,22,-22,126400,126900,37106,-690306,-695894
839.478502,3,1084,1000,84,-84,126400,126900,32115,227585,206249
839.478502,4,120,50,70,-70,126400,126900,-2139,-30461,-48241
839.478502,5,5092,5053,39,-39,126400,126900,17563,-433463,-443369
839.478502,6,0,0,0,0,126400,126900,0,0,0
839.73325,0,925,825,100,-100,126400,126900,43899,339801,314401
839.73325,1,808,711,97,-97,126400,126900,38219,131581,106943
839.73325,2,7429,7407,22,-22,126400,126900,37106,-690306,-695894
839.73325,3,1084,1000,84,-84,126400,126900,32115,227585,206249
839.73325,4,120,50,70,-70,126400,126900,-2139,-30461,-48241
839.73325,5,5092,5053,39,-39,126400,126900,17563,-433463,-443369
839.73325,6,0,0,0,0,126400,126900,0,0,0
839.990044,0,925,825,100,-100,126400,126900,43899,339801,314401
839.990044,1,808,711,97,-97,126400,126900,38219,131581,106943
839.990044,2,7429,7407,22,-22,126400,126900,37106,-690306,-695894
839.990044,3,1084,1000,84,-84,126400,126900,32115,227585,206249
839.990044,4,120,50,70,-70,126400,126900,-2139,-30461,-48241
839.990044,5,5092,5053,39,-39,126400,126900,17563,-433463,-443369
839.990044,6,0,0,0,0,126400,126900,0,0,0
840.274889,0,925,825,100,-100,126400,126900,43899,339801,314401
840.274889,1,808,711,97,-97,126400,126900,38219,131581,106943
840.274889,2,7429,7407,22,-22,126400,126900,37106,-690306,-695894
840.274889,3,1084,1000,84,-84,126400,126900,32115,227585,206249
840.274889,4,120,50,70,-70,126400,126900,-2139,-30461,-48241
840.274889,5,5092,5053,39,-39,126400,126900,17563,-433463,-443369
840.274889,6,0,0,0,0,126400,126900,0,0,0
840.506271,0,925,825,100,-100,126400,126900,43899,339801,314401
840.506271,1,808,711,97,-97,126400,126900,38219,131581,106943
840.506271,2,7429,7407,22,-22,126400,126900,37106,-690306,-695894
840.506271,3,1084,1000,84,-84,126400,126900,32115,227585,206249
840.506271,4,120,50,70,-70,126400,126900,-2139,-30461,-48241
840.506271,5,5092,5053,39,-39,126400,126900,17563,-433463,-443369
840.506271,6,0,0,0,0,126400,126900,0,0,0
840.759913,0,925,825,100,-100,126400,126900,43899,339801,314401
840.759913,1,808,711,97,-97,126400,126900,38219,131581,106943
840.759913,2,7429,7407,22,-22,126400,126900,37106,-690306,-695894
840.759913,3,1084,1000,84,-84,126400,126900,32115,227585,206249
840.759913,4,120,50,70,-70,126400,126900,-2139,-30461,-48241
840.759913,5,5092,5053,39,-39,126400,126900,17563,-433463,-443369
840.759913,6,0,0,0,0,126400,126900,0,0,0
840.991027,0,925,825,100,-100,126400,126900,43899,339801,314401
840.991027,1,808,711,97,-97,126400,126900,38219,131581,106943
840.991027,2,7429,7407,22,-22,126400,126900,37106,-690306,-695894
840.991027,3,1084,1000,84,-84,126400,126900,32115,227585,206249
840.991027,4,120,50,70,-70,126400,126900,-2139,-30461,-48241
840.991027,5,5092,5053,39,-39,126400,126900,17563,-433463,-443369
840.991027,6,0,0,0,0,126400,126900,0,0,0
841.246805,0,925,825,100,-100,126400,126900,43899,339801,314401
841.246805,1,808,711,97,-97,126400,126900,38219,131581,106943
841.246805,2,7429,7407,22,-22,126400,126900,37106,-690306,-695894
841.246805,3,1084,1000,84,-84,126400,126900,32115,227585,206249
841.246805,4,120,50,70,-70,126400,126900,-2139,-30461,-48241
841.246805,5,5092,5053,39,-39,126400,126900,17563,-433463,-443369
841.246805,6,0,0,0,0,126400,126900,0,0,0
841.509919,0,925,825,100,-100,126000,126900,43899,339801,314401
841.509919,1,808,711,97,-97,126000,126900,38219,131581,106943
841.509919,2,7439,7407,32,-32,126000,126900,36980,-688180,-696308
841.509919,3,1086,1000,86,-86,126000,126900,32090,228210,206366
841.509919,4,120,50,70,-70,126000,126900,-2139,-30461,-48241
841.509919,5,5102,5053,49,-49,126000,126900,17437,-431337,-443783
841.509919,6,0,0,0,0,126000,126900,0,0,0
841.796142,0,925,825,100,-100,126200,126900,43899,339801,314401
841.796142,1,808,711,97,-97,126200,126900,38219,131581,106943
841.796142,2,7439,7417,22,-22,126200,126900,36854,-692054,-697642
841.796142,3,1086,1000,86,-86,126200,126900,32090,228210,206366
841.796142,4,120,50,70,-70,126200,126900,-2139,-30461,-48241
841.796142,5,5102,5053,49,-49,126200,126900,17437,-431337,-443783
841.796142,6,0,0,0,0,126200,126900,0,0,0
842.012725,0,925,825,100,-100,126700,126900,43899,339801,319801
842.012725,1,808,754,54,-54,126700,126900,39307,134793,123993
842.012725,2,7439,7427,12,-12,126700,126900,37107,-691307,-693707
842.012725,3,1086,1007,79,-79,126700,126900,32267,228733,212933
842.012725,4,120,50,70,-70,126700,126900,-2139,-30461,-44461
842.012725,5,5102,5053,49,-49,126700,126900,17437,-431337,-441137
842.012725,6,0,0,0,0,126700,126900,0,0,0
842.257293,0,925,825,100,-100,126200,126900,43899,339801,314401
842.257293,1,808,754,54,-54,126200,126900,39307,134793,121077
842.257293,2,7445,7427,18,-18,126200,126900,37031,-690031,-694603
842.257293,3,1086,1013,73,-73,126200,126900,32418,226182,207640
842.257293,4,120,50,70,-70,126200,126900,-2139,-30461,-48241
842.257293,5,5102,5053,49,-49,126200,126900,17437,-431337,-443783
842.257293,6,0,0,0,0,126200,126900,0,0,0
842.45473,0,925,825,100,-100,126000,126900,43899,339801,314401
842.45473,1,808,754,54,-54,126000,126900,39307,134793,121077
842.45473,2,7455,7427,28,-28,126000,126900,36905,-687905,-695017
842.45473,3,1088,1013,75,-75,126000,126900,32393,227007,207957
842.45473,4,120,50,70,-70,126000,126900,-2139,-30461,-48241
842.45473,5,5112,5053,59,-59,126000,126900,17311,-425211,-440197
842.45473,6,0,0,0,0,126000,126900,0,0,0
842.713966,0,925,825,100,-100,126000,126900,43899,339801,314401
842.713966,1,808,754,54,-54,126000,126900,39307,134793,121077
842.713966,2,7455,7427,28,-28,126000,126900,36905,-687905,-695017
842.713966,3,1088,1013,75,-75,126000,126900,32393,227007,207957
842.713966,4,120,50,70,-70,126000,126900,-2139,-30461,-48241
842.713966,5,5112,5053,59,-59,126000,126900,17311,-425211,-440197
842.713966,6,0,0,0,0,126000,126900,0,0,0
843.0166,0,925,825,100,-100,126400,126900,43899,339801,314401
843.0166,1,808,754,54,-54,126400,126900,39307,134793,121077
843.0166,2,7465,7427,38,-38,126400,126900,37158,-686158,-695810
843.0166,3,1088,1013,75,-75,126400,126900,32393,227007,207957
843.0166,4,120,50,70,-70,126400,126900,-2139,-30461,-48241
843.0166,5,5112,5063,49,-49,126400,126900,17185,-429085,-441531
843.0166,6,0,0,0,0,126400,126900,0,0,0
843.226929,0,925,825,100,-100,126300,126500,43899,339801,319801
843.226929,1,808,754,54,-54,126300,126500,39307,134793,123993
843.226929,2,7465,7429,36,-36,126300,126500,37209,-686609,-693809
843.226929,3,1090,1013,77,-77,126300,126500,32368,227232,211832
843.226929,4,120,50,70,-70,126300,126500,-2139,-30461,-44461
843.226929,5,5112,5063,49,-49,126300,126500,17185,-429085,-438885
843.226929,6,0,0,0,0,126300,126500,0,0,0
843.458491,0,925,825,100,-100,126300,126500,43899,339801,319801
843.458491,1,818,754,64,-64,126300,126500,39560,136540,123740
843.458491,2,7465,7437,28,-28,126300,126500,37108,-688908,-694508
843.458491,3,1090,1013,77,-77,126300,126500,32368,227232,211832
843.458491,4,120,50,70,-70,126300,126500,-2139,-30461,-44461
843.458491,5,5112,5065,47,-47,126300,126500,17160,-429660,-439060
843.458491,6,0,0,0,0,126300,126500,0,0,0
843.75782,0,925,825,100,-100,126300,126500,43899,339801,319801
843.75782,1,818,754,64,-64,126300,126500,39560,136540,123740
843.75782,2,7475,7437,38,-38,126300,126500,37361,-687161,-694761
843.75782,3,1090,1013,77,-77,126300,126500,32368,227232,211832
843.75782,4,120,50,70,-70,126300,126500,-2139,-30461,-44461
843.75782,5,5112,5075,37,-37,126300,126500,17034,-432534,-439934
843.75782,6,0,0,0,0,126300,126500,0,0,0
843.960384,0,925,825,100,-100,126400,126500,43899,339801,329801
843.960384,1,828,754,74,-74,126400,126500,39813,136287,128887
843.960384,2,7475,7447,28,-28,126400,126500,37235,-689035,-691835
843.960384,3,1090,1013,77,-77,126400,126500,32368,227232,219532
843.960384,4,120,50,70,-70,126400,126500,-2139,-30461,-37461
843.960384,5,5112,5075,37,-37,126400,126500,17034,-432534,-436234
843.960384,6,0,0,0,0,126400,126500,0,0,0
844.217772,0,925,825,100,-100,126400,126500,43899,339801,329801
844.217772,1,828,754,74,-74,126400,126500,39813,136287,128887
844.217772,2,7475,7447,28,-28,126400,126500,37235,-689035,-691835
844.217772,3,1090,1013,77,-77,126400,126500,32368,227232,219532
844.217772,4,120,50,70,-70,126400,126500,-2139,-30461,-37461
844.217772,5,5112,5075,37,-37,126400,126500,17034,-432534,-436234
844.217772,6,0,0,0,0,126400,126500,0,0,0
844.480137,0,925,825,100,-100,126600,126500,43899,339801,349801
844.480137,1,828,754,74,-74,126600,126500,39813,136287,143687
844.480137,2,7485,7457,28,-28,126600,126500,37362,-692162,-689362
844.480137,3,1092,1013,79,-79,126600,126500,32419,227781,235681
844.480137,4,120,50,70,-70,126600,126500,-2139,-30461,-23461
844.480137,5,5122,5075,47,-47,126600,126500,17287,-427787,-423087
844.480137,6,0,0,0,0,126600,126500,0,0,0
844.774097,0,925,825,100,-100,126600,126500,43899,339801,349801
844.774097,1,848,754,94,-94,126600,126500,40319,139781,149181
844.774097,2,7495,7457,38,-38,126600,126500,37615,-690415,-686615
844.774097,3,1092,1013,79,-79,126600,126500,32419,227781,235681
844.774097,4,120,50,70,-70,126600,126500,-2139,-30461,-23461
844.774097,5,5122,5075,47,-47,126600,126500,17287,-427787,-423087
844.774097,6,0,0,0,0,126600,126500,0,0,0
844.98321,0,925,825,100,-100,126600,126500,43899,339801,349801
844.98321,1,848,754,94,-94,126600,126500,40319,139781,149181
844.98321,2,7505,7457,48,-48,126600,126500,37868,-687668,-682868
844.98321,3,1093,1013,80,-80,126600,126500,32444,228056,236056
844.98321,4,120,50,70,-70,126600,126500,-2139,-30461,-23461
844.98321,5,5122,5075,47,-47,126600,126500,17287,-427787,-423087
844.98321,6,0,0,0,0,126600,126500,0,0,0
845.27834,0,925,825,100,-100,126600,126500,43899,339801,349801
845.27834,1,848,754,94,-94,126600,126500,40319,139781,149181
845.27834,2,7505,7458,47,-47,126600,126500,37893,-688093,-683393
845.27834,3,1094,1013,81,-81,126600,126500,32431,228369,236469
845.27834,4,120,50,70,-70,126600,126500,-2139,-30461,-23461
845.27834,5,5122,5075,47,-47,126600,126500,17287,-427787,-423087
845.27834,6,0,0,0,0,126600,126500,0,0,0
845.54267,0,925,825,100,-100,126400,126500,43899,339801,329801
845.54267,1,848,754,94,-94,126400,126500,40319,139781,130381
845.54267,2,7515,7460,55,-55,126400,126500,37742,-684742,-690242
845.54267,3,1096,1013,83,-83,126400,126500,32482,228918,220618
845.54267,4,120,50,70,-70,126400,126500,-2139,-30461,-37461
845.54267,5,5132,5075,57,-57,126400,126500,17161,-422661,-428361
845.54267,6,0,0,0,0,126400,126500,0,0,0
845.7911,0,925,825,100,-100,126400,126900,43899,339801,314401
845.7911,1,848,754,94,-94,126400,126900,40319,139781,115905
845.7911,2,7515,7470,45,-45,126400,126900,37995,-689995,-701425
845.7911,3,1098,1013,85,-85,126400,126900,32457,229543,207953
845.7911,4,120,50,70,-70,126400,126900,-2139,-30461,-48241
845.7911,5,5142,5085,57,-57,126400,126900,17288,-424388,-438866
845.7911,6,0,0,0,0,126400,126900,0,0,0
846.035737,0,925,825,100,-100,127100,126800,43899,339801,365201
846.035737,1,848,754,94,-94,127100,126800,40319,139781,163657
846.035737,2,7515,7480,35,-35,127100,126800,38248,-694248,-685358
846.035737,3,1098,1013,85,-85,127100,126800,32457,229543,251133
846.035737,4,120,50,70,-70,127100,126800,-2139,-30461,-12681
846.035737,5,5142,5095,47,-47,127100,126800,17541,-428641,-416703
846.035737,6,0,0,0,0,127100,126800,0,0,0
846.283348,0,925,825,100,-100,126500,126800,43899,339801,314401
846.283348,1,848,754,94,-94,126500,126800,40319,139781,115905
846.283348,2,7515,7490,25,-25,126500,126800,38501,-697501,-703851
846.283348,3,1098,1013,85,-85,126500,126800,32457,229543,207953
846.283348,4,120,50,70,-70,126500,126800,-2139,-30461,-48241
846.283348,5,5142,5105,37,-37,126500,126800,17794,-431894,-441292
846.283348,6,0,0,0,0,126500,126800,0,0,0
846.49986,0,925,825,100,-100,126500,126800,43899,339801,314401
846.49986,1,848,754,94,-94,126500,126800,40319,139781,115905
846.49986,2,7515,7490,25,-25,126500,126800,38501,-697501,-703851
846.49986,3,1098,1013,85,-85,126500,126800,32457,229543,207953
846.49986,4,120,50,70,-70,126500,126800,-2139,-30461,-48241
846.49986,5,5142,5105,37,-37,126500,126800,17794,-431894,-441292
846.49986,6,0,0,0,0,126500,126800,0,0,0
846.782846,0,925,825,100,-100,126200,126800,43899,339801,314401
846.782846,1,848,754,94,-94,126200,126800,40319,139781,115905
846.782846,2,7525,7490,35,-35,126200,126800,38375,-695375,-704265
846.782846,3,1100,1013,87,-87,126200,126800,32432,230168,208070
846.782846,4,120,50,70,-70,126200,126800,-2139,-30461,-48241
846.782846,5,5152,5105,47,-47,126200,126800,17668,-427768,-439706
846.782846,6,0,0,0,0,126200,126800,0,0,0
847.012447,0,925,825,100,-100,126200,127000,43899,339801,314401
847.012447,1,848,754,94,-94,126200,127000,40319,139781,115905
847.012447,2,7525,7490,35,-35,126200,127000,38375,-695375,-704265
847.012447,3,1100,1013,87,-87,126200,127000,32432,230168,208070
847.012447,4,120,50,70,-70,126200,127000,-2139,-30461,-48241
847.012447,5,5152,5105,47,-47,126200,127000,17668,-427768,-439706
847.012447,6,0,0,0,0,126200,127000,0,0,0
847.300472,0,925,825,100,-100,126400,127000,43899,339801,314401
847.300472,1,848,754,94,-94,126400,127000,40319,139781,115905
847.300472,2,7535,7490,45,-45,126400,127000,38248,-693248,-704678
847.300472,3,1102,1013,89,-89,126400,127000,32407,230593,207987
847.300472,4,120,50,70,-70,126400,127000,-2139,-30461,-48241
847.300472,5,5162,5105,57,-57,126400,127000,17542,-423642,-438120
847.300472,6,0,0,0,0,126400,127000,0,0,0
847.501345,0,925,825,100,-100,126400,127000,43899,339801,314401
847.501345,1,848,754,94,-94,126400,127000,40319,139781,115905
847.501345,2,7535,7490,45,-45,126400,127000,38248,-693248,-704678
847.501345,3,1102,1013,89,-89,126400,127000,32407,230593,207987
847.501345,4,120,50,70,-70,126400,127000,-2139,-30461,-48241
847.501345,5,5162,5105,57,-57,126400,127000,17542,-423642,-438120
847.501345,6,0,0,0,0,126400,127000,0,0,0
847.7594,0,925,825,100,-100,126400,127000,43899,339801,314401
847.7594,1,848,754,94,-94,126400,127000,40319,139781,115905
847.7594,2,7535,7490,45,-45,126400,127000,38248,-693248,-704678
847.7594,3,1102,1013,89,-89,126400,127000,32407,230593,207987
847.7594,4,120,50,70,-70,126400,127000,-2139,-30461,-48241
847.7594,5,5162,5105,57,-57,126400,127000,17542,-423642,-438120
847.7594,6,0,0,0,0,126400,127000,0,0,0
848.031727,0,925,825,100,-100,126600,127000,43899,339801,314401
848.031727,1,848,754,94,-94,126600,127000,40319,139781,115905
848.031727,2,7545,7490,55,-55,126600,127000,38501,-689501,-703471
848.031727,3,1102,1013,89,-89,126600,127000,32407,230593,207987
848.031727,4,120,50,70,-70,126600,127000,-2139,-30461,-48241
848.031727,5,5162,5115,47,-47,126600,127000,17415,-428515,-440453
848.031727,6,0,0,0,0,126600,127000,0,0,0
848.281656,0,925,825,100,-100,126600,127000,43899,339801,314401
848.281656,1,848,754,94,-94,126600,127000,40319,139781,115905
848.281656,2,7545,7490,55,-55,126600,127000,38501,-689501,-703471
848.281656,3,1102,1013,89,-89,126600,127000,32407,230593,207987
848.281656,4,120,50,70,-70,126600,127000,-2139,-30461,-48241
848.281656,5,5162,5115,47,-47,126600,127000,17415,-428515,-440453
848.281656,6,0,0,0,0,126600,127000,0,0,0
848.49994,0,925,825,100,-100,126600,127000,43899,339801,314401
848.49994,1,848,754,94,-94,126600,127000,40319,139781,115905
848.49994,2,7545,7490,55,-55,126600,127000,38501,-689501,-703471
848.49994,3,1102,1013,89,-89,126600,127000,32407,230593,207987
848.49994,4,120,50,70,-70,126600,127000,-2139,-30461,-48241
848.49994,5,5162,5115,47,-47,126600,127000,17415,-428515,-440453
848.49994,6,0,0,0,0,126600,127000,0,0,0
848.791748,0,925,825,100,-100,126600,127000,43899,339801,314401
848.791748,1,848,754,94,-94,126600,127000,40319,139781,115905
848.791748,2,7545,7492,53,-53,126600,127000,38476,-690476,-703938
848.791748,3,1104,1013,91,-91,126600,127000,32458,231142,208028
848.791748,4,120,50,70,-70,126600,127000,-2139,-30461,-48241
848.791748,5,5162,5115,47,-47,126600,127000,17415,-428515,-440453
848.791748,6,0,0,0,0,126600,127000,0,0,0
848.953429,0,925,825,100,-100,126500,127000,43899,339801,314401
848.953429,1,848,754,94,-94,126500,127000,40319,139781,115905
848.953429,2,7545,7502,43,-43,126500,127000,38729,-696729,-707651
848.953429,3,1104,1013,91,-91,126500,127000,32458,231142,208028
848.953429,4,120,50,70,-70,126500,127000,-2139,-30461,-48241
848.953429,5,5172,5115,57,-57,126500,127000,17289,-424389,-438867
848.953429,6,0,0,0,0,126500,127000,0,0,0
849.247958,0,925,825,100,-100,126500,127000,43899,339801,314401
849.247958,1,848,754,94,-94,126500,127000,40319,139781,115905
849.247958,2,7555,7502,53,-53,126500,127000,38982,-690982,-704444
849.247958,3,1104,1013,91,-91,126500,127000,32458,231142,208028
849.247958,4,120,50,70,-70,126500,127000,-2139,-30461,-48241
849.247958,5,5172,5125,47,-47,126500,127000,17163,-432263,-444201
849.247958,6,0,0,0,0,126500,127000,0,0,0
849.491095,0,925,825,100,-100,127200,127300,43899,339801,329801
849.491095,1,848,754,94,-94,127200,127300,40319,139781,130381
849.491095,2,7555,7512,43,-43,127200,127300,38855,-695855,-700155
849.491095,3,1104,1013,91,-91,127200,127300,32458,231142,222042
849.491095,4,120,50,70,-70,127200,127300,-2139,-30461,-37461
849.491095,5,5172,5135,37,-37,127200,127300,17036,-435136,-438836
849.491095,6,0,0,0,0,127200,127300,0,0,0
849.709253,0,925,825,100,-100,127200,127200,43899,339801,339801
849.709253,1,848,754,94,-94,127200,127200,40319,139781,139781
849.709253,2,7555,7512,43,-43,127200,127200,38855,-695855,-695855
849.709253,3,1104,1013,91,-91,127200,127200,32458,231142,231142
849.709253,4,120,50,70,-70,127200,127200,-2139,-30461,-30461
849.709253,5,5172,5135,37,-37,127200,127200,17036,-435136,-435136
849.709253,6,0,0,0,0,127200,127200,0,0,0
849.971772,0,925,825,100,-100,126900,127200,43899,339801,314401
849.971772,1,848,754,94,-94,126900,127200,40319,139781,115905
849.971772,2,7555,7514,41,-41,126900,127200,38830,-696630,-707044
849.971772,3,1106,1013,93,-93,126900,127200,32509,231691,208069
849.971772,4,120,50,70,-70,126900,127200,-2139,-30461,-48241
849.971772,5,5172,5135,37,-37,126900,127200,17036,-435136,-444534
849.971772,6,0,0,0,0,126900,127200,0,0,0
850.234218,0,925,825,100,-100,126900,127200,43899,339801,314401
850.234218,1,848,754,94,-94,126900,127200,40319,139781,115905
850.234218,2,7555,7514,41,-41,126900,127200,38830,-696630,-707044
850.234218,3,1106,1013,93,-93,126900,127200,32509,231691,208069
850.234218,4,120,50,70,-70,126900,127200,-2139,-30461,-48241
850.234218,5,5172,5135,37,-37,126900,127200,17036,-435136,-444534
850.234218,6,0,0,0,0,126900,127200,0,0,0
850.522293,0,925,825,100,-100,126900,127200,43899,339801,314401
850.522293,1,848,754,94,-94,126900,127200,40319,139781,115905
850.522293,2,7555,7514,41,-41,126900,127200,38830,-696630,-707044
850.522293,3,1106,1013,93,-93,126900,127200,32509,231691,208069
850.522293,4,120,50,70,-70,126900,127200,-2139,-30461,-48241
850.522293,5,5172,5135,37,-37,126900,127200,17036,-435136,-444534
850.522293,6,0,0,0,0,126900,127200,0,0,0
850.757526,0,925,825,100,-100,126900,127200,43899,339801,314401
850.757526,1,848,754,94,-94,126900,127200,40319,139781,115905
850.757526,2,7555,7514,41,-41,126900,127200,38830,-696630,-707044
850.757526,3,1106,1013,93,-93,126900,127200,32509,231691,208069
850.757526,4,120,50,70,-70,126900,127200,-2139,-30461,-48241
850.757526,5,5172,5135,37,-37,126900,127200,17036,-435136,-444534
850.757526,6,0,0,0,0,126900,127200,0,0,0
851.016811,0,925,825,100,-100,126900,127200,43899,339801,314401
851.016811,1,848,754,94,-94,126900,127200,40319,139781,115905
851.016811,2,7555,7514,41,-41,126900,127200,38830,-696630,-707044
851.016811,3,1106,1013,93,-93,126900,127200,32509,231691,208069
851.016811,4,120,50,70,-70,126900,127200,-2139,-30461,-48241
851.016811,5,5172,5135,37,-37,126900,127200,17036,-435136,-444534
851.016811,6,0,0,0,0,126900,127200,0,0,0
851.272622,0,925,825,100,-100,126900,127200,43899,339801,314401
851.272622,1,848,754,94,-94,126900,127200,40319,139781,115905
851.272622,2,7555,7514,41,-41,126900,127200,38830,-696630,-707044
851.272622,3,1106,1013,93,-93,126900,127200,32509,231691,208069
851.272622,4,120,50,70,-70,126900,127200,-2139,-30461,-48241
851.272622,5,5172,5135,37,-37,126900,127200,17036,-435136,-444534
851.272622,6,0,0,0,0,126900,127200,0,0,0
851.485352,0,925,825,100,-100,126900,127200,43899,339801,314401
851.485352,1,848,754,94,-94,126900,127200,40319,139781,115905
851.485352,2,7555,7514,41,-41,126900,127200,38830,-696630,-707044
851.485352,3,1106,1013,93,-93,126900,127200,32509,231691,208069
851.485352,4,120,50,70,-70,126900,127200,-2139,-30461,-48241
851.485352,5,5172,5135,37,-37,126900,127200,17036,-435136,-444534
851.485352,6,0,0,0,0,126900,127200,0,0,0
851.79689,0,925,825,100,-100,127100,127300,43899,339801,319801
851.79689,1,848,754,94,-94,127100,127300,40319,139781,120981
851.79689,2,7555,7524,31,-31,127100,127300,38703,-699103,-705303
851.79689,3,1106,1013,93,-93,127100,127300,32509,231691,213091
851.79689,4,120,50,70,-70,127100,127300,-2139,-30461,-44461
851.79689,5,5172,5144,28,-28,127100,127300,16922,-435922,-441522
851.79689,6,0,0,0,0,127100,127300,0,0,0
852.019451,0,925,825,100,-100,126900,127300,43899,339801,314301
852.019451,1,848,754,94,-94,126900,127300,40319,139781,115811
852.019451,2,7555,7534,21,-21,126900,127300,38957,-702357,-707712
852.019451,3,1106,1013,93,-93,126900,127300,32509,231691,207976
852.019451,4,120,50,70,-70,126900,127300,-2139,-30461,-48311
852.019451,5,5182,5144,38,-38,126900,127300,16795,-434795,-444485
852.019451,6,0,0,0,0,126900,127300,0,0,0
852.203708,0,925,825,100,-100,126900,127300,43899,339801,314301
852.203708,1,848,754,94,-94,126900,127300,40319,139781,115811
852.203708,2,7555,7534,21,-21,126900,127300,38957,-702357,-707712
852.203708,3,1106,1013,93,-93,126900,127300,32509,231691,207976
852.203708,4,120,50,70,-70,126900,127300,-2139,-30461,-48311
852.203708,5,5182,5144,38,-38,126900,127300,16795,-434795,-444485
852.203708,6,0,0,0,0,126900,127300,0,0,0
852.480574,0,925,825,100,-100,126900,127300,43899,339801,314301
852.480574,1,848,754,94,-94,126900,127300,40319,139781,115811
852.480574,2,7555,7544,11,-11,126900,127300,38830,-703230,-706035
852.480574,3,1106,1013,93,-93,126900,127300,32509,231691,207976
852.480574,4,120,50,70,-70,126900,127300,-2139,-30461,-48311
852.480574,5,5182,5144,38,-38,126900,127300,16795,-434795,-444485
852.480574,6,0,0,0,0,126900,127300,0,0,0
852.797465,0,925,825,100,-100,126900,126800,43899,339801,349801
852.797465,1,848,754,94,-94,126900,126800,40319,139781,149181
852.797465,2,7555,7554,1,-1,126900,126800,39084,-703484,-703384
852.797465,3,1106,1020,86,-86,126900,126800,32687,231513,240113
852.797465,4,120,50,70,-70,126900,126800,-2139,-30461,-23461
852.797465,5,5182,5144,38,-38,126900,126800,16795,-434795,-430995
852.797465,6,0,0,0,0,126900,126800,0,0,0
852.993713,0,925,825,100,-100,126900,126800,43899,339801,349801
852.993713,1,848,816,32,-32,126900,126800,41894,144406,147606
852.993713,2,7555,7564,-9,9,126900,126800,39338,-702738,-703638
852.993713,3,1106,1027,79,-79,126900,126800,32865,232035,239935
852.993713,4,120,50,70,-70,126900,126800,-2139,-30461,-23461
852.993713,5,5182,5144,38,-38,126900,126800,16795,-434795,-430995
852.993713,6,0,0,0,0,126900,126800,0,0,0
853.300556,0,925,825,100,-100,126900,126800,43899,339801,349801
853.300556,1,848,816,32,-32,126900,126800,41894,144406,147606
853.300556,2,7555,7564,-9,9,126900,126800,39338,-702738,-703638
853.300556,3,1106,1027,79,-79,126900,126800,32865,232035,239935
853.300556,4,120,50,70,-70,126900,126800,-2139,-30461,-23461
853.300556,5,5182,5144,38,-38,126900,126800,16795,-434795,-430995
853.300556,6,0,0,0,0,126900,126800,0,0,0
853.479243,0,925,825,100,-100,126400,126600,43899,339801,319801
853.479243,1,848,816,32,-32,126400,126600,41894,144406,138006
853.479243,2,7565,7564,1,-1,126400,126600,39211,-703611,-703811
853.479243,3,1106,1039,67,-67,126400,126600,33169,229931,216531
853.479243,4,120,50,70,-70,126400,126600,-2139,-30461,-44461
853.479243,5,5182,5144,38,-38,126400,126600,16795,-434795,-442395
853.479243,6,0,0,0,0,126400,126600,0,0,0
853.777799,0,925,825,100,-100,126500,126600,43899,339801,329801
853.777799,1,848,816,32,-32,126500,126600,41894,144406,141206
853.777799,2,7570,7564,6,-6,126500,126600,39148,-703548,-704148
853.777799,3,1106,1044,62,-62,126500,126600,33295,228805,222605
853.777799,4,120,50,70,-70,126500,126600,-2139,-30461,-37461
853.777799,5,5182,5144,38,-38,126500,126600,16795,-434795,-438595
853.777799,6,0,0,0,0,126500,126600,0,0,0
854.006085,0,925,825,100,-100,126500,126600,43899,339801,329801
854.006085,1,848,816,32,-32,126500,126600,41894,144406,141206
854.006085,2,7570,7564,6,-6,126500,126600,39148,-703548,-704148
854.006085,3,1106,1044,62,-62,126500,126600,33295,228805,222605
854.006085,4,120,50,70,-70,126500,126600,-2139,-30461,-37461
854.006085,5,5182,5144,38,-38,126500,126600,16795,-434795,-438595
854.006085,6,0,0,0,0,126500,126600,0,0,0
854.294522,0,925,825,100,-100,126400,126400,43899,339801,339801
854.294522,1,848,816,32,-32,126400,126400,41894,144406,144406
854.294522,2,7570,7564,6,-6,126400,126400,39148,-703548,-703548
854.294522,3,1106,1044,62,-62,126400,126400,33295,228805,228805
854.294522,4,120,50,70,-70,126400,126400,-2139,-30461,-30461
854.294522,5,5182,5144,38,-38,126400,126400,16795,-434795,-434795
854.294522,6,0,0,0,0,126400,126400,0,0,0
854.548624,0,925,825,100,-100,126300,126400,43899,339801,329801
854.548624,1,848,816,32,-32,126300,126400,41894,144406,141206
854.548624,2,7575,7571,4,-4,126300,126400,39262,-703662,-704062
854.548624,3,1106,1049,57,-57,126300,126400,33421,228179,222479
854.548624,4,120,50,70,-70,126300,126400,-2139,-30461,-37461
854.548624,5,5182,5144,38,-38,126300,126400,16795,-434795,-438595
854.548624,6,0,0,0,0,126300,126400,0,0,0
854.763545,0,925,825,100,-100,125800,126400,43899,339801,314501
854.763545,1,848,816,32,-32,125800,126400,41894,144406,136310
854.763545,2,7580,7572,8,-8,125800,126400,39186,-703586,-705610
854.763545,3,1108,1049,59,-59,125800,126400,33396,228804,213877
854.763545,4,120,50,70,-70,125800,126400,-2139,-30461,-48171
854.763545,5,5192,5144,48,-48,125800,126400,16669,-432669,-444813
854.763545,6,0,0,0,0,125800,126400,0,0,0
855.007683,0,925,825,100,-100,125800,126400,43899,339801,314501
855.007683,1,848,816,32,-32,125800,126400,41894,144406,136310
855.007683,2,7580,7572,8,-8,125800,126400,39186,-703586,-705610
855.007683,3,1108,1049,59,-59,125800,126400,33396,228804,213877
855.007683,4,120,50,70,-70,125800,126400,-2139,-30461,-48171
855.007683,5,5192,5144,48,-48,125800,126400,16669,-432669,-444813
855.007683,6,0,0,0,0,125800,126400,0,0,0
855.249757,0,925,825,100,-100,125800,126400,43899,339801,314501
855.249757,1,848,816,32,-32,125800,126400,41894,144406,136310
855.249757,2,7580,7572,8,-8,125800,126400,39186,-703586,-705610
855.249757,3,1108,1049,59,-59,125800,126400,33396,228804,213877
855.249757,4,120,50,70,-70,125800,126400,-2139,-30461,-48171
855.249757,5,5192,5144,48,-48,125800,126400,16669,-432669,-444813
855.249757,6,0,0,0,0,125800,126400,0,0,0
855.501354,0,925,825,100,-100,126300,126300,43899,339801,339801
855.501354,1,848,816,32,-32,126300,126300,41894,144406,144406
855.501354,2,7590,7572,18,-18,126300,126300,39060,-703460,-703460
855.501354,3,1108,1049,59,-59,126300,126300,33396,228804,228804
855.501354,4,120,50,70,-70,126300,126300,-2139,-30461,-30461
855.501354,5,5192,5154,38,-38,126300,126300,16922,-433922,-433922
855.501354,6,0,0,0,0,126300,126300,0,0,0
855.709663,0,925,825,100,-100,126000,126300,43899,339801,314501
855.709663,1,848,816,32,-32,126000,126300,41894,144406,136310
855.709663,2,7590,7572,18,-18,126000,126300,39060,-703460,-708014
855.709663,3,1108,1053,55,-55,126000,126300,33497,227503,213588
855.709663,4,120,50,70,-70,126000,126300,-2139,-30461,-48171
855.709663,5,5196,5154,42,-42,126000,126300,16872,-433072,-443698
855.709663,6,0,0,0,0,126000,126300,0,0,0
855.98638,0,925,825,100,-100,126000,126300,43899,339801,314501
855.98638,1,848,816,32,-32,126000,126300,41894,144406,136310
855.98638,2,7590,7572,18,-18,126000,126300,39060,-703460,-708014
855.98638,3,1108,1053,55,-55,126000,126300,33497,227503,213588
855.98638,4,120,50,70,-70,126000,126300,-2139,-30461,-48171
855.98638,5,5196,5154,42,-42,126000,126300,16872,-433072,-443698
855.98638,6,0,0,0,0,126000,126300,0,0,0
856.225898,0,925,825,100,-100,126000,126300,43899,339801,314501
856.225898,1,848,816,32,-32,126000,126300,41894,144406,136310
856.225898,2,7590,7572,18,-18,126000,126300,39060,-703460,-708014
856.225898,3,1108,1053,55,-55,126000,126300,33497,227503,213588
856.225898,4,120,50,70,-70,126000,126300,-2139,-30461,-48171
856.225898,5,5196,5154,42,-42,126000,126300,16872,-433072,-443698
856.225898,6,0,0,0,0,126000,126300,0,0,0
856.481794,0,925,825,100,-100,126000,126300,43899,339801,314501
856.481794,1,848,816,32,-32,126000,126300,41894,144406,136310
856.481794,2,7590,7572,18,-18,126000,126300,39060,-703460,-708014
856.481794,3,1108,1053,55,-55,126000,126300,33497,227503,213588
856.481794,4,120,50,70,-70,126000,126300,-2139,-30461,-48171
856.481794,5,5196,5154,42,-42,126000,126300,16872,-433072,-443698
856.481794,6,0,0,0,0,126000,126300,0,0,0
856.711827,0,925,825,100,-100,126000,126300,43899,339801,314501
856.711827,1,848,816,32,-32,126000,126300,41894,144406,136310
856.711827,2,7590,7572,18,-18,126000,126300,39060,-703460,-708014
856.711827,3,1108,1053,55,-55,126000,126300,33497,227503,213588
856.711827,4,120,50,70,-70,126000,126300,-2139,-30461,-48171
856.711827,5,5196,5154,42,-42,126000,126300,16872,-433072,-443698
856.711827,6,0,0,0,0,126000,126300,0,0,0
856.987366,0,925,825,100,-100,126000,126300,43899,339801,314501
856.987366,1,848,816,32,-32,126000,126300,41894,144406,136310
856.987366,2,7600,7572,28,-28,126000,126300,38934,-701334,-708418
856.987366,3,1108,1053,55,-55,126000,126300,33497,227503,213588
856.987366,4,120,50,70,-70,126000,126300,-2139,-30461,-48171
856.987366,5,5196,5164,32,-32,126000,126300,17124,-437324,-445420
856.987366,6,0,0,0,0,126000,126300,0,0,0
857.260605,0,925,825,100,-100,126200,126300,43899,339801,329801
857.260605,1,848,816,32,-32,126200,126300,41894,144406,141206
857.260605,2,7600,7582,18,-18,126200,126300,38808,-703208,-705008
857.260605,3,1108,1053,55,-55,126200,126300,33497,227503,222003
857.260605,4,120,50,70,-70,126200,126300,-2139,-30461,-37461
857.260605,5,5196,5164,32,-32,126200,126300,17124,-437324,-440524
857.260605,6,0,0,0,0,126200,126300,0,0,0
857.545654,0,925,825,100,-100,126200,126300,43899,339801,329801
857.545654,1,861,816,45,-45,126200,126300,42222,147978,143478
857.545654,2,7610,7582,28,-28,126200,126300,39060,-700460,-703260
857.545654,3,1112,1053,59,-59,126200,126300,33597,228603,222703
857.545654,4,120,50,70,-70,126200,126300,-2139,-30461,-37461
857.545654,5,5196,5164,32,-32,126200,126300,17124,-437324,-440524
857.545654,6,0,0,0,0,126200,126300,0,0,0
857.732822,0,925,825,100,-100,126200,126300,43899,339801,329801
857.732822,1,861,816,45,-45,126200,126300,42222,147978,143478
857.732822,2,7610,7582,28,-28,126200,126300,39060,-700460,-703260
857.732822,3,1112,1053,59,-59,126200,126300,33597,228603,222703
857.732822,4,120,50,70,-70,126200,126300,-2139,-30461,-37461
857.732822,5,5196,5164,32,-32,126200,126300,17124,-437324,-440524
857.732822,6,0,0,0,0,126200,126300,0,0,0
857.972736,0,925,825,100,-100,126200,126300,43899,339801,329801
857.972736,1,871,816,55,-55,126200,126300,42474,148726,143226
857.972736,2,7610,7592,18,-18,126200,126300,38934,-702334,-704134
857.972736,3,1112,1053,59,-59,126200,126300,33597,228603,222703
857.972736,4,120,50,70,-70,126200,126300,-2139,-30461,-37461
857.972736,5,5196,5164,32,-32,126200,126300,17124,-437324,-440524
857.972736,6,0,0,0,0,126200,126300,0,0,0
858.23869,0,925,825,100,-100,126200,126300,43899,339801,329801
858.23869,1,871,816,55,-55,126200,126300,42474,148726,143226
858.23869,2,7610,7592,18,-18,126200,126300,38934,-702334,-704134
858.23869,3,1112,1053,59,-59,126200,126300,33597,228603,222703
858.23869,4,120,50,70,-70,126200,126300,-2139,-30461,-37461
858.23869,5,5196,5164,32,-32,126200,126300,17124,-437324,-440524
858.23869,6,0,0,0,0,126200,126300,0,0,0
858.494326,0,925,825,100,-100,126200,126300,43899,339801,329801
858.494326,1,871,816,55,-55,126200,126300,42474,148726,143226
858.494326,2,7610,7592,18,-18,126200,126300,38934,-702334,-704134
858.494326,3,1112,1053,59,-59,126200,126300,33597,228603,222703
858.494326,4,120,50,70,-70,126200,126300,-2139,-30461,-37461
858.494326,5,5196,5164,32,-32,126200,126300,17124,-437324,-440524
858.494326,6,0,0,0,0,126200,126300,0,0,0
858.704449,0,925,825,100,-100,126200,126300,43899,339801,329801
858.704449,1,871,816,55,-55,126200,126300,42474,148726,143226
858.704449,2,7610,7592,18,-18,126200,126300,38934,-702334,-704134
858.704449,3,1112,1053,59,-59,126200,126300,33597,228603,222703
858.704449,4,120,50,70,-70,126200,126300,-2139,-30461,-37461
858.704449,5,5196,5164,32,-32,126200,126300,17124,-437324,-440524
858.704449,6,0,0,0,0,126200,126300,0,0,0
858.983614,0,925,825,100,-100,125800,126300,43899,339801,314501
858.983614,1,871,816,55,-55,125800,126300,42474,148726,134811
858.983614,2,7620,7592,28,-28,125800,126300,38808,-700208,-707292
858.983614,3,1114,1053,61,-61,125800,126300,33572,229428,213995
858.983614,4,120,50,70,-70,125800,126300,-2139,-30461,-48171
858.983614,5,5206,5164,42,-42,125800,126300,16998,-434198,-444824
858.983614,6,0,0,0,0,125800,126300,0,0,0
859.29525,0,925,825,100,-100,125900,126300,43899,339801,314501
859.29525,1,910,816,94,-94,125900,126300,43457,163343,139561
859.29525,2,7630,7592,38,-38,125900,126300,39060,-696460,-706074
859.29525,3,1116,1053,63,-63,125900,126300,33622,230178,214239
859.29525,4,120,50,70,-70,125900,126300,-2139,-30461,-48171
859.29525,5,5216,5174,42,-42,125900,126300,17124,-435324,-445950
859.29525,6,0,0,0,0,125900,126300,0,0,0
859.4896,0,925,825,100,-100,125900,126300,43899,339801,314501
859.4896,1,910,816,94,-94,125900,126300,43457,163343,139561
859.4896,2,7630,7592,38,-38,125900,126300,39060,-696460,-706074
859.4896,3,1116,1053,63,-63,125900,126300,33622,230178,214239
859.4896,4,120,50,70,-70,125900,126300,-2139,-30461,-48171
859.4896,5,5216,5174,42,-42,125900,126300,17124,-435324,-445950
859.4896,6,0,0,0,0,125900,126300,0,0,0
859.773849,0,925,825,100,-100,126100,126300,43899,339801,319801
859.773849,1,910,816,94,-94,126100,126300,43457,163343,144543
859.773849,2,7630,7602,28,-28,126100,126300,38934,-700334,-705934
859.773849,3,1116,1053,63,-63,126100,126300,33622,230178,217578
859.773849,4,120,50,70,-70,126100,126300,-2139,-30461,-44461
859.773849,5,5216,5174,42,-42,126100,126300,17124,-435324,-443724
859.773849,6,0,0,0,0,126100,126300,0,0,0
860.017202,0,925,825,100,-100,126100,126100,43899,339801,339801
860.017202,1,910,816,94,-94,126100,126100,43457,163343,163343
860.017202,2,7630,7602,28,-28,126100,126100,38934,-700334,-700334
860.017202,3,1116,1053,63,-63,126100,126100,33622,230178,230178
860.017202,4,120,50,70,-70,126100,126100,-2139,-30461,-30461
860.017202,5,5216,5174,42,-42,126100,126100,17124,-435324,-435324
860.017202,6,0,0,0,0,126100,126100,0,0,0
860.210855,0,925,825,100,-100,126100,126000,43899,339801,349801
860.210855,1,910,816,94,-94,126100,126000,43457,163343,172743
860.210855,2,7630,7612,18,-18,126100,126000,39186,-701586,-699786
860.210855,3,1116,1063,53,-53,126100,126000,33874,228926,234226
860.210855,4,120,50,70,-70,126100,126000,-2139,-30461,-23461
860.210855,5,5216,5174,42,-42,126100,126000,17124,-435324,-431124
860.210855,6,0,0,0,0,126100,126000,0,0,0
860.497143,0,925,825,100,-100,126400,126000,43899,339801,365001
860.497143,1,910,816,94,-94,126400,126000,43457,163343,187031
860.497143,2,7630,7622,8,-8,126400,126000,39438,-701838,-699822
860.497143,3,1116,1063,53,-53,126400,126000,33874,228926,242282
860.497143,4,120,50,70,-70,126400,126000,-2139,-30461,-12821
860.497143,5,5216,5174,42,-42,126400,126000,17124,-435324,-424740
860.497143,6,0,0,0,0,126400,126000,0,0,0
860.752668,0,925,825,100,-100,126100,126000,43899,339801,349801
860.752668,1,910,816,94,-94,126100,126000,43457,163343,172743
860.752668,2,7630,7632,-2,2,126100,126000,39690,-702090,-702290
860.752668,3,1116,1067,49,-49,126100,126000,33975,228825,233725
860.752668,4,120,50,70,-70,126100,126000,-2139,-30461,-23461
860.752668,5,5216,5174,42,-42,126100,126000,17124,-435324,-431124
860.752668,6,0,0,0,0,126100,126000,0,0,0
860.966557,0,925,825,100,-100,126100,126000,43899,339801,349801
860.966557,1,910,816,94,-94,126100,126000,43457,163343,172743
860.966557,2,7630,7632,-2,2,126100,126000,39690,-702090,-702290
860.966557,3,1116,1067,49,-49,126100,126000,33975,228825,233725
860.966557,4,120,50,70,-70,126100,126000,-2139,-30461,-23461
860.966557,5,5216,5174,42,-42,126100,126000,17124,-435324,-431124
860.966557,6,0,0,0,0,126100,126000,0,0,0
861.27845,0,925,825,100,-100,126100,126000,43899,339801,349801
861.27845,1,910,816,94,-94,126100,126000,43457,163343,172743
861.27845,2,7630,7632,-2,2,126100,126000,39690,-702090,-702290
861.27845,3,1116,1067,49,-49,126100,126000,33975,228825,233725
861.27845,4,120,50,70,-70,126100,126000,-2139,-30461,-23461
861.27845,5,5216,5174,42,-42,126100,126000,17124,-435324,-431124
861.27845,6,0,0,0,0,126100,126000,0,0,0
861.478931,0,925,825,100,-100,125600,126000,43899,339801,314601
861.478931,1,910,816,94,-94,125600,126000,43457,163343,139655
861.478931,2,7640,7632,8,-8,125600,126000,39564,-703964,-705980
861.478931,3,1118,1067,51,-51,125600,126000,33950,229250,216398
861.478931,4,120,50,70,-70,125600,126000,-2139,-30461,-48101
861.478931,5,5216,5184,32,-32,125600,126000,17376,-437576,-445640
861.478931,6,0,0,0,0,125600,126000,0,0,0
861.790722,0,925,825,100,-100,126000,126000,43899,339801,339801
861.790722,1,910,816,94,-94,126000,126000,43457,163343,163343
861.790722,2,7644,7632,12,-12,126000,126000,39514,-703914,-703914
861.790722,3,1118,1071,47,-47,126000,126000,34051,228349,228349
861.790722,4,120,50,70,-70,126000,126000,-2139,-30461,-30461
861.790722,5,5216,5184,32,-32,126000,126000,17376,-437576,-437576
861.790722,6,0,0,0,0,126000,126000,0,0,0
861.983881,0,925,825,100,-100,126000,126000,43899,339801,339801
861.983881,1,910,816,94,-94,126000,126000,43457,163343,163343
861.983881,2,7644,7632,12,-12,126000,126000,39514,-703914,-703914
861.983881,3,1118,1071,47,-47,126000,126000,34051,228349,228349
861.983881,4,120,50,70,-70,126000,126000,-2139,-30461,-30461
861.983881,5,5216,5184,32,-32,126000,126000,17376,-437576,-437576
861.983881,6,0,0,0,0,126000,126000,0,0,0
862.243571,0,925,825,100,-100,125900,126200,43899,339801,314601
862.243571,1,910,816,94,-94,125900,126200,43457,163343,139655
862.243571,2,7654,7632,22,-22,125900,126200,39388,-701788,-707332
862.243571,3,1118,1071,47,-47,125900,126200,34051,228349,216505
862.243571,4,120,50,70,-70,125900,126200,-2139,-30461,-48101
862.243571,5,5216,5194,22,-22,125900,126200,17628,-440828,-446372
862.243571,6,0,0,0,0,125900,126200,0,0,0
862.547602,0,925,825,100,-100,125900,126300,43899,339801,314501
862.547602,1,910,816,94,-94,125900,126300,43457,163343,139561
862.547602,2,7654,7632,22,-22,125900,126300,39388,-701788,-707354
862.547602,3,1118,1071,47,-47,125900,126300,34051,228349,216458
862.547602,4,120,50,70,-70,125900,126300,-2139,-30461,-48171
862.547602,5,5216,5194,22,-22,125900,126300,17628,-440828,-446394
862.547602,6,0,0,0,0,125900,126300,0,0,0
862.797038,0,925,825,100,-100,125900,126300,43899,339801,314501
862.797038,1,910,816,94,-94,125900,126300,43457,163343,139561
862.797038,2,7654,7632,22,-22,125900,126300,39388,-701788,-707354
862.797038,3,1118,1071,47,-47,125900,126300,34051,228349,216458
862.797038,4,120,50,70,-70,125900,126300,-2139,-30461,-48171
862.797038,5,5216,5194,22,-22,125900,126300,17628,-440828,-446394
862.797038,6,0,0,0,0,125900,126300,0,0,0
863.024464,0,925,825,100,-100,125900,126300,43899,339801,314501
863.024464,1,910,816,94,-94,125900,126300,43457,163343,139561
863.024464,2,7654,7632,22,-22,125900,126300,39388,-701788,-707354
863.024464,3,1118,1071,47,-47,125900,126300,34051,228349,216458
863.024464,4,120,50,70,-70,125900,126300,-2139,-30461,-48171
863.024464,5,5216,5194,22,-22,125900,126300,17628,-440828,-446394
863.024464,6,0,0,0,0,125900,126300,0,0,0
863.299826,0,925,825,100,-100,125900,126300,43899,339801,314501
863.299826,1,910,816,94,-94,125900,126300,43457,163343,139561
863.299826,2,7654,7632,22,-22,125900,126300,39388,-701788,-707354
863.299826,3,1118,1071,47,-47,125900,126300,34051,228349,216458
863.299826,4,120,50,70,-70,125900,126300,-2139,-30461,-48171
863.299826,5,5216,5194,22,-22,125900,126300,17628,-440828,-446394
863.299826,6,0,0,0,0,125900,126300,0,0,0
863.513008,0,925,825,100,-100,126200,126300,43899,339801,329801
863.513008,1,910,816,94,-94,126200,126300,43457,163343,153943
863.513008,2,7654,7632,22,-22,126200,126300,39388,-701788,-703988
863.513008,3,1118,1071,47,-47,126200,126300,34051,228349,223649
863.513008,4,120,50,70,-70,126200,126300,-2139,-30461,-37461
863.513008,5,5216,5194,22,-22,126200,126300,17628,-440828,-443028
863.513008,6,0,0,0,0,126200,126300,0,0,0
863.763783,0,925,825,100,-100,126200,126300,43899,339801,329801
863.763783,1,910,816,94,-94,126200,126300,43457,163343,153943
863.763783,2,7654,7632,22,-22,126200,126300,39388,-701788,-703988
863.763783,3,1118,1071,47,-47,126200,126300,34051,228349,223649
863.763783,4,120,50,70,-70,126200,126300,-2139,-30461,-37461
863.763783,5,5216,5194,22,-22,126200,126300,17628,-440828,-443028
863.763783,6,0,0,0,0,126200,126300,0,0,0
863.968251,0,925,825,100,-100,126200,126300,43899,339801,329801
863.968251,1,910,816,94,-94,126200,126300,43457,163343,153943
863.968251,2,7654,7632,22,-22,126200,126300,39388,-701788,-703988
863.968251,3,1118,1071,47,-47,126200,126300,34051,228349,223649
863.968251,4,120,50,70,-70,126200,126300,-2139,-30461,-37461
863.968251,5,5216,5194,22,-22,126200,126300,17628,-440828,-443028
863.968251,6,0,0,0,0,126200,126300,0,0,0
864.262033,0,925,825,100,-100,126200,126300,43899,339801,329801
864.262033,1,910,816,94,-94,126200,126300,43457,163343,153943
864.262033,2,7654,7632,22,-22,126200,126300,39388,-701788,-703988
864.262033,3,1118,1071,47,-47,126200,126300,34051,228349,223649
864.262033,4,120,50,70,-70,126200,126300,-2139,-30461,-37461
864.262033,5,5216,5194,22,-22,126200,126300,17628,-440828,-443028
864.262033,6,0,0,0,0,126200,126300,0,0,0
864.540629,0,925,825,100,-100,126200,126300,43899,339801,329801
864.540629,1,910,816,94,-94,126200,126300,43457,163343,153943
864.540629,2,7654,7632,22,-22,126200,126300,39388,-701788,-703988
864.540629,3,1118,1071,47,-47,126200,126300,34051,228349,223649
864.540629,4,120,50,70,-70,126200,126300,-2139,-30461,-37461
864.540629,5,5216,5194,22,-22,126200,126300,17628,-440828,-443028
864.540629,6,0,0,0,0,126200,126300,0,0,0
864.797654,0,925,825,100,-100,125700,126300,43899,339801,314501
864.797654,1,910,816,94,-94,125700,126300,43457,163343,139561
864.797654,2,7664,7632,32,-32,125700,126300,39262,-699662,-707758
864.797654,3,1120,1071,49,-49,125700,126300,34026,228974,216577
864.797654,4,120,50,70,-70,125700,126300,-2139,-30461,-48171
864.797654,5,5216,5194,22,-22,125700,126300,17628,-440828,-446394
864.797654,6,0,0,0,0,125700,126300,0,0,0
865.045994,0,925,825,100,-100,125700,126300,43899,339801,314501
865.045994,1,910,816,94,-94,125700,126300,43457,163343,139561
865.045994,2,7664,7632,32,-32,125700,126300,39262,-699662,-707758
865.045994,3,1120,1071,49,-49,125700,126300,34026,228974,216577
865.045994,4,120,50,70,-70,125700,126300,-2139,-30461,-48171
865.045994,5,5216,5194,22,-22,125700,126300,17628,-440828,-446394
865.045994,6,0,0,0,0,125700,126300,0,0,0
865.20274,0,925,825,100,-100,125700,126300,43899,339801,314501
865.20274,1,910,816,94,-94,125700,126300,43457,163343,139561
865.20274,2,7664,7632,32,-32,125700,126300,39262,-699662,-707758
865.20274,3,1120,1071,49,-49,125700,126300,34026,228974,216577
865.20274,4,120,50,70,-70,125700,126300,-2139,-30461,-48171
865.20274,5,5216,5194,22,-22,125700,126300,17628,-440828,-446394
865.20274,6,0,0,0,0,125700,126300,0,0,0
865.498872,0,925,825,100,-100,126200,126300,43899,339801,329801
865.498872,1,910,816,94,-94,126200,126300,43457,163343,153943
865.498872,2,7664,7632,32,-32,126200,126300,39262,-699662,-702862
865.498872,3,1120,1071,49,-49,126200,126300,34026,228974,224074
865.498872,4,120,50,70,-70,126200,126300,-2139,-30461,-37461
865.498872,5,5216,5194,22,-22,126200,126300,17628,-440828,-443028
865.498872,6,0,0,0,0,126200,126300,0,0,0
865.789859,0,925,825,100,-100,126200,126300,43899,339801,329801
865.789859,1,910,816,94,-94,126200,126300,43457,163343,153943
865.789859,2,7664,7632,32,-32,126200,126300,39262,-699662,-702862
865.789859,3,1120,1071,49,-49,126200,126300,34026,228974,224074
865.789859,4,120,50,70,-70,126200,126300,-2139,-30461,-37461
865.789859,5,5216,5194,22,-22,126200,126300,17628,-440828,-443028
865.789859,6,0,0,0,0,126200,126300,0,0,0
866.034986,0,925,825,100,-100,126200,126300,43899,339801,329801
866.034986,1,910,816,94,-94,126200,126300,43457,163343,153943
866.034986,2,7664,7632,32,-32,126200,126300,39262,-699662,-702862
866.034986,3,1120,1071,49,-49,126200,126300,34026,228974,224074
866.034986,4,120,50,70,-70,126200,126300,-2139,-30461,-37461
866.034986,5,5216,5194,22,-22,126200,126300,17628,-440828,-443028
866.034986,6,0,0,0,0,126200,126300,0,0,0
866.209726,0,925,825,100,-100,126000,126300,43899,339801,314501
866.209726,1,910,816,94,-94,126000,126300,43457,163343,139561
866.209726,2,7664,7642,22,-22,126000,126300,39514,-701914,-707480
866.209726,3,1122,1071,51,-51,126000,126300,34001,228999,216096
866.209726,4,120,50,70,-70,126000,126300,-2139,-30461,-48171
866.209726,5,5224,5194,30,-30,126000,126300,17527,-440727,-448317
866.209726,6,0,0,0,0,126000,126300,0,0,0
866.485975,0,925,825,100,-100,126000,126300,43899,339801,314501
866.485975,1,910,816,94,-94,126000,126300,43457,163343,139561
866.485975,2,7664,7642,22,-22,126000,126300,39514,-701914,-707480
866.485975,3,1122,1071,51,-51,126000,126300,34001,228999,216096
866.485975,4,120,50,70,-70,126000,126300,-2139,-30461,-48171
866.485975,5,5224,5194,30,-30,126000,126300,17527,-440727,-448317
866.485975,6,0,0,0,0,126000,126300,0,0,0
866.751492,0,925,825,100,-100,126000,126300,43899,339801,314501
866.751492,1,910,816,94,-94,126000,126300,43457,163343,139561
866.751492,2,7664,7652,12,-12,126000,126300,39388,-703788,-706824
866.751492,3,1122,1071,51,-51,126000,126300,34001,228999,216096
866.751492,4,120,50,70,-70,126000,126300,-2139,-30461,-48171
866.751492,5,5224,5194,30,-30,126000,126300,17527,-440727,-448317
866.751492,6,0,0,0,0,126000,126300,0,0,0
866.974954,0,925,825,100,-100,126000,126300,43899,339801,314501
866.974954,1,910,816,94,-94,126000,126300,43457,163343,139561
866.974954,2,7664,7652,12,-12,126000,126300,39388,-703788,-706824
866.974954,3,1122,1071,51,-51,126000,126300,34001,228999,216096
866.974954,4,120,50,70,-70,126000,126300,-2139,-30461,-48171
866.974954,5,5224,5194,30,-30,126000,126300,17527,-440727,-448317
866.974954,6,0,0,0,0,126000,126300,0,0,0
867.2716,0,925,825,100,-100,126000,126300,43899,339801,314501
867.2716,1,910,816,94,-94,126000,126300,43457,163343,139561
867.2716,2,7664,7652,12,-12,126000,126300,39388,-703788,-706824
867.2716,3,1122,1071,51,-51,126000,126300,34001,228999,216096
867.2716,4,120,50,70,-70,126000,126300,-2139,-30461,-48171
867.2716,5,5224,5194,30,-30,126000,126300,17527,-440727,-448317
867.2716,6,0,0,0,0,126000,126300,0,0,0
867.501372,0,925,825,100,-100,126200,126300,43899,339801,329801
867.501372,1,910,816,94,-94,126200,126300,43457,163343,153943
867.501372,2,7664,7662,2,-2,126200,126300,39640,-705040,-705240
867.501372,3,1122,1071,51,-51,126200,126300,34001,228999,223899
867.501372,4,120,50,70,-70,126200,126300,-2139,-30461,-37461
867.501372,5,5224,5194,30,-30,126200,126300,17527,-440727,-443727
867.501372,6,0,0,0,0,126200,126300,0,0,0
867.754609,0,925,825,100,-100,126200,126300,43899,339801,329801
867.754609,1,910,816,94,-94,126200,126300,43457,163343,153943
867.754609,2,7674,7662,12,-12,126200,126300,39892,-705292,-706492
867.754609,3,1122,1071,51,-51,126200,126300,34001,228999,223899
867.754609,4,120,50,70,-70,126200,126300,-2139,-30461,-37461
867.754609,5,5224,5194,30,-30,126200,126300,17527,-440727,-443727
867.754609,6,0,0,0,0,126200,126300,0,0,0
868.025875,0,925,825,100,-100,126200,126300,43899,339801,329801
868.025875,1,910,816,94,-94,126200,126300,43457,163343,153943
868.025875,2,7674,7662,12,-12,126200,126300,39892,-705292,-706492
868.025875,3,1122,1071,51,-51,126200,126300,34001,228999,223899
868.025875,4,120,50,70,-70,126200,126300,-2139,-30461,-37461
868.025875,5,5224,5194,30,-30,126200,126300,17527,-440727,-443727
868.025875,6,0,0,0,0,126200,126300,0,0,0
868.257496,0,925,825,100,-100,126200,126300,43899,339801,329801
868.257496,1,910,816,94,-94,126200,126300,43457,163343,153943
868.257496,2,7674,7662,12,-12,126200,126300,39892,-705292,-706492
868.257496,3,1122,1071,51,-51,126200,126300,34001,228999,223899
868.257496,4,120,50,70,-70,126200,126300,-2139,-30461,-37461
868.257496,5,5224,5194,30,-30,126200,126300,17527,-440727,-443727
868.257496,6,0,0,0,0,126200,126300,0,0,0
868.452283,0,925,825,100,-100,126200,126300,43899,339801,329801
868.452283,1,910,816,94,-94,126200,126300,43457,163343,153943
868.452283,2,7684,7662,22,-22,126200,126300,40144,-704544,-706744
868.452283,3,1122,1071,51,-51,126200,126300,34001,228999,223899
868.452283,4,120,50,70,-70,126200,126300,-2139,-30461,-37461
868.452283,5,5224,5194,30,-30,126200,126300,17527,-440727,-443727
868.452283,6,0,0,0,0,126200,126300,0,0,0
868.793751,0,925,825,100,-100,126000,126300,43899,339801,314501
868.793751,1,910,816,94,-94,126000,126300,43457,163343,139561
868.793751,2,7684,7662,22,-22,126000,126300,40144,-704544,-710110
868.793751,3,1122,1071,51,-51,126000,126300,34001,228999,216096
868.793751,4,120,50,70,-70,126000,126300,-2139,-30461,-48171
868.793751,5,5224,5204,20,-20,126000,126300,17779,-443979,-449039
868.793751,6,0,0,0,0,126000,126300,0,0,0
869.022848,0,925,825,100,-100,126000,126300,43899,339801,314501
869.022848,1,910,816,94,-94,126000,126300,43457,163343,139561
869.022848,2,7684,7662,22,-22,126000,126300,40144,-704544,-710110
869.022848,3,1122,1071,51,-51,126000,126300,34001,228999,216096
869.022848,4,120,50,70,-70,126000,126300,-2139,-30461,-48171
869.022848,5,5224,5204,20,-20,126000,126300,17779,-443979,-449039
869.022848,6,0,0,0,0,126000,126300,0,0,0
869.276723,0,925,825,100,-100,126000,126300,43899,339801,314501
869.276723,1,910,816,94,-94,126000,126300,43457,163343,139561
869.276723,2,7684,7662,22,-22,126000,126300,40144,-704544,-710110
869.276723,3,1122,1071,51,-51,126000,126300,34001,228999,216096
869.276723,4,120,50,70,-70,126000,126300,-2139,-30461,-48171
869.276723,5,5224,5204,20,-20,126000,126300,17779,-443979,-449039
869.276723,6,0,0,0,0,126000,126300,0,0,0
869.509593,0,925,825,100,-100,126200,126300,43899,339801,329801
869.509593,1,910,816,94,-94,126200,126300,43457,163343,153943
869.509593,2,7694,7662,32,-32,126200,126300,40396,-701796,-704996
869.509593,3,1126,1071,55,-55,126200,126300,34101,230099,224599
869.509593,4,120,50,70,-70,126200,126300,-2139,-30461,-37461
869.509593,5,5234,5204,30,-30,126200,126300,18031,-441231,-444231
869.509593,6,0,0,0,0,126200,126300,0,0,0
869.781838,0,925,825,100,-100,126200,126500,43899,339801,314501
869.781838,1,910,816,94,-94,126200,126500,43457,163343,139561
869.781838,2,7704,7662,42,-42,126200,126500,40648,-699048,-709674
869.781838,3,1128,1071,57,-57,126200,126500,34151,230649,216228
869.781838,4,120,50,70,-70,126200,126500,-2139,-30461,-48171
869.781838,5,5234,5204,30,-30,126200,126500,18031,-441231,-448821
869.781838,6,0,0,0,0,126200,126500,0,0,0
869.963217,0,925,825,100,-100,126000,126500,43899,339801,314501
869.963217,1,910,816,94,-94,126000,126500,43457,163343,139561
869.963217,2,7704,7672,32,-32,126000,126500,40900,-703300,-711396
869.963217,3,1128,1071,57,-57,126000,126500,34151,230649,216228
869.963217,4,120,50,70,-70,126000,126500,-2139,-30461,-48171
869.963217,5,5239,5204,35,-35,126000,126500,17968,-440168,-449023
869.963217,6,0,0,0,0,126000,126500,0,0,0
870.261481,0,925,825,100,-100,126000,126500,43899,339801,314501
870.261481,1,910,816,94,-94,126000,126500,43457,163343,139561
870.261481,2,7704,7672,32,-32,126000,126500,40900,-703300,-711396
870.261481,3,1128,1071,57,-57,126000,126500,34151,230649,216228
870.261481,4,120,50,70,-70,126000,126500,-2139,-30461,-48171
870.261481,5,5239,5204,35,-35,126000,126500,17968,-440168,-449023
870.261481,6,0,0,0,0,126000,126500,0,0,0
870.542852,0,925,825,100,-100,126000,126100,43899,339801,329801
870.542852,1,910,816,94,-94,126000,126100,43457,163343,153943
870.542852,2,7704,7672,32,-32,126000,126100,40900,-703300,-706500
870.542852,3,1128,1071,57,-57,126000,126100,34151,230649,224949
870.542852,4,120,50,70,-70,126000,126100,-2139,-30461,-37461
870.542852,5,5239,5204,35,-35,126000,126100,17968,-440168,-443668
870.542852,6,0,0,0,0,126000,126100,0,0,0
870.767425,0,925,825,100,-100,126000,126100,43899,339801,329801
870.767425,1,910,816,94,-94,126000,126100,43457,163343,153943
870.767425,2,7704,7672,32,-32,126000,126100,40900,-703300,-706500
870.767425,3,1128,1071,57,-57,126000,126100,34151,230649,224949
870.767425,4,120,50,70,-70,126000,126100,-2139,-30461,-37461
870.767425,5,5239,5204,35,-35,126000,126100,17968,-440168,-443668
870.767425,6,0,0,0,0,126000,126100,0,0,0
871.038557,0,925,825,100,-100,126000,126100,43899,339801,329801
871.038557,1,910,816,94,-94,126000,126100,43457,163343,153943
871.038557,2,7704,7672,32,-32,126000,126100,40900,-703300,-706500
871.038557,3,1128,1071,57,-57,126000,126100,34151,230649,224949
871.038557,4,120,50,70,-70,126000,126100,-2139,-30461,-37461
871.038557,5,5239,5204,35,-35,126000,126100,17968,-440168,-443668
871.038557,6,0,0,0,0,126000,126100,0,0,0
871.233098,0,925,825,100,-100,126000,126100,43899,339801,329801
871.233098,1,910,816,94,-94,126000,126100,43457,163343,153943
871.233098,2,7704,7672,32,-32,126000,126100,40900,-703300,-706500
871.233098,3,1128,1071,57,-57,126000,126100,34151,230649,224949
871.233098,4,120,50,70,-70,126000,126100,-2139,-30461,-37461
871.233098,5,5239,5204,35,-35,126000,126100,17968,-440168,-443668
871.233098,6,0,0,0,0,126000,126100,0,0,0
871.517906,0,925,825,100,-100,126000,126100,43899,339801,329801
871.517906,1,910,816,94,-94,126000,126100,43457,163343,153943
871.517906,2,7704,7672,32,-32,126000,126100,40900,-703300,-706500
871.517906,3,1128,1071,57,-57,126000,126100,34151,230649,224949
871.517906,4,120,50,70,-70,126000,126100,-2139,-30461,-37461
871.517906,5,5239,5204,35,-35,126000,126100,17968,-440168,-443668
871.517906,6,0,0,0,0,126000,126100,0,0,0
871.742055,0,925,825,100,-100,126200,126100,43899,339801,349801
871.742055,1,910,816,94,-94,126200,126100,43457,163343,172743
871.742055,2,7704,7682,22,-22,126200,126100,40774,-707174,-704974
871.742055,3,1128,1071,57,-57,126200,126100,34151,230649,236349
871.742055,4,120,50,70,-70,126200,126100,-2139,-30461,-23461
871.742055,5,5239,5214,25,-25,126200,126100,17842,-445042,-442542
871.742055,6,0,0,0,0,126200,126100,0,0,0
872.045537,0,925,825,100,-100,126200,126100,43899,339801,349801
872.045537,1,910,816,94,-94,126200,126100,43457,163343,172743
872.045537,2,7704,7682,22,-22,126200,126100,40774,-707174,-704974
872.045537,3,1128,1071,57,-57,126200,126100,34151,230649,236349
872.045537,4,120,50,70,-70,126200,126100,-2139,-30461,-23461
872.045537,5,5239,5214,25,-25,126200,126100,17842,-445042,-442542
872.045537,6,0,0,0,0,126200,126100,0,0,0
872.293484,0,925,825,100,-100,125500,126100,43899,339801,314601
872.293484,1,910,816,94,-94,125500,126100,43457,163343,139655
872.293484,2,7714,7682,32,-32,125500,126100,40648,-705048,-713112
872.293484,3,1130,1071,59,-59,125500,126100,34126,231274,216406
872.293484,4,120,50,70,-70,125500,126100,-2139,-30461,-48101
872.293484,5,5249,5214,35,-35,125500,126100,17716,-443916,-452736
872.293484,6,0,0,0,0,125500,126100,0,0,0
872.527958,0,925,825,100,-100,125700,126100,43899,339801,314601
872.527958,1,910,816,94,-94,125700,126100,43457,163343,139655
872.527958,2,7714,7682,32,-32,125700,126100,40648,-705048,-713112
872.527958,3,1130,1071,59,-59,125700,126100,34126,231274,216406
872.527958,4,120,50,70,-70,125700,126100,-2139,-30461,-48101
872.527958,5,5259,5214,45,-45,125700,126100,17590,-441790,-453130
872.527958,6,0,0,0,0,125700,126100,0,0,0
872.769692,0,925,825,100,-100,125700,126000,43899,339801,314601
872.769692,1,910,816,94,-94,125700,126000,43457,163343,139655
872.769692,2,7714,7682,32,-32,125700,126000,40648,-705048,-713112
872.769692,3,1130,1071,59,-59,125700,126000,34126,231274,216406
872.769692,4,120,50,70,-70,125700,126000,-2139,-30461,-48101
872.769692,5,5259,5214,45,-45,125700,126000,17590,-441790,-453130
872.769692,6,0,0,0,0,125700,126000,0,0,0
872.968017,0,925,825,100,-100,125700,126000,43899,339801,314601
872.968017,1,910,816,94,-94,125700,126000,43457,163343,139655
872.968017,2,7714,7682,32,-32,125700,126000,40648,-705048,-713112
872.968017,3,1130,1071,59,-59,125700,126000,34126,231274,216406
872.968017,4,120,50,70,-70,125700,126000,-2139,-30461,-48101
872.968017,5,5259,5214,45,-45,125700,126000,17590,-441790,-453130
872.968017,6,0,0,0,0,125700,126000,0,0,0
873.228344,0,925,825,100,-100,125700,126000,43899,339801,314601
873.228344,1,910,816,94,-94,125700,126000,43457,163343,139655
873.228344,2,7714,7682,32,-32,125700,126000,40648,-705048,-713112
873.228344,3,1130,1071,59,-59,125700,126000,34126,231274,216406
873.228344,4,120,50,70,-70,125700,126000,-2139,-30461,-48101
873.228344,5,5259,5214,45,-45,125700,126000,17590,-441790,-453130
873.228344,6,0,0,0,0,125700,126000,0,0,0
873.509166,0,925,825,100,-100,125700,126000,43899,339801,314601
873.509166,1,910,816,94,-94,125700,126000,43457,163343,139655
873.509166,2,7714,7682,32,-32,125700,126000,40648,-705048,-713112
873.509166,3,1130,1071,59,-59,125700,126000,34126,231274,216406
873.509166,4,120,50,70,-70,125700,126000,-2139,-30461,-48101
873.509166,5,5259,5214,45,-45,125700,126000,17590,-441790,-453130
873.509166,6,0,0,0,0,125700,126000,0,0,0
873.701549,0,925,825,100,-100,125700,125800,43899,339801,329801
873.701549,1,910,816,94,-94,125700,125800,43457,163343,153943
873.701549,2,7714,7692,22,-22,125700,125800,40899,-708299,-710499
873.701549,3,1130,1071,59,-59,125700,125800,34126,231274,225374
873.701549,4,120,50,70,-70,125700,125800,-2139,-30461,-37461
873.701549,5,5259,5214,45,-45,125700,125800,17590,-441790,-446290
873.701549,6,0,0,0,0,125700,125800,0,0,0
874.025297,0,925,825,100,-100,125700,125800,43899,339801,329801
874.025297,1,910,816,94,-94,125700,125800,43457,163343,153943
874.025297,2,7714,7702,12,-12,125700,125800,41150,-709550,-710750
874.025297,3,1130,1071,59,-59,125700,125800,34126,231274,225374
874.025297,4,120,50,70,-70,125700,125800,-2139,-30461,-37461
874.025297,5,5259,5214,45,-45,125700,125800,17590,-441790,-446290
874.025297,6,0,0,0,0,125700,125800,0,0,0
874.278657,0,925,825,100,-100,125600,125800,43899,339801,319801
874.278657,1,910,816,94,-94,125600,125800,43457,163343,144543
874.278657,2,7715,7712,3,-3,125600,125800,41388,-710688,-711288
874.278657,3,1130,1071,59,-59,125600,125800,34126,231274,219474
874.278657,4,120,50,70,-70,125600,125800,-2139,-30461,-44461
874.278657,5,5259,5224,35,-35,125600,125800,17841,-443141,-450141
874.278657,6,0,0,0,0,125600,125800,0,0,0
874.482657,0,925,825,100,-100,125500,125800,43899,339801,314601
874.482657,1,910,816,94,-94,125500,125800,43457,163343,139655
874.482657,2,7724,7712,12,-12,125500,125800,41275,-710575,-713599
874.482657,3,1130,1071,59,-59,125500,125800,34126,231274,216406
874.482657,4,120,50,70,-70,125500,125800,-2139,-30461,-48101
874.482657,5,5259,5234,25,-25,125500,125800,18092,-445492,-451792
874.482657,6,0,0,0,0,125500,125800,0,0,0
874.720843,0,925,825,100,-100,125500,125800,43899,339801,314601
874.720843,1,910,816,94,-94,125500,125800,43457,163343,139655
874.720843,2,7724,7712,12,-12,125500,125800,41275,-710575,-713599
874.720843,3,1130,1071,59,-59,125500,125800,34126,231274,216406
874.720843,4,120,50,70,-70,125500,125800,-2139,-30461,-48101
874.720843,5,5259,5234,25,-25,125500,125800,18092,-445492,-451792
874.720843,6,0,0,0,0,125500,125800,0,0,0
874.995629,0,925,825,100,-100,125500,125800,43899,339801,314601
874.995629,1,910,816,94,-94,125500,125800,43457,163343,139655
874.995629,2,7724,7712,12,-12,125500,125800,41275,-710575,-713599
874.995629,3,1130,1071,59,-59,125500,125800,34126,231274,216406
874.995629,4,120,50,70,-70,125500,125800,-2139,-30461,-48101
874.995629,5,5259,5234,25,-25,125500,125800,18092,-445492,-451792
874.995629,6,0,0,0,0,125500,125800,0,0,0
875.214055,0,925,825,100,-100,125500,125800,43899,339801,314601
875.214055,1,910,816,94,-94,125500,125800,43457,163343,139655
875.214055,2,7724,7712,12,-12,125500,125800,41275,-710575,-713599
875.214055,3,1130,1071,59,-59,125500,125800,34126,231274,216406
875.214055,4,120,50,70,-70,125500,125800,-2139,-30461,-48101
875.214055,5,5259,5234,25,-25,125500,125800,18092,-445492,-451792
875.214055,6,0,0,0,0,125500,125800,0,0,0
875.451343,0,925,825,100,-100,125500,125800,43899,339801,314601
875.451343,1,910,816,94,-94,125500,125800,43457,163343,139655
875.451343,2,7724,7712,12,-12,125500,125800,41275,-710575,-713599
875.451343,3,1130,1071,59,-59,125500,125800,34126,231274,216406
875.451343,4,120,50,70,-70,125500,125800,-2139,-30461,-48101
875.451343,5,5259,5234,25,-25,125500,125800,18092,-445492,-451792
875.451343,6,0,0,0,0,125500,125800,0,0,0
875.712663,0,925,825,100,-100,125500,125800,43899,339801,314601
875.712663,1,910,816,94,-94,125500,125800,43457,163343,139655
875.712663,2,7724,7712,12,-12,125500,125800,41275,-710575,-713599
875.712663,3,1130,1071,59,-59,125500,125800,34126,231274,216406
875.712663,4,120,50,70,-70,125500,125800,-2139,-30461,-48101
875.712663,5,5259,5234,25,-25,125500,125800,18092,-445492,-451792
875.712663,6,0,0,0,0,125500,125800,0,0,0
875.989671,0,925,825,100,-100,125500,125800,43899,339801,314601
875.989671,1,910,816,94,-94,125500,125800,43457,163343,139655
875.989671,2,7724,7712,12,-12,125500,125800,41275,-710575,-713599
875.989671,3,1130,1071,59,-59,125500,125800,34126,231274,216406
875.989671,4,120,50,70,-70,125500,125800,-2139,-30461,-48101
875.989671,5,5259,5234,25,-25,125500,125800,18092,-445492,-451792
875.989671,6,0,0,0,0,125500,125800,0,0,0
876.288784,0,925,825,100,-100,125800,125900,43899,339801,329801
876.288784,1,910,816,94,-94,125800,125900,43457,163343,153943
876.288784,2,7724,7712,12,-12,125800,125900,41275,-710575,-711775
876.288784,3,1130,1071,59,-59,125800,125900,34126,231274,225374
876.288784,4,120,50,70,-70,125800,125900,-2139,-30461,-37461
876.288784,5,5259,5241,18,-18,125800,125900,18004,-446104,-447904
876.288784,6,0,0,0,0,125800,125900,0,0,0
876.503998,0,925,825,100,-100,125800,125900,43899,339801,329801
876.503998,1,910,816,94,-94,125800,125900,43457,163343,153943
876.503998,2,7724,7712,12,-12,125800,125900,41275,-710575,-711775
876.503998,3,1130,1071,59,-59,125800,125900,34126,231274,225374
876.503998,4,120,50,70,-70,125800,125900,-2139,-30461,-37461
876.503998,5,5259,5241,18,-18,125800,125900,18004,-446104,-447904
876.503998,6,0,0,0,0,125800,125900,0,0,0
876.781353,0,925,825,100,-100,125800,125900,43899,339801,329801
876.781353,1,910,816,94,-94,125800,125900,43457,163343,153943
876.781353,2,7724,7712,12,-12,125800,125900,41275,-710575,-711775
876.781353,3,1130,1071,59,-59,125800,125900,34126,231274,225374
876.781353,4,120,50,70,-70,125800,125900,-2139,-30461,-37461
876.781353,5,5259,5241,18,-18,125800,125900,18004,-446104,-447904
876.781353,6,0,0,0,0,125800,125900,0,0,0
877.046796,0,925,825,100,-100,125800,125900,43899,339801,329801
877.046796,1,910,816,94,-94,125800,125900,43457,163343,153943
877.046796,2,7724,7712,12,-12,125800,125900,41275,-710575,-711775
877.046796,3,1130,1071,59,-59,125800,125900,34126,231274,225374
877.046796,4,120,50,70,-70,125800,125900,-2139,-30461,-37461
877.046796,5,5259,5241,18,-18,125800,125900,18004,-446104,-447904
877.046796,6,0,0,0,0,125800,125900,0,0,0
877.293826,0,925,825,100,-100,125800,125900,43899,339801,329801
877.293826,1,910,816,94,-94,125800,125900,43457,163343,153943
877.293826,2,7724,7712,12,-12,125800,125900,41275,-710575,-711775
877.293826,3,1130,1071,59,-59,125800,125900,34126,231274,225374
877.293826,4,120,50,70,-70,125800,125900,-2139,-30461,-37461
877.293826,5,5259,5241,18,-18,125800,125900,18004,-446104,-447904
877.293826,6,0,0,0,0,125800,125900,0,0,0
877.523774,0,925,825,100,-100,125800,125900,43899,339801,329801
877.523774,1,910,816,94,-94,125800,125900,43457,163343,153943
877.523774,2,7724,7712,12,-12,125800,125900,41275,-710575,-711775
877.523774,3,1130,1071,59,-59,125800,125900,34126,231274,225374
877.523774,4,120,50,70,-70,125800,125900,-2139,-30461,-37461
877.523774,5,5259,5241,18,-18,125800,125900,18004,-446104,-447904
877.523774,6,0,0,0,0,125800,125900,0,0,0
877.748836,0,925,825,100,-100,125800,125900,43899,339801,329801
877.748836,1,910,816,94,-94,125800,125900,43457,163343,153943
877.748836,2,7724,7712,12,-12,125800,125900,41275,-710575,-711775
877.748836,3,1130,1071,59,-59,125800,125900,34126,231274,225374
877.748836,4,120,50,70,-70,125800,125900,-2139,-30461,-37461
877.748836,5,5259,5241,18,-18,125800,125900,18004,-446104,-447904
877.748836,6,0,0,0,0,125800,125900,0,0,0
878.049116,0,925,825,100,-100,125800,125900,43899,339801,329801
878.049116,1,910,816,94,-94,125800,125900,43457,163343,153943
878.049116,2,7724,7712,12,-12,125800,125900,41275,-710575,-711775
878.049116,3,1130,1071,59,-59,125800,125900,34126,231274,225374
878.049116,4,120,50,70,-70,125800,125900,-2139,-30461,-37461
878.049116,5,5259,5241,18,-18,125800,125900,18004,-446104,-447904
878.049116,6,0,0,0,0,125800,125900,0,0,0
878.233583,0,925,825,100,-100,125300,125900,43899,339801,314601
878.233583,1,910,816,94,-94,125300,125900,43457,163343,139655
878.233583,2,7734,7712,22,-22,125300,125900,41149,-709449,-714993
878.233583,3,1132,1071,61,-61,125300,125900,34101,231899,216527
878.233583,4,120,50,70,-70,125300,125900,-2139,-30461,-48101
878.233583,5,5269,5241,28,-28,125300,125900,17878,-443978,-451034
878.233583,6,0,0,0,0,125300,125900,0,0,0
878.534817,0,925,825,100,-100,125300,125900,43899,339801,314601
878.534817,1,910,816,94,-94,125300,125900,43457,163343,139655
878.534817,2,7734,7712,22,-22,125300,125900,41149,-709449,-714993
878.534817,3,1132,1071,61,-61,125300,125900,34101,231899,216527
878.534817,4,120,50,70,-70,125300,125900,-2139,-30461,-48101
878.534817,5,5269,5241,28,-28,125300,125900,17878,-443978,-451034
878.534817,6,0,0,0,0,125300,125900,0,0,0
878.713917,0,925,825,100,-100,125300,125900,43899,339801,314601
878.713917,1,910,816,94,-94,125300,125900,43457,163343,139655
878.713917,2,7734,7712,22,-22,125300,125900,41149,-709449,-714993
878.713917,3,1132,1071,61,-61,125300,125900,34101,231899,216527
878.713917,4,120,50,70,-70,125300,125900,-2139,-30461,-48101
878.713917,5,5269,5241,28,-28,125300,125900,17878,-443978,-451034
878.713917,6,0,0,0,0,125300,125900,0,0,0
878.984549,0,925,825,100,-100,125300,125900,43899,339801,314601
878.984549,1,910,816,94,-94,125300,125900,43457,163343,139655
878.984549,2,7734,7712,22,-22,125300,125900,41149,-709449,-714993
878.984549,3,1132,1071,61,-61,125300,125900,34101,231899,216527
878.984549,4,120,50,70,-70,125300,125900,-2139,-30461,-48101
878.984549,5,5269,5241,28,-28,125300,125900,17878,-443978,-451034
878.984549,6,0,0,0,0,125300,125900,0,0,0
879.235594,0,925,825,100,-100,125300,125900,43899,339801,314601
879.235594,1,910,816,94,-94,125300,125900,43457,163343,139655
879.235594,2,7734,7712,22,-22,125300,125900,41149,-709449,-714993
879.235594,3,1132,1071,61,-61,125300,125900,34101,231899,216527
879.235594,4,120,50,70,-70,125300,125900,-2139,-30461,-48101
879.235594,5,5269,5241,28,-28,125300,125900,17878,-443978,-451034
879.235594,6,0,0,0,0,125300,125900,0,0,0
879.53144,0,925,825,100,-100,125300,125700,43899,339801,314701
879.53144,1,910,816,94,-94,125300,125700,43457,163343,139749
879.53144,2,7734,7712,22,-22,125300,125700,41149,-709449,-714971
879.53144,3,1132,1071,61,-61,125300,125700,34101,231899,216588
879.53144,4,120,50,70,-70,125300,125700,-2139,-30461,-48031
879.53144,5,5269,5241,28,-28,125300,125700,17878,-443978,-451006
879.53144,6,0,0,0,0,125300,125700,0,0,0
879.800759,0,925,825,100,-100,125300,125700,43899,339801,314701
879.800759,1,910,816,94,-94,125300,125700,43457,163343,139749
879.800759,2,7734,7712,22,-22,125300,125700,41149,-709449,-714971
879.800759,3,1132,1071,61,-61,125300,125700,34101,231899,216588
879.800759,4,120,50,70,-70,125300,125700,-2139,-30461,-48031
879.800759,5,5269,5241,28,-28,125300,125700,17878,-443978,-451006
879.800759,6,0,0,0,0,125300,125700,0,0,0
880.025827,0,925,825,100,-100,125300,125700,43899,339801,314701
880.025827,1,910,816,94,-94,125300,125700,43457,163343,139749
880.025827,2,7734,7712,22,-22,125300,125700,41149,-709449,-714971
880.025827,3,1132,1071,61,-61,125300,125700,34101,231899,216588
880.025827,4,120,50,70,-70,125300,125700,-2139,-30461,-48031
880.025827,5,5269,5241,28,-28,125300,125700,17878,-443978,-451006
880.025827,6,0,0,0,0,125300,125700,0,0,0
880.205221,0,925,825,100,-100,125300,125700,43899,339801,314701
880.205221,1,910,816,94,-94,125300,125700,43457,163343,139749
880.205221,2,7734,7712,22,-22,125300,125700,41149,-709449,-714971
880.205221,3,1132,1071,61,-61,125300,125700,34101,231899,216588
880.205221,4,120,50,70,-70,125300,125700,-2139,-30461,-48031
880.205221,5,5269,5241,28,-28,125300,125700,17878,-443978,-451006
880.205221,6,0,0,0,0,125300,125700,0,0,0
880.494618,0,925,825,100,-100,125300,125700,43899,339801,314701
880.494618,1,910,816,94,-94,125300,125700,43457,163343,139749
880.494618,2,7734,7712,22,-22,125300,125700,41149,-709449,-714971
880.494618,3,1132,1071,61,-61,125300,125700,34101,231899,216588
880.494618,4,120,50,70,-70,125300,125700,-2139,-30461,-48031
880.494618,5,5269,5241,28,-28,125300,125700,17878,-443978,-451006
880.494618,6,0,0,0,0,125300,125700,0,0,0
880.765655,0,925,825,100,-100,125300,125700,43899,339801,314701
880.765655,1,910,816,94,-94,125300,125700,43457,163343,139749
880.765655,2,7734,7712,22,-22,125300,125700,41149,-709449,-714971
880.765655,3,1132,1071,61,-61,125300,125700,34101,231899,216588
880.765655,4,120,50,70,-70,125300,125700,-2139,-30461,-48031
880.765655,5,5269,5241,28,-28,125300,125700,17878,-443978,-451006
880.765655,6,0,0,0,0,125300,125700,0,0,0
880.982464,0,925,825,100,-100,125300,125700,43899,339801,314701
880.982464,1,910,816,94,-94,125300,125700,43457,163343,139749
880.982464,2,7734,7712,22,-22,125300,125700,41149,-709449,-714971
880.982464,3,1132,1071,61,-61,125300,125700,34101,231899,216588
880.982464,4,120,50,70,-70,125300,125700,-2139,-30461,-48031
880.982464,5,5269,5241,28,-28,125300,125700,17878,-443978,-451006
880.982464,6,0,0,0,0,125300,125700,0,0,0
881.220628,0,925,825,100,-100,125700,125700,43899,339801,339801
881.220628,1,910,816,94,-94,125700,125700,43457,163343,163343
881.220628,2,7734,7722,12,-12,125700,125700,41023,-712323,-712323
881.220628,3,1132,1071,61,-61,125700,125700,34101,231899,231899
881.220628,4,120,50,70,-70,125700,125700,-2139,-30461,-30461
881.220628,5,5279,5241,38,-38,125700,125700,18129,-443229,-443229
881.220628,6,0,0,0,0,125700,125700,0,0,0
881.485324,0,925,825,100,-100,125700,125700,43899,339801,339801
881.485324,1,910,816,94,-94,125700,125700,43457,163343,163343
881.485324,2,7744,7722,22,-22,125700,125700,40897,-711197,-711197
881.485324,3,1132,1071,61,-61,125700,125700,34101,231899,231899
881.485324,4,120,50,70,-70,125700,125700,-2139,-30461,-30461
881.485324,5,5279,5251,28,-28,125700,125700,18380,-445480,-445480
881.485324,6,0,0,0,0,125700,125700,0,0,0
881.733933,0,925,825,100,-100,126200,125700,43899,339801,364901
881.733933,1,910,816,94,-94,126200,125700,43457,163343,186937
881.733933,2,7744,7732,12,-12,126200,125700,40847,-712147,-709135
881.733933,3,1134,1073,61,-61,126200,125700,34051,232749,248060
881.733933,4,120,50,70,-70,126200,125700,-2139,-30461,-12891
881.733933,5,5279,5251,28,-28,126200,125700,18380,-445480,-438452
881.733933,6,0,0,0,0,126200,125700,0,0,0
881.961619,0,925,825,100,-100,125300,125400,43899,339801,329801
881.961619,1,910,816,94,-94,125300,125400,43457,163343,153943
881.961619,2,7744,7742,2,-2,125300,125400,41098,-713398,-713598
881.961619,3,1134,1078,56,-56,125300,125400,34176,231624,226024
881.961619,4,120,50,70,-70,125300,125400,-2139,-30461,-37461
881.961619,5,5289,5251,38,-38,125300,125400,18255,-445355,-449155
881.961619,6,0,0,0,0,125300,125400,0,0,0
882.280478,0,925,825,100,-100,125300,125200,43899,339801,349801
882.280478,1,910,817,93,-93,125300,125200,43482,163418,172718
882.280478,2,7744,7752,-8,8,125300,125200,41349,-712649,-713449
882.280478,3,1134,1086,48,-48,125300,125200,34376,232224,237024
882.280478,4,120,50,70,-70,125300,125200,-2139,-30461,-23461
882.280478,5,5289,5251,38,-38,125300,125200,18255,-445355,-441555
882.280478,6,0,0,0,0,125300,125200,0,0,0
882.536029,0,925,825,100,-100,125000,125200,43899,339801,319801
882.536029,1,910,817,93,-93,125000,125200,43482,163418,144818
882.536029,2,7754,7752,2,-2,125000,125200,41224,-712524,-712924
882.536029,3,1134,1086,48,-48,125000,125200,34376,232224,222624
882.536029,4,120,50,70,-70,125000,125200,-2139,-30461,-44461
882.536029,5,5289,5251,38,-38,125000,125200,18255,-445355,-452955
882.536029,6,0,0,0,0,125000,125200,0,0,0
882.763046,0,925,825,100,-100,125200,125200,43899,339801,339801
882.763046,1,910,817,93,-93,125200,125200,43482,163418,163418
882.763046,2,7764,7752,12,-12,125200,125200,41099,-712399,-712399
882.763046,3,1134,1086,48,-48,125200,125200,34376,232224,232224
882.763046,4,120,50,70,-70,125200,125200,-2139,-30461,-30461
882.763046,5,5289,5261,28,-28,125200,125200,18505,-447605,-447605
882.763046,6,0,0,0,0,125200,125200,0,0,0
882.997417,0,925,825,100,-100,125200,125400,43899,339801,319801
882.997417,1,910,817,93,-93,125200,125400,43482,163418,144818
882.997417,2,7764,7752,12,-12,125200,125400,41099,-712399,-714799
882.997417,3,1134,1086,48,-48,125200,125400,34376,232224,222624
882.997417,4,120,50,70,-70,125200,125400,-2139,-30461,-44461
882.997417,5,5289,5261,28,-28,125200,125400,18505,-447605,-453205
882.997417,6,0,0,0,0,125200,125400,0,0,0
883.2435,0,925,825,100,-100,125200,125400,43899,339801,319801
883.2435,1,910,817,93,-93,125200,125400,43482,163418,144818
883.2435,2,7764,7752,12,-12,125200,125400,41099,-712399,-714799
883.2435,3,1134,1086,48,-48,125200,125400,34376,232224,222624
883.2435,4,120,50,70,-70,125200,125400,-2139,-30461,-44461
883.2435,5,5289,5261,28,-28,125200,125400,18505,-447605,-453205
883.2435,6,0,0,0,0,125200,125400,0,0,0
883.541312,0,925,825,100,-100,125200,125400,43899,339801,319801
883.541312,1,910,817,93,-93,125200,125400,43482,163418,144818
883.541312,2,7764,7752,12,-12,125200,125400,41099,-712399,-714799
883.541312,3,1134,1086,48,-48,125200,125400,34376,232224,222624
883.541312,4,120,50,70,-70,125200,125400,-2139,-30461,-44461
883.541312,5,5289,5261,28,-28,125200,125400,18505,-447605,-453205
883.541312,6,0,0,0,0,125200,125400,0,0,0
883.783311,0,925,825,100,-100,125200,125400,43899,339801,319801
883.783311,1,910,817,93,-93,125200,125400,43482,163418,144818
883.783311,2,7764,7752,12,-12,125200,125400,41099,-712399,-714799
883.783311,3,1134,1086,48,-48,125200,125400,34376,232224,222624
883.783311,4,120,50,70,-70,125200,125400,-2139,-30461,-44461
883.783311,5,5289,5261,28,-28,125200,125400,18505,-447605,-453205
883.783311,6,0,0,0,0,125200,125400,0,0,0
884.023087,0,925,825,100,-100,125200,125400,43899,339801,319801
884.023087,1,910,817,93,-93,125200,125400,43482,163418,144818
884.023087,2,7764,7752,12,-12,125200,125400,41099,-712399,-714799
884.023087,3,1134,1086,48,-48,125200,125400,34376,232224,222624
884.023087,4,120,50,70,-70,125200,125400,-2139,-30461,-44461
884.023087,5,5289,5261,28,-28,125200,125400,18505,-447605,-453205
884.023087,6,0,0,0,0,125200,125400,0,0,0
884.222048,0,925,825,100,-100,125200,125400,43899,339801,319801
884.222048,1,910,817,93,-93,125200,125400,43482,163418,144818
884.222048,2,7764,7752,12,-12,125200,125400,41099,-712399,-714799
884.222048,3,1134,1086,48,-48,125200,125400,34376,232224,222624
884.222048,4,120,50,70,-70,125200,125400,-2139,-30461,-44461
884.222048,5,5289,5261,28,-28,125200,125400,18505,-447605,-453205
884.222048,6,0,0,0,0,125200,125400,0,0,0
884.471393,0,925,825,100,-100,125200,125000,43899,339801,359801
884.471393,1,910,817,93,-93,125200,125000,43482,163418,182018
884.471393,2,7764,7752,12,-12,125200,125000,41099,-712399,-709999
884.471393,3,1134,1086,48,-48,125200,125000,34376,232224,241824
884.471393,4,120,50,70,-70,125200,125000,-2139,-30461,-16461
884.471393,5,5289,5261,28,-28,125200,125000,18505,-447605,-442005
884.471393,6,0,0,0,0,125200,125000,0,0,0
884.770681,0,925,825,100,-100,124800,125000,43899,339801,319801
884.770681,1,910,817,93,-93,124800,125000,43482,163418,144818
884.770681,2,7774,7752,22,-22,124800,125000,40974,-710274,-714674
884.770681,3,1134,1086,48,-48,124800,125000,34376,232224,222624
884.770681,4,120,50,70,-70,124800,125000,-2139,-30461,-44461
884.770681,5,5299,5261,38,-38,124800,125000,18380,-445480,-453080
884.770681,6,0,0,0,0,124800,125000,0,0,0
884.992805,0,925,825,100,-100,124800,125000,43899,339801,319801
884.992805,1,910,817,93,-93,124800,125000,43482,163418,144818
884.992805,2,7774,7752,22,-22,124800,125000,40974,-710274,-714674
884.992805,3,1134,1086,48,-48,124800,125000,34376,232224,222624
884.992805,4,120,50,70,-70,124800,125000,-2139,-30461,-44461
884.992805,5,5299,5261,38,-38,124800,125000,18380,-445480,-453080
884.992805,6,0,0,0,0,124800,125000,0,0,0
885.246178,0,925,825,100,-100,124800,125000,43899,339801,319801
885.246178,1,910,817,93,-93,124800,125000,43482,163418,144818
885.246178,2,7774,7752,22,-22,124800,125000,40974,-710274,-714674
885.246178,3,1134,1086,48,-48,124800,125000,34376,232224,222624
885.246178,4,120,50,70,-70,124800,125000,-2139,-30461,-44461
885.246178,5,5299,5261,38,-38,124800,125000,18380,-445480,-453080
885.246178,6,0,0,0,0,124800,125000,0,0,0
885.453652,0,925,825,100,-100,124800,125000,43899,339801,319801
885.453652,1,910,817,93,-93,124800,125000,43482,163418,144818
885.453652,2,7774,7752,22,-22,124800,125000,40974,-710274,-714674
885.453652,3,1134,1086,48,-48,124800,125000,34376,232224,222624
885.453652,4,120,50,70,-70,124800,125000,-2139,-30461,-44461
885.453652,5,5299,5261,38,-38,124800,125000,18380,-445480,-453080
885.453652,6,0,0,0,0,124800,125000,0,0,0
885.795092,0,925,825,100,-100,124800,125000,43899,339801,319801
885.795092,1,910,817,93,-93,124800,125000,43482,163418,144818
885.795092,2,7774,7752,22,-22,124800,125000,40974,-710274,-714674
885.795092,3,1134,1086,48,-48,124800,125000,34376,232224,222624
885.795092,4,120,50,70,-70,124800,125000,-2139,-30461,-44461
885.795092,5,5299,5261,38,-38,124800,125000,18380,-445480,-453080
885.795092,6,0,0,0,0,124800,125000,0,0,0
885.953773,0,925,825,100,-100,124800,125000,43899,339801,319801
885.953773,1,910,817,93,-93,124800,125000,43482,163418,144818
885.953773,2,7774,7752,22,-22,124800,125000,40974,-710274,-714674
885.953773,3,1134,1086,48,-48,124800,125000,34376,232224,222624
885.953773,4,120,50,70,-70,124800,125000,-2139,-30461,-44461
885.953773,5,5299,5261,38,-38,124800,125000,18380,-445480,-453080
885.953773,6,0,0,0,0,124800,125000,0,0,0
886.289571,0,925,825,100,-100,124900,125000,43899,339801,329801
886.289571,1,910,817,93,-93,124900,125000,43482,163418,154118
886.289571,2,7774,7754,20,-20,124900,125000,40949,-710649,-712649
886.289571,3,1136,1086,50,-50,124900,125000,34426,232374,227374
886.289571,4,120,50,70,-70,124900,125000,-2139,-30461,-37461
886.289571,5,5299,5261,38,-38,124900,125000,18380,-445480,-449280
886.289571,6,0,0,0,0,124900,125000,0,0,0
886.473114,0,925,825,100,-100,124800,125000,43899,339801,319801
886.473114,1,910,817,93,-93,124800,125000,43482,163418,144818
886.473114,2,7774,7764,10,-10,124800,125000,41199,-712899,-714899
886.473114,3,1136,1086,50,-50,124800,125000,34426,232374,222374
886.473114,4,120,50,70,-70,124800,125000,-2139,-30461,-44461
886.473114,5,5299,5261,38,-38,124800,125000,18380,-445480,-453080
886.473114,6,0,0,0,0,124800,125000,0,0,0
886.763389,0,925,825,100,-100,124800,125000,43899,339801,319801
886.763389,1,910,817,93,-93,124800,125000,43482,163418,144818
886.763389,2,7774,7764,10,-10,124800,125000,41199,-712899,-714899
886.763389,3,1136,1086,50,-50,124800,125000,34426,232374,222374
886.763389,4,120,50,70,-70,124800,125000,-2139,-30461,-44461
886.763389,5,5299,5271,28,-28,124800,125000,18630,-448730,-454330
886.763389,6,0,0,0,0,124800,125000,0,0,0
887.042023,0,925,825,100,-100,124800,124700,43899,339801,349801
887.042023,1,910,817,93,-93,124800,124700,43482,163418,172718
887.042023,2,7774,7764,10,-10,124800,124700,41199,-712899,-711899
887.042023,3,1136,1086,50,-50,124800,124700,34426,232374,237374
887.042023,4,120,50,70,-70,124800,124700,-2139,-30461,-23461
887.042023,5,5299,5281,18,-18,124800,124700,18880,-450980,-449180
887.042023,6,0,0,0,0,124800,124700,0,0,0
887.212676,0,925,825,100,-100,124800,124700,43899,339801,349801
887.212676,1,910,817,93,-93,124800,124700,43482,163418,172718
887.212676,2,7774,7774,0,0,124800,124700,41449,-713149,-713149
887.212676,3,1136,1094,42,-42,124800,124700,34626,232174,236374
887.212676,4,120,50,70,-70,124800,124700,-2139,-30461,-23461
887.212676,5,5299,5281,18,-18,124800,124700,18880,-450980,-449180
887.212676,6,0,0,0,0,124800,124700,0,0,0
887.46682,0,925,825,100,-100,124800,124700,43899,339801,349801
887.46682,1,910,817,93,-93,124800,124700,43482,163418,172718
887.46682,2,7774,7775,-1,1,124800,124700,41474,-713274,-713374
887.46682,3,1136,1094,42,-42,124800,124700,34626,232174,236374
887.46682,4,120,50,70,-70,124800,124700,-2139,-30461,-23461
887.46682,5,5299,5281,18,-18,124800,124700,18880,-450980,-449180
887.46682,6,0,0,0,0,124800,124700,0,0,0
887.759055,0,925,825,100,-100,125400,124700,43899,339801,364701
887.759055,1,910,817,93,-93,125400,124700,43482,163418,186575
887.759055,2,7774,7785,-11,11,125400,124700,41349,-712149,-714888
887.759055,3,1136,1096,40,-40,125400,124700,34601,232799,242759
887.759055,4,120,50,70,-70,125400,124700,-2139,-30461,-13031
887.759055,5,5299,5291,8,-8,125400,124700,19129,-453229,-451237
887.759055,6,0,0,0,0,125400,124700,0,0,0
888.02245,0,925,825,100,-100,125400,124700,43899,339801,364701
888.02245,1,910,817,93,-93,125400,124700,43482,163418,186575
888.02245,2,7774,7785,-11,11,125400,124700,41349,-712149,-714888
888.02245,3,1136,1096,40,-40,125400,124700,34601,232799,242759
888.02245,4,120,50,70,-70,125400,124700,-2139,-30461,-13031
888.02245,5,5299,5291,8,-8,125400,124700,19129,-453229,-451237
888.02245,6,0,0,0,0,125400,124700,0,0,0
888.289662,0,925,825,100,-100,125400,124700,43899,339801,364701
888.289662,1,910,817,93,-93,125400,124700,43482,163418,186575
888.289662,2,7784,7795,-11,11,125400,124700,41099,-711899,-714638
888.289662,3,1136,1098,38,-38,125400,124700,34576,233424,242886
888.289662,4,120,50,70,-70,125400,124700,-2139,-30461,-13031
888.289662,5,5309,5301,8,-8,125400,124700,18879,-450979,-448987
888.289662,6,0,0,0,0,125400,124700,0,0,0
888.505658,0,925,825,100,-100,125400,124700,43899,339801,364701
888.505658,1,910,817,93,-93,125400,124700,43482,163418,186575
888.505658,2,7784,7795,-11,11,125400,124700,41099,-711899,-714638
888.505658,3,1136,1098,38,-38,125400,124700,34576,233424,242886
888.505658,4,120,50,70,-70,125400,124700,-2139,-30461,-13031
888.505658,5,5309,5301,8,-8,125400,124700,18879,-450979,-448987
888.505658,6,0,0,0,0,125400,124700,0,0,0
888.786458,0,925,825,100,-100,125000,124700,43899,339801,364701
888.786458,1,910,817,93,-93,125000,124700,43482,163418,186575
888.786458,2,7787,7795,-8,8,125000,124700,41061,-712461,-714453
888.786458,3,1136,1101,35,-35,125000,124700,34651,233349,242064
888.786458,4,120,50,70,-70,125000,124700,-2139,-30461,-13031
888.786458,5,5309,5301,8,-8,125000,124700,18879,-450979,-448987
888.786458,6,0,0,0,0,125000,124700,0,0,0
889.041554,0,925,825,100,-100,125100,124700,43899,339801,364701
889.041554,1,910,817,93,-93,125100,124700,43482,163418,186575
889.041554,2,7797,7795,2,-2,125100,124700,41311,-714711,-714213
889.041554,3,1136,1101,35,-35,125100,124700,34651,233349,242064
889.041554,4,120,50,70,-70,125100,124700,-2139,-30461,-13031
889.041554,5,5309,5311,-2,2,125100,124700,18754,-450854,-451352
889.041554,6,0,0,0,0,125100,124700,0,0,0
889.293024,0,925,825,100,-100,124900,124700,43899,339801,359801
889.293024,1,910,817,93,-93,124900,124700,43482,163418,182018
889.293024,2,7797,7795,2,-2,124900,124700,41311,-714711,-714311
889.293024,3,1136,1103,33,-33,124900,124700,34701,233099,239699
889.293024,4,120,50,70,-70,124900,124700,-2139,-30461,-16461
889.293024,5,5311,5311,0,0,124900,124700,18729,-451029,-451029
889.293024,6,0,0,0,0,124900,124700,0,0,0
889.489803,0,925,825,100,-100,125000,124700,43899,339801,364701
889.489803,1,910,817,93,-93,125000,124700,43482,163418,186575
889.489803,2,7797,7805,-8,8,125000,124700,41186,-713586,-715578
889.489803,3,1136,1103,33,-33,125000,124700,34701,233099,241316
889.489803,4,120,50,70,-70,125000,124700,-2139,-30461,-13031
889.489803,5,5311,5311,0,0,125000,124700,18729,-451029,-451029
889.489803,6,0,0,0,0,125000,124700,0,0,0
889.793627,0,925,855,70,-70,125100,124700,44650,345050,362480
889.793627,1,910,828,82,-82,125100,124700,43757,165343,185761
889.793627,2,7797,7815,-18,18,125100,124700,41436,-711836,-716318
889.793627,3,1136,1107,29,-29,125100,124700,34801,233799,241020
889.793627,4,120,50,70,-70,125100,124700,-2139,-30461,-13031
889.793627,5,5311,5311,0,0,125100,124700,18729,-451029,-451029
889.793627,6,0,0,0,0,125100,124700,0,0,0
890.012164,0,925,855,70,-70,125000,124700,44650,345050,362480
890.012164,1,910,828,82,-82,125000,124700,43757,165343,185761
890.012164,2,7799,7815,-16,16,125000,124700,41411,-712211,-716195
890.012164,3,1136,1109,27,-27,125000,124700,34851,233749,240472
890.012164,4,120,50,70,-70,125000,124700,-2139,-30461,-13031
890.012164,5,5311,5311,0,0,125000,124700,18729,-451029,-451029
890.012164,6,0,0,0,0,125000,124700,0,0,0
890.226757,0,925,855,70,-70,124900,124700,44650,345050,359050
890.226757,1,910,828,82,-82,124900,124700,43757,165343,181743
890.226757,2,7799,7815,-16,16,124900,124700,41411,-712211,-715411
890.226757,3,1136,1113,23,-23,124900,124700,34951,233649,238249
890.226757,4,120,50,70,-70,124900,124700,-2139,-30461,-16461
890.226757,5,5311,5311,0,0,124900,124700,18729,-451029,-451029
890.226757,6,0,0,0,0,124900,124700,0,0,0
890.477717,0,925,855,70,-70,125400,124700,44650,345050,362480
890.477717,1,910,828,82,-82,125400,124700,43757,165343,185761
890.477717,2,7799,7825,-26,26,125400,124700,41286,-710086,-716560
890.477717,3,1136,1115,21,-21,125400,124700,34926,234274,239503
890.477717,4,120,50,70,-70,125400,124700,-2139,-30461,-13031
890.477717,5,5311,5311,0,0,125400,124700,18729,-451029,-451029
890.477717,6,0,0,0,0,125400,124700,0,0,0
890.753677,0,925,855,70,-70,124900,125500,44650,345050,327480
890.753677,1,910,828,82,-82,124900,125500,43757,165343,144761
890.753677,2,7809,7825,-16,16,124900,125500,41536,-712336,-708320
890.753677,3,1136,1119,17,-17,124900,125500,35026,233774,229507
890.753677,4,120,50,70,-70,124900,125500,-2139,-30461,-48031
890.753677,5,5311,5321,-10,10,124900,125500,18604,-450904,-448394
890.753677,6,0,0,0,0,124900,125500,0,0,0
890.962427,0,937,855,82,-82,125600,125500,44950,347150,355350
890.962427,1,910,828,82,-82,125600,125500,43757,165343,173543
890.962427,2,7819,7835,-16,16,125600,125500,41662,-717462,-719062
890.962427,3,1136,1121,15,-15,125600,125500,35001,233199,234699
890.962427,4,120,50,70,-70,125600,125500,-2139,-30461,-23461
890.962427,5,5311,5321,-10,10,125600,125500,18604,-450904,-451904
890.962427,6,0,0,0,0,125600,125500,0,0,0
891.277394,0,937,855,82,-82,125600,125400,44950,347150,363550
891.277394,1,910,828,82,-82,125600,125400,43757,165343,181743
891.277394,2,7829,7835,-6,6,125600,125400,41913,-719713,-720913
891.277394,3,1138,1121,17,-17,125600,125400,34976,233824,237224
891.277394,4,120,50,70,-70,125600,125400,-2139,-30461,-16461
891.277394,5,5321,5321,0,0,125600,125400,18479,-450779,-450779
891.277394,6,0,0,0,0,125600,125400,0,0,0
891.536178,0,937,855,82,-82,125400,125400,44950,347150,347150
891.536178,1,910,828,82,-82,125400,125400,43757,165343,165343
891.536178,2,7831,7835,-4,4,125400,125400,41888,-719688,-719688
891.536178,3,1138,1123,15,-15,125400,125400,35026,233574,233574
891.536178,4,120,50,70,-70,125400,125400,-2139,-30461,-30461
891.536178,5,5321,5321,0,0,125400,125400,18479,-450779,-450779
891.536178,6,0,0,0,0,125400,125400,0,0,0
891.78501,0,937,855,82,-82,125400,125500,44950,347150,338950
891.78501,1,910,828,82,-82,125400,125500,43757,165343,157143
891.78501,2,7831,7835,-4,4,125400,125500,41888,-719688,-719288
891.78501,3,1138,1123,15,-15,125400,125500,35026,233574,232074
891.78501,4,120,50,70,-70,125400,125500,-2139,-30461,-37461
891.78501,5,5321,5321,0,0,125400,125500,18479,-450779,-450779
891.78501,6,0,0,0,0,125400,125500,0,0,0
891.964311,0,937,855,82,-82,125500,125500,44950,347150,347150
891.964311,1,910,828,82,-82,125500,125500,43757,165343,165343
891.964311,2,7833,7835,-2,2,125500,125500,41863,-719863,-719863
891.964311,3,1138,1125,13,-13,125500,125500,35076,233524,233524
891.964311,4,120,50,70,-70,125500,125500,-2139,-30461,-30461
891.964311,5,5321,5321,0,0,125500,125500,18479,-450779,-450779
891.964311,6,0,0,0,0,125500,125500,0,0,0
892.22226,0,937,855,82,-82,125500,125400,44950,347150,355350
892.22226,1,910,828,82,-82,125500,125400,43757,165343,173543
892.22226,2,7833,7835,-2,2,125500,125400,41863,-719863,-720063
892.22226,3,1138,1125,13,-13,125500,125400,35076,233524,234824
892.22226,4,120,50,70,-70,125500,125400,-2139,-30461,-23461
892.22226,5,5321,5321,0,0,125500,125400,18479,-450779,-450779
892.22226,6,0,0,0,0,125500,125400,0,0,0
892.496252,0,937,855,82,-82,125500,125300,44950,347150,363550
892.496252,1,910,828,82,-82,125500,125300,43757,165343,181743
892.496252,2,7835,7835,0,0,125500,125300,41838,-720238,-720238
892.496252,3,1138,1127,11,-11,125500,125300,35126,233674,235874
892.496252,4,120,50,70,-70,125500,125300,-2139,-30461,-16461
892.496252,5,5321,5321,0,0,125500,125300,18479,-450779,-450779
892.496252,6,0,0,0,0,125500,125300,0,0,0
892.727781,0,937,855,82,-82,125300,125300,44950,347150,347150
892.727781,1,910,828,82,-82,125300,125300,43757,165343,165343
892.727781,2,7845,7845,0,0,125300,125300,41964,-722364,-722364
892.727781,3,1138,1131,7,-7,125300,125300,35226,233574,233574
892.727781,4,120,50,70,-70,125300,125300,-2139,-30461,-30461
892.727781,5,5321,5331,-10,10,125300,125300,18730,-450030,-450030
892.727781,6,0,0,0,0,125300,125300,0,0,0
892.954323,0,937,855,82,-82,125300,125300,44950,347150,347150
892.954323,1,910,828,82,-82,125300,125300,43757,165343,165343
892.954323,2,7845,7855,-10,10,125300,125300,42215,-724615,-724615
892.954323,3,1138,1131,7,-7,125300,125300,35226,233574,233574
892.954323,4,120,50,70,-70,125300,125300,-2139,-30461,-30461
892.954323,5,5321,5331,-10,10,125300,125300,18730,-450030,-450030
892.954323,6,0,0,0,0,125300,125300,0,0,0
893.254891,0,937,855,82,-82,125300,125300,44950,347150,347150
893.254891,1,910,828,82,-82,125300,125300,43757,165343,165343
893.254891,2,7845,7855,-10,10,125300,125300,42215,-724615,-724615
893.254891,3,1138,1131,7,-7,125300,125300,35226,233574,233574
893.254891,4,120,50,70,-70,125300,125300,-2139,-30461,-30461
893.254891,5,5321,5331,-10,10,125300,125300,18730,-450030,-450030
893.254891,6,0,0,0,0,125300,125300,0,0,0
893.467115,0,937,855,82,-82,125300,125300,44950,347150,347150
893.467115,1,910,828,82,-82,125300,125300,43757,165343,165343
893.467115,2,7845,7855,-10,10,125300,125300,42215,-724615,-724615
893.467115,3,1138,1131,7,-7,125300,125300,35226,233574,233574
893.467115,4,120,50,70,-70,125300,125300,-2139,-30461,-30461
893.467115,5,5321,5331,-10,10,125300,125300,18730,-450030,-450030
893.467115,6,0,0,0,0,125300,125300,0,0,0
893.75369,0,937,855,82,-82,125600,125800,44950,347150,330750
893.75369,1,920,828,92,-92,125600,125800,44008,165092,146692
893.75369,2,7855,7855,0,0,125600,125800,42466,-724866,-724866
893.75369,3,1138,1131,7,-7,125600,125800,35226,233574,232174
893.75369,4,120,50,70,-70,125600,125800,-2139,-30461,-44461
893.75369,5,5331,5331,0,0,125600,125800,18981,-450281,-450281
893.75369,6,0,0,0,0,125600,125800,0,0,0
894.016893,0,937,855,82,-82,125600,125800,44950,347150,330750
894.016893,1,920,828,92,-92,125600,125800,44008,165092,146692
894.016893,2,7855,7855,0,0,125600,125800,42466,-724866,-724866
894.016893,3,1138,1131,7,-7,125600,125800,35226,233574,232174
894.016893,4,120,50,70,-70,125600,125800,-2139,-30461,-44461
894.016893,5,5331,5331,0,0,125600,125800,18981,-450281,-450281
894.016893,6,0,0,0,0,125600,125800,0,0,0
894.209007,0,937,855,82,-82,125600,125800,44950,347150,330750
894.209007,1,920,828,92,-92,125600,125800,44008,165092,146692
894.209007,2,7855,7855,0,0,125600,125800,42466,-724866,-724866
894.209007,3,1138,1131,7,-7,125600,125800,35226,233574,232174
894.209007,4,120,50,70,-70,125600,125800,-2139,-30461,-44461
894.209007,5,5331,5331,0,0,125600,125800,18981,-450281,-450281
894.209007,6,0,0,0,0,125600,125800,0,0,0
894.521148,0,937,855,82,-82,125400,125400,44950,347150,347150
894.521148,1,920,828,92,-92,125400,125400,44008,165092,165092
894.521148,2,7855,7855,0,0,125400,125400,42466,-724866,-724866
894.521148,3,1138,1133,5,-5,125400,125400,35276,233324,233324
894.521148,4,120,50,70,-70,125400,125400,-2139,-30461,-30461
894.521148,5,5333,5331,2,-2,125400,125400,18956,-450256,-450256
894.521148,6,0,0,0,0,125400,125400,0,0,0
894.725174,0,937,855,82,-82,124800,125400,44950,347150,326568
894.725174,1,920,828,92,-92,124800,125400,44008,165092,142000
894.725174,2,7867,7855,12,-12,124800,125400,42316,-722716,-725728
894.725174,3,1140,1135,5,-5,124800,125400,35301,234099,232844
894.725174,4,120,50,70,-70,124800,125400,-2139,-30461,-48031
894.725174,5,5343,5331,12,-12,124800,125400,18831,-449131,-452143
894.725174,6,0,0,0,0,124800,125400,0,0,0
895.022548,0,937,855,82,-82,125400,125400,44950,347150,347150
895.022548,1,920,828,92,-92,125400,125400,44008,165092,165092
895.022548,2,7877,7865,12,-12,125400,125400,42441,-722841,-722841
895.022548,3,1140,1135,5,-5,125400,125400,35301,234099,234099
895.022548,4,120,50,70,-70,125400,125400,-2139,-30461,-30461
895.022548,5,5353,5341,12,-12,125400,125400,18957,-451257,-451257
895.022548,6,0,0,0,0,125400,125400,0,0,0
895.218755,0,937,855,82,-82,125400,125400,44950,347150,347150
895.218755,1,920,828,92,-92,125400,125400,44008,165092,165092
895.218755,2,7877,7865,12,-12,125400,125400,42441,-722841,-722841
895.218755,3,1140,1135,5,-5,125400,125400,35301,234099,234099
895.218755,4,120,50,70,-70,125400,125400,-2139,-30461,-30461
895.218755,5,5353,5341,12,-12,125400,125400,18957,-451257,-451257
895.218755,6,0,0,0,0,125400,125400,0,0,0
895.508453,0,937,855,82,-82,125400,125400,44950,347150,347150
895.508453,1,920,828,92,-92,125400,125400,44008,165092,165092
895.508453,2,7877,7865,12,-12,125400,125400,42441,-722841,-722841
895.508453,3,1140,1135,5,-5,125400,125400,35301,234099,234099
895.508453,4,120,50,70,-70,125400,125400,-2139,-30461,-30461
895.508453,5,5353,5341,12,-12,125400,125400,18957,-451257,-451257
895.508453,6,0,0,0,0,125400,125400,0,0,0
895.704229,0,937,855,82,-82,125400,125400,44950,347150,347150
895.704229,1,920,828,92,-92,125400,125400,44008,165092,165092
895.704229,2,7877,7865,12,-12,125400,125400,42441,-722841,-722841
895.704229,3,1140,1135,5,-5,125400,125400,35301,234099,234099
895.704229,4,120,50,70,-70,125400,125400,-2139,-30461,-30461
895.704229,5,5353,5341,12,-12,125400,125400,18957,-451257,-451257
895.704229,6,0,0,0,0,125400,125400,0,0,0
895.958277,0,937,855,82,-82,125400,125400,44950,347150,347150
895.958277,1,920,828,92,-92,125400,125400,44008,165092,165092
895.958277,2,7877,7865,12,-12,125400,125400,42441,-722841,-722841
895.958277,3,1140,1135,5,-5,125400,125400,35301,234099,234099
895.958277,4,120,50,70,-70,125400,125400,-2139,-30461,-30461
895.958277,5,5353,5341,12,-12,125400,125400,18957,-451257,-451257
895.958277,6,0,0,0,0,125400,125400,0,0,0
896.239511,0,937,855,82,-82,125400,125400,44950,347150,347150
896.239511,1,920,828,92,-92,125400,125400,44008,165092,165092
896.239511,2,7877,7865,12,-12,125400,125400,42441,-722841,-722841
896.239511,3,1140,1135,5,-5,125400,125400,35301,234099,234099
896.239511,4,120,50,70,-70,125400,125400,-2139,-30461,-30461
896.239511,5,5353,5341,12,-12,125400,125400,18957,-451257,-451257
896.239511,6,0,0,0,0,125400,125400,0,0,0
896.504946,0,937,855,82,-82,125400,125400,44950,347150,347150
896.504946,1,920,828,92,-92,125400,125400,44008,165092,165092
896.504946,2,7877,7865,12,-12,125400,125400,42441,-722841,-722841
896.504946,3,1140,1135,5,-5,125400,125400,35301,234099,234099
896.504946,4,120,50,70,-70,125400,125400,-2139,-30461,-30461
896.504946,5,5353,5341,12,-12,125400,125400,18957,-451257,-451257
896.504946,6,0,0,0,0,125400,125400,0,0,0
896.763947,0,937,855,82,-82,125000,125000,44950,347150,347150
896.763947,1,920,828,92,-92,125000,125000,44008,165092,165092
896.763947,2,7887,7875,12,-12,125000,125000,42567,-722967,-722967
896.763947,3,1140,1135,5,-5,125000,125000,35301,234099,234099
896.763947,4,120,50,70,-70,125000,125000,-2139,-30461,-30461
896.763947,5,5363,5351,12,-12,125000,125000,19082,-453382,-453382
896.763947,6,0,0,0,0,125000,125000,0,0,0
897.008184,0,937,855,82,-82,125600,125000,44950,347150,367650
897.008184,1,920,828,92,-92,125600,125000,44008,165092,188092
897.008184,2,7887,7885,2,-2,125600,125000,42817,-724217,-723717
897.008184,3,1140,1139,1,-1,125600,125000,35326,234274,234524
897.008184,4,120,50,70,-70,125600,125000,-2139,-30461,-12961
897.008184,5,5363,5351,12,-12,125600,125000,19082,-453382,-450382
897.008184,6,0,0,0,0,125600,125000,0,0,0
897.224045,0,937,855,82,-82,125000,125000,44950,347150,347150
897.224045,1,920,828,92,-92,125000,125000,44008,165092,165092
897.224045,2,7887,7885,2,-2,125000,125000,42817,-724217,-724217
897.224045,3,1140,1139,1,-1,125000,125000,35326,234274,234274
897.224045,4,120,50,70,-70,125000,125000,-2139,-30461,-30461
897.224045,5,5363,5361,2,-2,125000,125000,19332,-455632,-455632
897.224045,6,0,0,0,0,125000,125000,0,0,0
897.489375,0,937,855,82,-82,125000,125000,44950,347150,347150
897.489375,1,920,828,92,-92,125000,125000,44008,165092,165092
897.489375,2,7887,7885,2,-2,125000,125000,42817,-724217,-724217
897.489375,3,1140,1139,1,-1,125000,125000,35326,234274,234274
897.489375,4,120,50,70,-70,125000,125000,-2139,-30461,-30461
897.489375,5,5363,5361,2,-2,125000,125000,19332,-455632,-455632
897.489375,6,0,0,0,0,125000,125000,0,0,0
897.799586,0,937,855,82,-82,125000,125000,44950,347150,347150
897.799586,1,920,828,92,-92,125000,125000,44008,165092,165092
897.799586,2,7887,7885,2,-2,125000,125000,42817,-724217,-724217
897.799586,3,1140,1139,1,-1,125000,125000,35326,234274,234274
897.799586,4,120,50,70,-70,125000,125000,-2139,-30461,-30461
897.799586,5,5363,5361,2,-2,125000,125000,19332,-455632,-455632
897.799586,6,0,0,0,0,125000,125000,0,0,0
898.0456,0,937,855,82,-82,125000,125000,44950,347150,347150
898.0456,1,920,828,92,-92,125000,125000,44008,165092,165092
898.0456,2,7887,7885,2,-2,125000,125000,42817,-724217,-724217
898.0456,3,1140,1139,1,-1,125000,125000,35326,234274,234274
898.0456,4,120,50,70,-70,125000,125000,-2139,-30461,-30461
898.0456,5,5363,5361,2,-2,125000,125000,19332,-455632,-455632
898.0456,6,0,0,0,0,125000,125000,0,0,0
898.229527,0,937,855,82,-82,125000,125000,44950,347150,347150
898.229527,1,920,828,92,-92,125000,125000,44008,165092,165092
898.229527,2,7887,7885,2,-2,125000,125000,42817,-724217,-724217
898.229527,3,1140,1139,1,-1,125000,125000,35326,234274,234274
898.229527,4,120,50,70,-70,125000,125000,-2139,-30461,-30461
898.229527,5,5363,5361,2,-2,125000,125000,19332,-455632,-455632
898.229527,6,0,0,0,0,125000,125000,0,0,0
898.491706,0,937,855,82,-82,125000,125000,44950,347150,347150
898.491706,1,920,828,92,-92,125000,125000,44008,165092,165092
898.491706,2,7887,7885,2,-2,125000,125000,42817,-724217,-724217
898.491706,3,1140,1139,1,-1,125000,125000,35326,234274,234274
898.491706,4,120,50,70,-70,125000,125000,-2139,-30461,-30461
898.491706,5,5363,5361,2,-2,125000,125000,19332,-455632,-455632
898.491706,6,0,0,0,0,125000,125000,0,0,0
898.785883,0,937,855,82,-82,125000,125000,44950,347150,347150
898.785883,1,920,828,92,-92,125000,125000,44008,165092,165092
898.785883,2,7887,7885,2,-2,125000,125000,42817,-724217,-724217
898.785883,3,1140,1139,1,-1,125000,125000,35326,234274,234274
898.785883,4,120,50,70,-70,125000,125000,-2139,-30461,-30461
898.785883,5,5363,5361,2,-2,125000,125000,19332,-455632,-455632
898.785883,6,0,0,0,0,125000,125000,0,0,0
898.992632,0,937,855,82,-82,125000,125000,44950,347150,347150
898.992632,1,920,828,92,-92,125000,125000,44008,165092,165092
898.992632,2,7887,7885,2,-2,125000,125000,42817,-724217,-724217
898.992632,3,1140,1139,1,-1,125000,125000,35326,234274,234274
898.992632,4,120,50,70,-70,125000,125000,-2139,-30461,-30461
898.992632,5,5363,5361,2,-2,125000,125000,19332,-455632,-455632
898.992632,6,0,0,0,0,125000,125000,0,0,0
899.295458,0,937,855,82,-82,125000,125000,44950,347150,347150
899.295458,1,920,828,92,-92,125000,125000,44008,165092,165092
899.295458,2,7887,7885,2,-2,125000,125000,42817,-724217,-724217
899.295458,3,1140,1139,1,-1,125000,125000,35326,234274,234274
899.295458,4,120,50,70,-70,125000,125000,-2139,-30461,-30461
899.295458,5,5363,5361,2,-2,125000,125000,19332,-455632,-455632
899.295458,6,0,0,0,0,125000,125000,0,0,0
899.478063,0,937,855,82,-82,125600,125000,44950,347150,367650
899.478063,1,920,828,92,-92,125600,125000,44008,165092,188092
899.478063,2,7887,7895,-8,8,125600,125000,43067,-724467,-726467
899.478063,3,1140,1142,-2,2,125600,125000,35326,234674,234174
899.478063,4,120,50,70,-70,125600,125000,-2139,-30461,-12961
899.478063,5,5366,5361,5,-5,125600,125000,19294,-455894,-454644
899.478063,6,0,0,0,0,125600,125000,0,0,0
899.778429,0,937,855,82,-82,125600,125000,44950,347150,367650
899.778429,1,920,828,92,-92,125600,125000,44008,165092,188092
899.778429,2,7887,7895,-8,8,125600,125000,43067,-724467,-726467
899.778429,3,1140,1142,-2,2,125600,125000,35326,234674,234174
899.778429,4,120,50,70,-70,125600,125000,-2139,-30461,-12961
899.778429,5,5366,5361,5,-5,125600,125000,19294,-455894,-454644
899.778429,6,0,0,0,0,125600,125000,0,0,0
900.024601,0,937,855,82,-82,125600,125000,44950,347150,367650
900.024601,1,920,828,92,-92,125600,125000,44008,165092,188092
900.024601,2,7887,7895,-8,8,125600,125000,43067,-724467,-726467
900.024601,3,1140,1142,-2,2,125600,125000,35326,234674,234174
900.024601,4,120,50,70,-70,125600,125000,-2139,-30461,-12961
900.024601,5,5366,5361,5,-5,125600,125000,19294,-455894,-454644
900.024601,6,0,0,0,0,125600,125000,0,0,0
